"filename", "language", "Go", "Go Checksum File", "Protocol Buffers", "Go Template File", "Go Module File", "comment", "blank", "total"
"/opt/projects/swiftkube/cmd/appmanager/app/httpserver.go", "Go", 75, 0, 0, 0, 0, 0, 16, 91
"/opt/projects/swiftkube/cmd/appmanager/app/server.go", "Go", 182, 0, 0, 0, 0, 0, 36, 218
"/opt/projects/swiftkube/cmd/appmanager/main.go", "Go", 14, 0, 0, 0, 0, 0, 7, 21
"/opt/projects/swiftkube/cmd/genesis-agent/main.go", "Go", 26, 0, 0, 0, 0, 0, 10, 36
"/opt/projects/swiftkube/cmd/genesis-server/main.go", "Go", 3, 0, 0, 0, 0, 0, 3, 6
"/opt/projects/swiftkube/cmd/genesisctl/main.go", "Go", 12, 0, 0, 0, 0, 0, 3, 15
"/opt/projects/swiftkube/cmd/podmanager/main.go", "Go", 14, 0, 0, 0, 0, 0, 7, 21
"/opt/projects/swiftkube/ctlplugin/deploy/main.go", "Go", 3, 0, 0, 0, 0, 0, 3, 6
"/opt/projects/swiftkube/go.mod", "Go Module File", 0, 0, 0, 0, 211, 0, 5, 216
"/opt/projects/swiftkube/go.sum", "Go Checksum File", 0, 1279, 0, 0, 0, 0, 1, 1280
"/opt/projects/swiftkube/hack/tools.go", "Go", 5, 0, 0, 0, 0, 0, 3, 8
"/opt/projects/swiftkube/pkg/apis/swiftdeploymentcontroller/register.go", "Go", 4, 0, 0, 0, 0, 0, 2, 6
"/opt/projects/swiftkube/pkg/apis/swiftdeploymentcontroller/v1alpha1/doc.go", "Go", 3, 0, 0, 0, 0, 0, 2, 5
"/opt/projects/swiftkube/pkg/apis/swiftdeploymentcontroller/v1alpha1/register.go", "Go", 32, 0, 0, 0, 0, 0, 8, 40
"/opt/projects/swiftkube/pkg/apis/swiftdeploymentcontroller/v1alpha1/types.go", "Go", 43, 0, 0, 0, 0, 0, 12, 55
"/opt/projects/swiftkube/pkg/apis/swiftdeploymentcontroller/v1alpha1/zz_generated.deepcopy.go", "Go", 134, 0, 0, 0, 0, 0, 18, 152
"/opt/projects/swiftkube/pkg/cgroup/cgroup.go", "Go", 303, 0, 0, 0, 0, 0, 67, 370
"/opt/projects/swiftkube/pkg/controller/swiftdeployment/strategy.go", "Go", 46, 0, 0, 0, 0, 0, 10, 56
"/opt/projects/swiftkube/pkg/controller/swiftdeployment/swiftdeployment_controller.go", "Go", 494, 0, 0, 0, 0, 0, 64, 558
"/opt/projects/swiftkube/pkg/generated/clientset/versioned/clientset.go", "Go", 87, 0, 0, 0, 0, 0, 18, 105
"/opt/projects/swiftkube/pkg/generated/clientset/versioned/fake/clientset_generated.go", "Go", 59, 0, 0, 0, 0, 0, 11, 70
"/opt/projects/swiftkube/pkg/generated/clientset/versioned/fake/doc.go", "Go", 3, 0, 0, 0, 0, 0, 2, 5
"/opt/projects/swiftkube/pkg/generated/clientset/versioned/fake/register.go", "Go", 34, 0, 0, 0, 0, 0, 7, 41
"/opt/projects/swiftkube/pkg/generated/clientset/versioned/scheme/doc.go", "Go", 3, 0, 0, 0, 0, 0, 2, 5
"/opt/projects/swiftkube/pkg/generated/clientset/versioned/scheme/register.go", "Go", 35, 0, 0, 0, 0, 0, 6, 41
"/opt/projects/swiftkube/pkg/generated/clientset/versioned/typed/swiftdeploymentcontroller/v1alpha1/doc.go", "Go", 3, 0, 0, 0, 0, 0, 2, 5
"/opt/projects/swiftkube/pkg/generated/clientset/versioned/typed/swiftdeploymentcontroller/v1alpha1/fake/doc.go", "Go", 3, 0, 0, 0, 0, 0, 2, 5
"/opt/projects/swiftkube/pkg/generated/clientset/versioned/typed/swiftdeploymentcontroller/v1alpha1/fake/fake_swiftdeployment.go", "Go", 100, 0, 0, 0, 0, 0, 26, 126
"/opt/projects/swiftkube/pkg/generated/clientset/versioned/typed/swiftdeploymentcontroller/v1alpha1/fake/fake_swiftdeploymentcontroller_client.go", "Go", 19, 0, 0, 0, 0, 0, 6, 25
"/opt/projects/swiftkube/pkg/generated/clientset/versioned/typed/swiftdeploymentcontroller/v1alpha1/generated_expansion.go", "Go", 3, 0, 0, 0, 0, 0, 3, 6
"/opt/projects/swiftkube/pkg/generated/clientset/versioned/typed/swiftdeploymentcontroller/v1alpha1/swiftdeployment.go", "Go", 163, 0, 0, 0, 0, 0, 17, 180
"/opt/projects/swiftkube/pkg/generated/clientset/versioned/typed/swiftdeploymentcontroller/v1alpha1/swiftdeploymentcontroller_client.go", "Go", 77, 0, 0, 0, 0, 0, 15, 92
"/opt/projects/swiftkube/pkg/generated/informers/externalversions/factory.go", "Go", 200, 0, 0, 0, 0, 0, 36, 236
"/opt/projects/swiftkube/pkg/generated/informers/externalversions/generic.go", "Go", 36, 0, 0, 0, 0, 0, 11, 47
"/opt/projects/swiftkube/pkg/generated/informers/externalversions/internalinterfaces/factory_interfaces.go", "Go", 18, 0, 0, 0, 0, 0, 7, 25
"/opt/projects/swiftkube/pkg/generated/informers/externalversions/swiftdeploymentcontroller/interface.go", "Go", 24, 0, 0, 0, 0, 0, 7, 31
"/opt/projects/swiftkube/pkg/generated/informers/externalversions/swiftdeploymentcontroller/v1alpha1/interface.go", "Go", 23, 0, 0, 0, 0, 0, 7, 30
"/opt/projects/swiftkube/pkg/generated/informers/externalversions/swiftdeploymentcontroller/v1alpha1/swiftdeployment.go", "Go", 64, 0, 0, 0, 0, 0, 11, 75
"/opt/projects/swiftkube/pkg/generated/listers/swiftdeploymentcontroller/v1alpha1/expansion_generated.go", "Go", 8, 0, 0, 0, 0, 0, 4, 12
"/opt/projects/swiftkube/pkg/generated/listers/swiftdeploymentcontroller/v1alpha1/swiftdeployment.go", "Go", 72, 0, 0, 0, 0, 0, 12, 84
"/opt/projects/swiftkube/pkg/podmanager/monitor.go", "Go", 62, 0, 0, 0, 0, 0, 21, 83
"/opt/projects/swiftkube/pkg/podmanager/scaler.go", "Go", 168, 0, 0, 0, 0, 0, 22, 190
"/opt/projects/swiftkube/pkg/podmanager/server.go", "Go", 509, 0, 0, 0, 0, 0, 110, 619
"/opt/projects/swiftkube/pkg/signals/signal.go", "Go", 23, 0, 0, 0, 0, 0, 6, 29
"/opt/projects/swiftkube/pkg/signals/signal_posix.go", "Go", 6, 0, 0, 0, 0, 0, 3, 9
"/opt/projects/swiftkube/pkg/swiftlet/controller.go", "Go", 258, 0, 0, 0, 0, 0, 48, 306
"/opt/projects/swiftkube/vendor/cloud.google.com/go/compute/internal/version.go", "Go", 16, 0, 0, 0, 0, 0, 3, 19
"/opt/projects/swiftkube/vendor/cloud.google.com/go/compute/metadata/metadata.go", "Go", 473, 0, 0, 0, 0, 0, 71, 544
"/opt/projects/swiftkube/vendor/cloud.google.com/go/compute/metadata/retry.go", "Go", 102, 0, 0, 0, 0, 0, 13, 115
"/opt/projects/swiftkube/vendor/cloud.google.com/go/compute/metadata/retry_linux.go", "Go", 22, 0, 0, 0, 0, 0, 5, 27
"/opt/projects/swiftkube/vendor/cloud.google.com/go/compute/metadata/tidyfix.go", "Go", 20, 0, 0, 0, 0, 0, 4, 24
"/opt/projects/swiftkube/vendor/github.com/Azure/azure-sdk-for-go/services/compute/mgmt/2019-12-01/compute/availabilitysets.go", "Go", 580, 0, 0, 0, 0, 0, 73, 653
"/opt/projects/swiftkube/vendor/github.com/Azure/azure-sdk-for-go/services/compute/mgmt/2019-12-01/compute/client.go", "Go", 37, 0, 0, 0, 0, 0, 7, 44
"/opt/projects/swiftkube/vendor/github.com/Azure/azure-sdk-for-go/services/compute/mgmt/2019-12-01/compute/containerservices.go", "Go", 485, 0, 0, 0, 0, 0, 54, 539
"/opt/projects/swiftkube/vendor/github.com/Azure/azure-sdk-for-go/services/compute/mgmt/2019-12-01/compute/dedicatedhostgroups.go", "Go", 521, 0, 0, 0, 0, 0, 65, 586
"/opt/projects/swiftkube/vendor/github.com/Azure/azure-sdk-for-go/services/compute/mgmt/2019-12-01/compute/dedicatedhosts.go", "Go", 443, 0, 0, 0, 0, 0, 51, 494
"/opt/projects/swiftkube/vendor/github.com/Azure/azure-sdk-for-go/services/compute/mgmt/2019-12-01/compute/diskencryptionsets.go", "Go", 540, 0, 0, 0, 0, 0, 62, 602
"/opt/projects/swiftkube/vendor/github.com/Azure/azure-sdk-for-go/services/compute/mgmt/2019-12-01/compute/disks.go", "Go", 696, 0, 0, 0, 0, 0, 79, 775
"/opt/projects/swiftkube/vendor/github.com/Azure/azure-sdk-for-go/services/compute/mgmt/2019-12-01/compute/enums.go", "Go", 1221, 0, 0, 0, 0, 0, 173, 1394
"/opt/projects/swiftkube/vendor/github.com/Azure/azure-sdk-for-go/services/compute/mgmt/2019-12-01/compute/galleries.go", "Go", 520, 0, 0, 0, 0, 0, 61, 581
"/opt/projects/swiftkube/vendor/github.com/Azure/azure-sdk-for-go/services/compute/mgmt/2019-12-01/compute/galleryapplications.go", "Go", 436, 0, 0, 0, 0, 0, 50, 486
"/opt/projects/swiftkube/vendor/github.com/Azure/azure-sdk-for-go/services/compute/mgmt/2019-12-01/compute/galleryapplicationversions.go", "Go", 464, 0, 0, 0, 0, 0, 51, 515
"/opt/projects/swiftkube/vendor/github.com/Azure/azure-sdk-for-go/services/compute/mgmt/2019-12-01/compute/galleryimages.go", "Go", 442, 0, 0, 0, 0, 0, 51, 493
"/opt/projects/swiftkube/vendor/github.com/Azure/azure-sdk-for-go/services/compute/mgmt/2019-12-01/compute/galleryimageversions.go", "Go", 453, 0, 0, 0, 0, 0, 51, 504
"/opt/projects/swiftkube/vendor/github.com/Azure/azure-sdk-for-go/services/compute/mgmt/2019-12-01/compute/images.go", "Go", 523, 0, 0, 0, 0, 0, 61, 584
"/opt/projects/swiftkube/vendor/github.com/Azure/azure-sdk-for-go/services/compute/mgmt/2019-12-01/compute/loganalytics.go", "Go", 183, 0, 0, 0, 0, 0, 24, 207
"/opt/projects/swiftkube/vendor/github.com/Azure/azure-sdk-for-go/services/compute/mgmt/2019-12-01/compute/models.go", "Go", 14279, 0, 0, 0, 0, 0, 1222, 15501
"/opt/projects/swiftkube/vendor/github.com/Azure/azure-sdk-for-go/services/compute/mgmt/2019-12-01/compute/operations.go", "Go", 85, 0, 0, 0, 0, 0, 14, 99
"/opt/projects/swiftkube/vendor/github.com/Azure/azure-sdk-for-go/services/compute/mgmt/2019-12-01/compute/proximityplacementgroups.go", "Go", 512, 0, 0, 0, 0, 0, 64, 576
"/opt/projects/swiftkube/vendor/github.com/Azure/azure-sdk-for-go/services/compute/mgmt/2019-12-01/compute/resourceskus.go", "Go", 133, 0, 0, 0, 0, 0, 17, 150
"/opt/projects/swiftkube/vendor/github.com/Azure/azure-sdk-for-go/services/compute/mgmt/2019-12-01/compute/snapshots.go", "Go", 689, 0, 0, 0, 0, 0, 79, 768
"/opt/projects/swiftkube/vendor/github.com/Azure/azure-sdk-for-go/services/compute/mgmt/2019-12-01/compute/sshpublickeys.go", "Go", 577, 0, 0, 0, 0, 0, 73, 650
"/opt/projects/swiftkube/vendor/github.com/Azure/azure-sdk-for-go/services/compute/mgmt/2019-12-01/compute/usage.go", "Go", 138, 0, 0, 0, 0, 0, 18, 156
"/opt/projects/swiftkube/vendor/github.com/Azure/azure-sdk-for-go/services/compute/mgmt/2019-12-01/compute/version.go", "Go", 15, 0, 0, 0, 0, 0, 5, 20
"/opt/projects/swiftkube/vendor/github.com/Azure/azure-sdk-for-go/services/compute/mgmt/2019-12-01/compute/virtualmachineextensionimages.go", "Go", 238, 0, 0, 0, 0, 0, 33, 271
"/opt/projects/swiftkube/vendor/github.com/Azure/azure-sdk-for-go/services/compute/mgmt/2019-12-01/compute/virtualmachineextensions.go", "Go", 395, 0, 0, 0, 0, 0, 48, 443
"/opt/projects/swiftkube/vendor/github.com/Azure/azure-sdk-for-go/services/compute/mgmt/2019-12-01/compute/virtualmachineimages.go", "Go", 382, 0, 0, 0, 0, 0, 51, 433
"/opt/projects/swiftkube/vendor/github.com/Azure/azure-sdk-for-go/services/compute/mgmt/2019-12-01/compute/virtualmachineruncommands.go", "Go", 210, 0, 0, 0, 0, 0, 28, 238
"/opt/projects/swiftkube/vendor/github.com/Azure/azure-sdk-for-go/services/compute/mgmt/2019-12-01/compute/virtualmachines.go", "Go", 1746, 0, 0, 0, 0, 0, 200, 1946
"/opt/projects/swiftkube/vendor/github.com/Azure/azure-sdk-for-go/services/compute/mgmt/2019-12-01/compute/virtualmachinescalesetextensions.go", "Go", 434, 0, 0, 0, 0, 0, 50, 484
"/opt/projects/swiftkube/vendor/github.com/Azure/azure-sdk-for-go/services/compute/mgmt/2019-12-01/compute/virtualmachinescalesetrollingupgrades.go", "Go", 308, 0, 0, 0, 0, 0, 39, 347
"/opt/projects/swiftkube/vendor/github.com/Azure/azure-sdk-for-go/services/compute/mgmt/2019-12-01/compute/virtualmachinescalesets.go", "Go", 1818, 0, 0, 0, 0, 0, 201, 2019
"/opt/projects/swiftkube/vendor/github.com/Azure/azure-sdk-for-go/services/compute/mgmt/2019-12-01/compute/virtualmachinescalesetvmextensions.go", "Go", 406, 0, 0, 0, 0, 0, 48, 454
"/opt/projects/swiftkube/vendor/github.com/Azure/azure-sdk-for-go/services/compute/mgmt/2019-12-01/compute/virtualmachinescalesetvms.go", "Go", 1208, 0, 0, 0, 0, 0, 134, 1342
"/opt/projects/swiftkube/vendor/github.com/Azure/azure-sdk-for-go/services/compute/mgmt/2019-12-01/compute/virtualmachinesizes.go", "Go", 99, 0, 0, 0, 0, 0, 16, 115
"/opt/projects/swiftkube/vendor/github.com/Azure/azure-sdk-for-go/services/containerregistry/mgmt/2019-05-01/containerregistry/client.go", "Go", 37, 0, 0, 0, 0, 0, 7, 44
"/opt/projects/swiftkube/vendor/github.com/Azure/azure-sdk-for-go/services/containerregistry/mgmt/2019-05-01/containerregistry/enums.go", "Go", 422, 0, 0, 0, 0, 0, 92, 514
"/opt/projects/swiftkube/vendor/github.com/Azure/azure-sdk-for-go/services/containerregistry/mgmt/2019-05-01/containerregistry/models.go", "Go", 4666, 0, 0, 0, 0, 0, 429, 5095
"/opt/projects/swiftkube/vendor/github.com/Azure/azure-sdk-for-go/services/containerregistry/mgmt/2019-05-01/containerregistry/operations.go", "Go", 125, 0, 0, 0, 0, 0, 16, 141
"/opt/projects/swiftkube/vendor/github.com/Azure/azure-sdk-for-go/services/containerregistry/mgmt/2019-05-01/containerregistry/registries.go", "Go", 1122, 0, 0, 0, 0, 0, 134, 1256
"/opt/projects/swiftkube/vendor/github.com/Azure/azure-sdk-for-go/services/containerregistry/mgmt/2019-05-01/containerregistry/replications.go", "Go", 488, 0, 0, 0, 0, 0, 55, 543
"/opt/projects/swiftkube/vendor/github.com/Azure/azure-sdk-for-go/services/containerregistry/mgmt/2019-05-01/containerregistry/runs.go", "Go", 474, 0, 0, 0, 0, 0, 56, 530
"/opt/projects/swiftkube/vendor/github.com/Azure/azure-sdk-for-go/services/containerregistry/mgmt/2019-05-01/containerregistry/tasks.go", "Go", 582, 0, 0, 0, 0, 0, 65, 647
"/opt/projects/swiftkube/vendor/github.com/Azure/azure-sdk-for-go/services/containerregistry/mgmt/2019-05-01/containerregistry/version.go", "Go", 15, 0, 0, 0, 0, 0, 5, 20
"/opt/projects/swiftkube/vendor/github.com/Azure/azure-sdk-for-go/services/containerregistry/mgmt/2019-05-01/containerregistry/webhooks.go", "Go", 780, 0, 0, 0, 0, 0, 87, 867
"/opt/projects/swiftkube/vendor/github.com/Azure/azure-sdk-for-go/services/containerservice/mgmt/2020-04-01/containerservice/agentpools.go", "Go", 543, 0, 0, 0, 0, 0, 66, 609
"/opt/projects/swiftkube/vendor/github.com/Azure/azure-sdk-for-go/services/containerservice/mgmt/2020-04-01/containerservice/client.go", "Go", 37, 0, 0, 0, 0, 0, 7, 44
"/opt/projects/swiftkube/vendor/github.com/Azure/azure-sdk-for-go/services/containerservice/mgmt/2020-04-01/containerservice/containerservices.go", "Go", 559, 0, 0, 0, 0, 0, 63, 622
"/opt/projects/swiftkube/vendor/github.com/Azure/azure-sdk-for-go/services/containerservice/mgmt/2020-04-01/containerservice/enums.go", "Go", 644, 0, 0, 0, 0, 0, 59, 703
"/opt/projects/swiftkube/vendor/github.com/Azure/azure-sdk-for-go/services/containerservice/mgmt/2020-04-01/containerservice/managedclusters.go", "Go", 1238, 0, 0, 0, 0, 0, 143, 1381
"/opt/projects/swiftkube/vendor/github.com/Azure/azure-sdk-for-go/services/containerservice/mgmt/2020-04-01/containerservice/models.go", "Go", 3149, 0, 0, 0, 0, 0, 256, 3405
"/opt/projects/swiftkube/vendor/github.com/Azure/azure-sdk-for-go/services/containerservice/mgmt/2020-04-01/containerservice/openshiftmanagedclusters.go", "Go", 554, 0, 0, 0, 0, 0, 66, 620
"/opt/projects/swiftkube/vendor/github.com/Azure/azure-sdk-for-go/services/containerservice/mgmt/2020-04-01/containerservice/operations.go", "Go", 85, 0, 0, 0, 0, 0, 14, 99
"/opt/projects/swiftkube/vendor/github.com/Azure/azure-sdk-for-go/services/containerservice/mgmt/2020-04-01/containerservice/version.go", "Go", 15, 0, 0, 0, 0, 0, 5, 20
"/opt/projects/swiftkube/vendor/github.com/Azure/azure-sdk-for-go/services/network/mgmt/2019-06-01/network/applicationgateways.go", "Go", 1318, 0, 0, 0, 0, 0, 159, 1477
"/opt/projects/swiftkube/vendor/github.com/Azure/azure-sdk-for-go/services/network/mgmt/2019-06-01/network/applicationsecuritygroups.go", "Go", 520, 0, 0, 0, 0, 0, 61, 581
"/opt/projects/swiftkube/vendor/github.com/Azure/azure-sdk-for-go/services/network/mgmt/2019-06-01/network/availabledelegations.go", "Go", 132, 0, 0, 0, 0, 0, 17, 149
"/opt/projects/swiftkube/vendor/github.com/Azure/azure-sdk-for-go/services/network/mgmt/2019-06-01/network/availableendpointservices.go", "Go", 132, 0, 0, 0, 0, 0, 17, 149
"/opt/projects/swiftkube/vendor/github.com/Azure/azure-sdk-for-go/services/network/mgmt/2019-06-01/network/availableprivateendpointtypes.go", "Go", 240, 0, 0, 0, 0, 0, 28, 268
"/opt/projects/swiftkube/vendor/github.com/Azure/azure-sdk-for-go/services/network/mgmt/2019-06-01/network/availableresourcegroupdelegations.go", "Go", 135, 0, 0, 0, 0, 0, 17, 152
"/opt/projects/swiftkube/vendor/github.com/Azure/azure-sdk-for-go/services/network/mgmt/2019-06-01/network/azurefirewallfqdntags.go", "Go", 129, 0, 0, 0, 0, 0, 17, 146
"/opt/projects/swiftkube/vendor/github.com/Azure/azure-sdk-for-go/services/network/mgmt/2019-06-01/network/azurefirewalls.go", "Go", 516, 0, 0, 0, 0, 0, 62, 578
"/opt/projects/swiftkube/vendor/github.com/Azure/azure-sdk-for-go/services/network/mgmt/2019-06-01/network/bastionhosts.go", "Go", 519, 0, 0, 0, 0, 0, 61, 580
"/opt/projects/swiftkube/vendor/github.com/Azure/azure-sdk-for-go/services/network/mgmt/2019-06-01/network/bgpservicecommunities.go", "Go", 129, 0, 0, 0, 0, 0, 17, 146
"/opt/projects/swiftkube/vendor/github.com/Azure/azure-sdk-for-go/services/network/mgmt/2019-06-01/network/client.go", "Go", 176, 0, 0, 0, 0, 0, 25, 201
"/opt/projects/swiftkube/vendor/github.com/Azure/azure-sdk-for-go/services/network/mgmt/2019-06-01/network/connectionmonitors.go", "Go", 610, 0, 0, 0, 0, 0, 74, 684
"/opt/projects/swiftkube/vendor/github.com/Azure/azure-sdk-for-go/services/network/mgmt/2019-06-01/network/ddoscustompolicies.go", "Go", 313, 0, 0, 0, 0, 0, 39, 352
"/opt/projects/swiftkube/vendor/github.com/Azure/azure-sdk-for-go/services/network/mgmt/2019-06-01/network/ddosprotectionplans.go", "Go", 523, 0, 0, 0, 0, 0, 61, 584
"/opt/projects/swiftkube/vendor/github.com/Azure/azure-sdk-for-go/services/network/mgmt/2019-06-01/network/defaultsecurityrules.go", "Go", 203, 0, 0, 0, 0, 0, 26, 229
"/opt/projects/swiftkube/vendor/github.com/Azure/azure-sdk-for-go/services/network/mgmt/2019-06-01/network/enums.go", "Go", 1742, 0, 0, 0, 0, 0, 335, 2077
"/opt/projects/swiftkube/vendor/github.com/Azure/azure-sdk-for-go/services/network/mgmt/2019-06-01/network/expressroutecircuitauthorizations.go", "Go", 355, 0, 0, 0, 0, 0, 42, 397
"/opt/projects/swiftkube/vendor/github.com/Azure/azure-sdk-for-go/services/network/mgmt/2019-06-01/network/expressroutecircuitconnections.go", "Go", 362, 0, 0, 0, 0, 0, 42, 404
"/opt/projects/swiftkube/vendor/github.com/Azure/azure-sdk-for-go/services/network/mgmt/2019-06-01/network/expressroutecircuitpeerings.go", "Go", 364, 0, 0, 0, 0, 0, 43, 407
"/opt/projects/swiftkube/vendor/github.com/Azure/azure-sdk-for-go/services/network/mgmt/2019-06-01/network/expressroutecircuits.go", "Go", 883, 0, 0, 0, 0, 0, 103, 986
"/opt/projects/swiftkube/vendor/github.com/Azure/azure-sdk-for-go/services/network/mgmt/2019-06-01/network/expressrouteconnections.go", "Go", 319, 0, 0, 0, 0, 0, 41, 360
"/opt/projects/swiftkube/vendor/github.com/Azure/azure-sdk-for-go/services/network/mgmt/2019-06-01/network/expressroutecrossconnectionpeerings.go", "Go", 365, 0, 0, 0, 0, 0, 43, 408
"/opt/projects/swiftkube/vendor/github.com/Azure/azure-sdk-for-go/services/network/mgmt/2019-06-01/network/expressroutecrossconnections.go", "Go", 678, 0, 0, 0, 0, 0, 77, 755
"/opt/projects/swiftkube/vendor/github.com/Azure/azure-sdk-for-go/services/network/mgmt/2019-06-01/network/expressroutegateways.go", "Go", 374, 0, 0, 0, 0, 0, 50, 424
"/opt/projects/swiftkube/vendor/github.com/Azure/azure-sdk-for-go/services/network/mgmt/2019-06-01/network/expressroutelinks.go", "Go", 203, 0, 0, 0, 0, 0, 26, 229
"/opt/projects/swiftkube/vendor/github.com/Azure/azure-sdk-for-go/services/network/mgmt/2019-06-01/network/expressrouteports.go", "Go", 520, 0, 0, 0, 0, 0, 61, 581
"/opt/projects/swiftkube/vendor/github.com/Azure/azure-sdk-for-go/services/network/mgmt/2019-06-01/network/expressrouteportslocations.go", "Go", 196, 0, 0, 0, 0, 0, 26, 222
"/opt/projects/swiftkube/vendor/github.com/Azure/azure-sdk-for-go/services/network/mgmt/2019-06-01/network/expressrouteserviceproviders.go", "Go", 129, 0, 0, 0, 0, 0, 17, 146
"/opt/projects/swiftkube/vendor/github.com/Azure/azure-sdk-for-go/services/network/mgmt/2019-06-01/network/firewallpolicies.go", "Go", 520, 0, 0, 0, 0, 0, 62, 582
"/opt/projects/swiftkube/vendor/github.com/Azure/azure-sdk-for-go/services/network/mgmt/2019-06-01/network/firewallpolicyrulegroups.go", "Go", 364, 0, 0, 0, 0, 0, 43, 407
"/opt/projects/swiftkube/vendor/github.com/Azure/azure-sdk-for-go/services/network/mgmt/2019-06-01/network/hubvirtualnetworkconnections.go", "Go", 203, 0, 0, 0, 0, 0, 26, 229
"/opt/projects/swiftkube/vendor/github.com/Azure/azure-sdk-for-go/services/network/mgmt/2019-06-01/network/inboundnatrules.go", "Go", 374, 0, 0, 0, 0, 0, 43, 417
"/opt/projects/swiftkube/vendor/github.com/Azure/azure-sdk-for-go/services/network/mgmt/2019-06-01/network/interfaceipconfigurations.go", "Go", 203, 0, 0, 0, 0, 0, 26, 229
"/opt/projects/swiftkube/vendor/github.com/Azure/azure-sdk-for-go/services/network/mgmt/2019-06-01/network/interfaceloadbalancers.go", "Go", 134, 0, 0, 0, 0, 0, 17, 151
"/opt/projects/swiftkube/vendor/github.com/Azure/azure-sdk-for-go/services/network/mgmt/2019-06-01/network/interfacesgroup.go", "Go", 1150, 0, 0, 0, 0, 0, 128, 1278
"/opt/projects/swiftkube/vendor/github.com/Azure/azure-sdk-for-go/services/network/mgmt/2019-06-01/network/interfacetapconfigurations.go", "Go", 387, 0, 0, 0, 0, 0, 43, 430
"/opt/projects/swiftkube/vendor/github.com/Azure/azure-sdk-for-go/services/network/mgmt/2019-06-01/network/loadbalancerbackendaddresspools.go", "Go", 203, 0, 0, 0, 0, 0, 26, 229
"/opt/projects/swiftkube/vendor/github.com/Azure/azure-sdk-for-go/services/network/mgmt/2019-06-01/network/loadbalancerfrontendipconfigurations.go", "Go", 204, 0, 0, 0, 0, 0, 26, 230
"/opt/projects/swiftkube/vendor/github.com/Azure/azure-sdk-for-go/services/network/mgmt/2019-06-01/network/loadbalancerloadbalancingrules.go", "Go", 203, 0, 0, 0, 0, 0, 26, 229
"/opt/projects/swiftkube/vendor/github.com/Azure/azure-sdk-for-go/services/network/mgmt/2019-06-01/network/loadbalancernetworkinterfaces.go", "Go", 134, 0, 0, 0, 0, 0, 17, 151
"/opt/projects/swiftkube/vendor/github.com/Azure/azure-sdk-for-go/services/network/mgmt/2019-06-01/network/loadbalanceroutboundrules.go", "Go", 203, 0, 0, 0, 0, 0, 26, 229
"/opt/projects/swiftkube/vendor/github.com/Azure/azure-sdk-for-go/services/network/mgmt/2019-06-01/network/loadbalancerprobes.go", "Go", 203, 0, 0, 0, 0, 0, 26, 229
"/opt/projects/swiftkube/vendor/github.com/Azure/azure-sdk-for-go/services/network/mgmt/2019-06-01/network/loadbalancers.go", "Go", 522, 0, 0, 0, 0, 0, 61, 583
"/opt/projects/swiftkube/vendor/github.com/Azure/azure-sdk-for-go/services/network/mgmt/2019-06-01/network/localnetworkgateways.go", "Go", 440, 0, 0, 0, 0, 0, 54, 494
"/opt/projects/swiftkube/vendor/github.com/Azure/azure-sdk-for-go/services/network/mgmt/2019-06-01/network/models.go", "Go", 34345, 0, 0, 0, 0, 0, 2819, 37164
"/opt/projects/swiftkube/vendor/github.com/Azure/azure-sdk-for-go/services/network/mgmt/2019-06-01/network/natgateways.go", "Go", 518, 0, 0, 0, 0, 0, 62, 580
"/opt/projects/swiftkube/vendor/github.com/Azure/azure-sdk-for-go/services/network/mgmt/2019-06-01/network/operations.go", "Go", 125, 0, 0, 0, 0, 0, 16, 141
"/opt/projects/swiftkube/vendor/github.com/Azure/azure-sdk-for-go/services/network/mgmt/2019-06-01/network/p2svpngateways.go", "Go", 665, 0, 0, 0, 0, 0, 77, 742
"/opt/projects/swiftkube/vendor/github.com/Azure/azure-sdk-for-go/services/network/mgmt/2019-06-01/network/p2svpnserverconfigurations.go", "Go", 353, 0, 0, 0, 0, 0, 42, 395
"/opt/projects/swiftkube/vendor/github.com/Azure/azure-sdk-for-go/services/network/mgmt/2019-06-01/network/packetcaptures.go", "Go", 464, 0, 0, 0, 0, 0, 57, 521
"/opt/projects/swiftkube/vendor/github.com/Azure/azure-sdk-for-go/services/network/mgmt/2019-06-01/network/peerexpressroutecircuitconnections.go", "Go", 208, 0, 0, 0, 0, 0, 26, 234
"/opt/projects/swiftkube/vendor/github.com/Azure/azure-sdk-for-go/services/network/mgmt/2019-06-01/network/privateendpoints.go", "Go", 449, 0, 0, 0, 0, 0, 53, 502
"/opt/projects/swiftkube/vendor/github.com/Azure/azure-sdk-for-go/services/network/mgmt/2019-06-01/network/privatelinkservices.go", "Go", 956, 0, 0, 0, 0, 0, 108, 1064
"/opt/projects/swiftkube/vendor/github.com/Azure/azure-sdk-for-go/services/network/mgmt/2019-06-01/network/profiles.go", "Go", 514, 0, 0, 0, 0, 0, 63, 577
"/opt/projects/swiftkube/vendor/github.com/Azure/azure-sdk-for-go/services/network/mgmt/2019-06-01/network/publicipaddresses.go", "Go", 835, 0, 0, 0, 0, 0, 93, 928
"/opt/projects/swiftkube/vendor/github.com/Azure/azure-sdk-for-go/services/network/mgmt/2019-06-01/network/publicipprefixes.go", "Go", 523, 0, 0, 0, 0, 0, 61, 584
"/opt/projects/swiftkube/vendor/github.com/Azure/azure-sdk-for-go/services/network/mgmt/2019-06-01/network/resourcenavigationlinks.go", "Go", 96, 0, 0, 0, 0, 0, 15, 111
"/opt/projects/swiftkube/vendor/github.com/Azure/azure-sdk-for-go/services/network/mgmt/2019-06-01/network/routefilterrules.go", "Go", 439, 0, 0, 0, 0, 0, 51, 490
"/opt/projects/swiftkube/vendor/github.com/Azure/azure-sdk-for-go/services/network/mgmt/2019-06-01/network/routefilters.go", "Go", 526, 0, 0, 0, 0, 0, 61, 587
"/opt/projects/swiftkube/vendor/github.com/Azure/azure-sdk-for-go/services/network/mgmt/2019-06-01/network/routes.go", "Go", 350, 0, 0, 0, 0, 0, 42, 392
"/opt/projects/swiftkube/vendor/github.com/Azure/azure-sdk-for-go/services/network/mgmt/2019-06-01/network/routetables.go", "Go", 522, 0, 0, 0, 0, 0, 61, 583
"/opt/projects/swiftkube/vendor/github.com/Azure/azure-sdk-for-go/services/network/mgmt/2019-06-01/network/securitygroups.go", "Go", 522, 0, 0, 0, 0, 0, 61, 583
"/opt/projects/swiftkube/vendor/github.com/Azure/azure-sdk-for-go/services/network/mgmt/2019-06-01/network/securityrules.go", "Go", 350, 0, 0, 0, 0, 0, 42, 392
"/opt/projects/swiftkube/vendor/github.com/Azure/azure-sdk-for-go/services/network/mgmt/2019-06-01/network/serviceassociationlinks.go", "Go", 96, 0, 0, 0, 0, 0, 15, 111
"/opt/projects/swiftkube/vendor/github.com/Azure/azure-sdk-for-go/services/network/mgmt/2019-06-01/network/serviceendpointpolicies.go", "Go", 523, 0, 0, 0, 0, 0, 61, 584
"/opt/projects/swiftkube/vendor/github.com/Azure/azure-sdk-for-go/services/network/mgmt/2019-06-01/network/serviceendpointpolicydefinitions.go", "Go", 352, 0, 0, 0, 0, 0, 42, 394
"/opt/projects/swiftkube/vendor/github.com/Azure/azure-sdk-for-go/services/network/mgmt/2019-06-01/network/servicetags.go", "Go", 93, 0, 0, 0, 0, 0, 15, 108
"/opt/projects/swiftkube/vendor/github.com/Azure/azure-sdk-for-go/services/network/mgmt/2019-06-01/network/subnets.go", "Go", 506, 0, 0, 0, 0, 0, 58, 564
"/opt/projects/swiftkube/vendor/github.com/Azure/azure-sdk-for-go/services/network/mgmt/2019-06-01/network/usages.go", "Go", 137, 0, 0, 0, 0, 0, 18, 155
"/opt/projects/swiftkube/vendor/github.com/Azure/azure-sdk-for-go/services/network/mgmt/2019-06-01/network/version.go", "Go", 15, 0, 0, 0, 0, 0, 5, 20
"/opt/projects/swiftkube/vendor/github.com/Azure/azure-sdk-for-go/services/network/mgmt/2019-06-01/network/virtualhubs.go", "Go", 519, 0, 0, 0, 0, 0, 61, 580
"/opt/projects/swiftkube/vendor/github.com/Azure/azure-sdk-for-go/services/network/mgmt/2019-06-01/network/virtualnetworkgatewayconnections.go", "Go", 666, 0, 0, 0, 0, 0, 78, 744
"/opt/projects/swiftkube/vendor/github.com/Azure/azure-sdk-for-go/services/network/mgmt/2019-06-01/network/virtualnetworkgateways.go", "Go", 1485, 0, 0, 0, 0, 0, 169, 1654
"/opt/projects/swiftkube/vendor/github.com/Azure/azure-sdk-for-go/services/network/mgmt/2019-06-01/network/virtualnetworkpeerings.go", "Go", 352, 0, 0, 0, 0, 0, 42, 394
"/opt/projects/swiftkube/vendor/github.com/Azure/azure-sdk-for-go/services/network/mgmt/2019-06-01/network/virtualnetworks.go", "Go", 698, 0, 0, 0, 0, 0, 81, 779
"/opt/projects/swiftkube/vendor/github.com/Azure/azure-sdk-for-go/services/network/mgmt/2019-06-01/network/virtualnetworktaps.go", "Go", 550, 0, 0, 0, 0, 0, 62, 612
"/opt/projects/swiftkube/vendor/github.com/Azure/azure-sdk-for-go/services/network/mgmt/2019-06-01/network/virtualwans.go", "Go", 519, 0, 0, 0, 0, 0, 61, 580
"/opt/projects/swiftkube/vendor/github.com/Azure/azure-sdk-for-go/services/network/mgmt/2019-06-01/network/vpnconnections.go", "Go", 352, 0, 0, 0, 0, 0, 42, 394
"/opt/projects/swiftkube/vendor/github.com/Azure/azure-sdk-for-go/services/network/mgmt/2019-06-01/network/vpngateways.go", "Go", 590, 0, 0, 0, 0, 0, 69, 659
"/opt/projects/swiftkube/vendor/github.com/Azure/azure-sdk-for-go/services/network/mgmt/2019-06-01/network/vpnlinkconnections.go", "Go", 136, 0, 0, 0, 0, 0, 17, 153
"/opt/projects/swiftkube/vendor/github.com/Azure/azure-sdk-for-go/services/network/mgmt/2019-06-01/network/vpnsitelinkconnections.go", "Go", 98, 0, 0, 0, 0, 0, 15, 113
"/opt/projects/swiftkube/vendor/github.com/Azure/azure-sdk-for-go/services/network/mgmt/2019-06-01/network/vpnsitelinks.go", "Go", 202, 0, 0, 0, 0, 0, 26, 228
"/opt/projects/swiftkube/vendor/github.com/Azure/azure-sdk-for-go/services/network/mgmt/2019-06-01/network/vpnsites.go", "Go", 519, 0, 0, 0, 0, 0, 61, 580
"/opt/projects/swiftkube/vendor/github.com/Azure/azure-sdk-for-go/services/network/mgmt/2019-06-01/network/vpnsitesconfiguration.go", "Go", 106, 0, 0, 0, 0, 0, 15, 121
"/opt/projects/swiftkube/vendor/github.com/Azure/azure-sdk-for-go/services/network/mgmt/2019-06-01/network/watchers.go", "Go", 1395, 0, 0, 0, 0, 0, 166, 1561
"/opt/projects/swiftkube/vendor/github.com/Azure/azure-sdk-for-go/services/network/mgmt/2019-06-01/network/webapplicationfirewallpolicies.go", "Go", 457, 0, 0, 0, 0, 0, 57, 514
"/opt/projects/swiftkube/vendor/github.com/Azure/azure-sdk-for-go/services/resources/mgmt/2017-05-10/resources/client.go", "Go", 37, 0, 0, 0, 0, 0, 7, 44
"/opt/projects/swiftkube/vendor/github.com/Azure/azure-sdk-for-go/services/resources/mgmt/2017-05-10/resources/deploymentoperations.go", "Go", 230, 0, 0, 0, 0, 0, 28, 258
"/opt/projects/swiftkube/vendor/github.com/Azure/azure-sdk-for-go/services/resources/mgmt/2017-05-10/resources/deployments.go", "Go", 796, 0, 0, 0, 0, 0, 94, 890
"/opt/projects/swiftkube/vendor/github.com/Azure/azure-sdk-for-go/services/resources/mgmt/2017-05-10/resources/enums.go", "Go", 28, 0, 0, 0, 0, 0, 8, 36
"/opt/projects/swiftkube/vendor/github.com/Azure/azure-sdk-for-go/services/resources/mgmt/2017-05-10/resources/groups.go", "Go", 586, 0, 0, 0, 0, 0, 76, 662
"/opt/projects/swiftkube/vendor/github.com/Azure/azure-sdk-for-go/services/resources/mgmt/2017-05-10/resources/models.go", "Go", 2019, 0, 0, 0, 0, 0, 213, 2232
"/opt/projects/swiftkube/vendor/github.com/Azure/azure-sdk-for-go/services/resources/mgmt/2017-05-10/resources/providers.go", "Go", 339, 0, 0, 0, 0, 0, 44, 383
"/opt/projects/swiftkube/vendor/github.com/Azure/azure-sdk-for-go/services/resources/mgmt/2017-05-10/resources/resources.go", "Go", 1204, 0, 0, 0, 0, 0, 137, 1341
"/opt/projects/swiftkube/vendor/github.com/Azure/azure-sdk-for-go/services/resources/mgmt/2017-05-10/resources/tags.go", "Go", 391, 0, 0, 0, 0, 0, 53, 444
"/opt/projects/swiftkube/vendor/github.com/Azure/azure-sdk-for-go/services/resources/mgmt/2017-05-10/resources/version.go", "Go", 15, 0, 0, 0, 0, 0, 5, 20
"/opt/projects/swiftkube/vendor/github.com/Azure/azure-sdk-for-go/services/storage/mgmt/2019-06-01/storage/accounts.go", "Go", 1254, 0, 0, 0, 0, 0, 145, 1399
"/opt/projects/swiftkube/vendor/github.com/Azure/azure-sdk-for-go/services/storage/mgmt/2019-06-01/storage/blobcontainers.go", "Go", 1300, 0, 0, 0, 0, 0, 138, 1438
"/opt/projects/swiftkube/vendor/github.com/Azure/azure-sdk-for-go/services/storage/mgmt/2019-06-01/storage/blobservices.go", "Go", 301, 0, 0, 0, 0, 0, 36, 337
"/opt/projects/swiftkube/vendor/github.com/Azure/azure-sdk-for-go/services/storage/mgmt/2019-06-01/storage/client.go", "Go", 37, 0, 0, 0, 0, 0, 7, 44
"/opt/projects/swiftkube/vendor/github.com/Azure/azure-sdk-for-go/services/storage/mgmt/2019-06-01/storage/encryptionscopes.go", "Go", 422, 0, 0, 0, 0, 0, 48, 470
"/opt/projects/swiftkube/vendor/github.com/Azure/azure-sdk-for-go/services/storage/mgmt/2019-06-01/storage/enums.go", "Go", 645, 0, 0, 0, 0, 0, 140, 785
"/opt/projects/swiftkube/vendor/github.com/Azure/azure-sdk-for-go/services/storage/mgmt/2019-06-01/storage/fileservices.go", "Go", 288, 0, 0, 0, 0, 0, 36, 324
"/opt/projects/swiftkube/vendor/github.com/Azure/azure-sdk-for-go/services/storage/mgmt/2019-06-01/storage/fileshares.go", "Go", 622, 0, 0, 0, 0, 0, 68, 690
"/opt/projects/swiftkube/vendor/github.com/Azure/azure-sdk-for-go/services/storage/mgmt/2019-06-01/storage/managementpolicies.go", "Go", 281, 0, 0, 0, 0, 0, 36, 317
"/opt/projects/swiftkube/vendor/github.com/Azure/azure-sdk-for-go/services/storage/mgmt/2019-06-01/storage/models.go", "Go", 4132, 0, 0, 0, 0, 0, 360, 4492
"/opt/projects/swiftkube/vendor/github.com/Azure/azure-sdk-for-go/services/storage/mgmt/2019-06-01/storage/objectreplicationpolicies.go", "Go", 372, 0, 0, 0, 0, 0, 46, 418
"/opt/projects/swiftkube/vendor/github.com/Azure/azure-sdk-for-go/services/storage/mgmt/2019-06-01/storage/operations.go", "Go", 85, 0, 0, 0, 0, 0, 14, 99
"/opt/projects/swiftkube/vendor/github.com/Azure/azure-sdk-for-go/services/storage/mgmt/2019-06-01/storage/privateendpointconnections.go", "Go", 366, 0, 0, 0, 0, 0, 46, 412
"/opt/projects/swiftkube/vendor/github.com/Azure/azure-sdk-for-go/services/storage/mgmt/2019-06-01/storage/privatelinkresources.go", "Go", 109, 0, 0, 0, 0, 0, 16, 125
"/opt/projects/swiftkube/vendor/github.com/Azure/azure-sdk-for-go/services/storage/mgmt/2019-06-01/storage/queue.go", "Go", 514, 0, 0, 0, 0, 0, 58, 572
"/opt/projects/swiftkube/vendor/github.com/Azure/azure-sdk-for-go/services/storage/mgmt/2019-06-01/storage/queueservices.go", "Go", 278, 0, 0, 0, 0, 0, 36, 314
"/opt/projects/swiftkube/vendor/github.com/Azure/azure-sdk-for-go/services/storage/mgmt/2019-06-01/storage/skus.go", "Go", 94, 0, 0, 0, 0, 0, 16, 110
"/opt/projects/swiftkube/vendor/github.com/Azure/azure-sdk-for-go/services/storage/mgmt/2019-06-01/storage/table.go", "Go", 499, 0, 0, 0, 0, 0, 58, 557
"/opt/projects/swiftkube/vendor/github.com/Azure/azure-sdk-for-go/services/storage/mgmt/2019-06-01/storage/tableservices.go", "Go", 278, 0, 0, 0, 0, 0, 36, 314
"/opt/projects/swiftkube/vendor/github.com/Azure/azure-sdk-for-go/services/storage/mgmt/2019-06-01/storage/usages.go", "Go", 97, 0, 0, 0, 0, 0, 16, 113
"/opt/projects/swiftkube/vendor/github.com/Azure/azure-sdk-for-go/services/storage/mgmt/2019-06-01/storage/version.go", "Go", 15, 0, 0, 0, 0, 0, 5, 20
"/opt/projects/swiftkube/vendor/github.com/Azure/azure-sdk-for-go/storage/appendblob.go", "Go", 70, 0, 0, 0, 0, 0, 10, 80
"/opt/projects/swiftkube/vendor/github.com/Azure/azure-sdk-for-go/storage/authorization.go", "Go", 206, 0, 0, 0, 0, 0, 30, 236
"/opt/projects/swiftkube/vendor/github.com/Azure/azure-sdk-for-go/storage/blob.go", "Go", 553, 0, 0, 0, 0, 0, 69, 622
"/opt/projects/swiftkube/vendor/github.com/Azure/azure-sdk-for-go/storage/blobsasuri.go", "Go", 145, 0, 0, 0, 0, 0, 24, 169
"/opt/projects/swiftkube/vendor/github.com/Azure/azure-sdk-for-go/storage/blobserviceclient.go", "Go", 158, 0, 0, 0, 0, 0, 18, 176
"/opt/projects/swiftkube/vendor/github.com/Azure/azure-sdk-for-go/storage/blockblob.go", "Go", 264, 0, 0, 0, 0, 0, 37, 301
"/opt/projects/swiftkube/vendor/github.com/Azure/azure-sdk-for-go/storage/client.go", "Go", 926, 0, 0, 0, 0, 0, 136, 1062
"/opt/projects/swiftkube/vendor/github.com/Azure/azure-sdk-for-go/storage/commonsasuri.go", "Go", 23, 0, 0, 0, 0, 0, 5, 28
"/opt/projects/swiftkube/vendor/github.com/Azure/azure-sdk-for-go/storage/container.go", "Go", 548, 0, 0, 0, 0, 0, 82, 630
"/opt/projects/swiftkube/vendor/github.com/Azure/azure-sdk-for-go/storage/copyblob.go", "Go", 197, 0, 0, 0, 0, 0, 30, 227
"/opt/projects/swiftkube/vendor/github.com/Azure/azure-sdk-for-go/storage/directory.go", "Go", 198, 0, 0, 0, 0, 0, 30, 228
"/opt/projects/swiftkube/vendor/github.com/Azure/azure-sdk-for-go/storage/entity.go", "Go", 401, 0, 0, 0, 0, 0, 55, 456
"/opt/projects/swiftkube/vendor/github.com/Azure/azure-sdk-for-go/storage/file.go", "Go", 409, 0, 0, 0, 0, 0, 65, 474
"/opt/projects/swiftkube/vendor/github.com/Azure/azure-sdk-for-go/storage/fileserviceclient.go", "Go", 276, 0, 0, 0, 0, 0, 52, 328
"/opt/projects/swiftkube/vendor/github.com/Azure/azure-sdk-for-go/storage/leaseblob.go", "Go", 156, 0, 0, 0, 0, 0, 35, 191
"/opt/projects/swiftkube/vendor/github.com/Azure/azure-sdk-for-go/storage/message.go", "Go", 141, 0, 0, 0, 0, 0, 20, 161
"/opt/projects/swiftkube/vendor/github.com/Azure/azure-sdk-for-go/storage/odata.go", "Go", 29, 0, 0, 0, 0, 0, 9, 38
"/opt/projects/swiftkube/vendor/github.com/Azure/azure-sdk-for-go/storage/pageblob.go", "Go", 168, 0, 0, 0, 0, 0, 25, 193
"/opt/projects/swiftkube/vendor/github.com/Azure/azure-sdk-for-go/storage/queue.go", "Go", 368, 0, 0, 0, 0, 0, 58, 426
"/opt/projects/swiftkube/vendor/github.com/Azure/azure-sdk-for-go/storage/queuesasuri.go", "Go", 115, 0, 0, 0, 0, 0, 21, 136
"/opt/projects/swiftkube/vendor/github.com/Azure/azure-sdk-for-go/storage/queueserviceclient.go", "Go", 26, 0, 0, 0, 0, 0, 6, 32
"/opt/projects/swiftkube/vendor/github.com/Azure/azure-sdk-for-go/storage/share.go", "Go", 178, 0, 0, 0, 0, 0, 28, 206
"/opt/projects/swiftkube/vendor/github.com/Azure/azure-sdk-for-go/storage/storagepolicy.go", "Go", 42, 0, 0, 0, 0, 0, 9, 51
"/opt/projects/swiftkube/vendor/github.com/Azure/azure-sdk-for-go/storage/storageservice.go", "Go", 120, 0, 0, 0, 0, 0, 20, 140
"/opt/projects/swiftkube/vendor/github.com/Azure/azure-sdk-for-go/storage/table.go", "Go", 356, 0, 0, 0, 0, 0, 57, 413
"/opt/projects/swiftkube/vendor/github.com/Azure/azure-sdk-for-go/storage/table_batch.go", "Go", 263, 0, 0, 0, 0, 0, 52, 315
"/opt/projects/swiftkube/vendor/github.com/Azure/azure-sdk-for-go/storage/tableserviceclient.go", "Go", 168, 0, 0, 0, 0, 0, 26, 194
"/opt/projects/swiftkube/vendor/github.com/Azure/azure-sdk-for-go/storage/util.go", "Go", 223, 0, 0, 0, 0, 0, 27, 250
"/opt/projects/swiftkube/vendor/github.com/Azure/azure-sdk-for-go/version/version.go", "Go", 5, 0, 0, 0, 0, 0, 3, 8
"/opt/projects/swiftkube/vendor/github.com/Azure/go-ansiterm/constants.go", "Go", 165, 0, 0, 0, 0, 0, 24, 189
"/opt/projects/swiftkube/vendor/github.com/Azure/go-ansiterm/context.go", "Go", 6, 0, 0, 0, 0, 0, 2, 8
"/opt/projects/swiftkube/vendor/github.com/Azure/go-ansiterm/csi_entry_state.go", "Go", 40, 0, 0, 0, 0, 0, 10, 50
"/opt/projects/swiftkube/vendor/github.com/Azure/go-ansiterm/csi_param_state.go", "Go", 30, 0, 0, 0, 0, 0, 9, 39
"/opt/projects/swiftkube/vendor/github.com/Azure/go-ansiterm/escape_intermediate_state.go", "Go", 29, 0, 0, 0, 0, 0, 8, 37
"/opt/projects/swiftkube/vendor/github.com/Azure/go-ansiterm/escape_state.go", "Go", 39, 0, 0, 0, 0, 0, 9, 48
"/opt/projects/swiftkube/vendor/github.com/Azure/go-ansiterm/event_handler.go", "Go", 61, 0, 0, 0, 0, 0, 30, 91
"/opt/projects/swiftkube/vendor/github.com/Azure/go-ansiterm/ground_state.go", "Go", 18, 0, 0, 0, 0, 0, 7, 25
"/opt/projects/swiftkube/vendor/github.com/Azure/go-ansiterm/osc_string_state.go", "Go", 24, 0, 0, 0, 0, 0, 8, 32
"/opt/projects/swiftkube/vendor/github.com/Azure/go-ansiterm/parser.go", "Go", 126, 0, 0, 0, 0, 0, 26, 152
"/opt/projects/swiftkube/vendor/github.com/Azure/go-ansiterm/parser_action_helpers.go", "Go", 81, 0, 0, 0, 0, 0, 19, 100
"/opt/projects/swiftkube/vendor/github.com/Azure/go-ansiterm/parser_actions.go", "Go", 107, 0, 0, 0, 0, 0, 13, 120
"/opt/projects/swiftkube/vendor/github.com/Azure/go-ansiterm/states.go", "Go", 57, 0, 0, 0, 0, 0, 15, 72
"/opt/projects/swiftkube/vendor/github.com/Azure/go-ansiterm/utilities.go", "Go", 17, 0, 0, 0, 0, 0, 5, 22
"/opt/projects/swiftkube/vendor/github.com/Azure/go-ansiterm/winterm/ansi.go", "Go", 171, 0, 0, 0, 0, 0, 26, 197
"/opt/projects/swiftkube/vendor/github.com/Azure/go-ansiterm/winterm/api.go", "Go", 285, 0, 0, 0, 0, 0, 43, 328
"/opt/projects/swiftkube/vendor/github.com/Azure/go-ansiterm/winterm/attr_translation.go", "Go", 70, 0, 0, 0, 0, 0, 31, 101
"/opt/projects/swiftkube/vendor/github.com/Azure/go-ansiterm/winterm/cursor_helpers.go", "Go", 83, 0, 0, 0, 0, 0, 19, 102
"/opt/projects/swiftkube/vendor/github.com/Azure/go-ansiterm/winterm/erase_helpers.go", "Go", 63, 0, 0, 0, 0, 0, 22, 85
"/opt/projects/swiftkube/vendor/github.com/Azure/go-ansiterm/winterm/scroll_helper.go", "Go", 99, 0, 0, 0, 0, 0, 20, 119
"/opt/projects/swiftkube/vendor/github.com/Azure/go-ansiterm/winterm/utilities.go", "Go", 7, 0, 0, 0, 0, 0, 3, 10
"/opt/projects/swiftkube/vendor/github.com/Azure/go-ansiterm/winterm/win_event_handler.go", "Go", 657, 0, 0, 0, 0, 0, 87, 744
"/opt/projects/swiftkube/vendor/github.com/Azure/go-autorest/autorest/adal/config.go", "Go", 135, 0, 0, 0, 0, 0, 17, 152
"/opt/projects/swiftkube/vendor/github.com/Azure/go-autorest/autorest/adal/devicetoken.go", "Go", 229, 0, 0, 0, 0, 0, 45, 274
"/opt/projects/swiftkube/vendor/github.com/Azure/go-autorest/autorest/adal/go_mod_tidy_hack.go", "Go", 21, 0, 0, 0, 0, 0, 5, 26
"/opt/projects/swiftkube/vendor/github.com/Azure/go-autorest/autorest/adal/persist.go", "Go", 122, 0, 0, 0, 0, 0, 14, 136
"/opt/projects/swiftkube/vendor/github.com/Azure/go-autorest/autorest/adal/sender.go", "Go", 89, 0, 0, 0, 0, 0, 13, 102
"/opt/projects/swiftkube/vendor/github.com/Azure/go-autorest/autorest/adal/token.go", "Go", 1274, 0, 0, 0, 0, 0, 157, 1431
"/opt/projects/swiftkube/vendor/github.com/Azure/go-autorest/autorest/adal/token_1.13.go", "Go", 69, 0, 0, 0, 0, 0, 8, 77
"/opt/projects/swiftkube/vendor/github.com/Azure/go-autorest/autorest/adal/token_legacy.go", "Go", 68, 0, 0, 0, 0, 0, 8, 76
"/opt/projects/swiftkube/vendor/github.com/Azure/go-autorest/autorest/adal/version.go", "Go", 39, 0, 0, 0, 0, 0, 7, 46
"/opt/projects/swiftkube/vendor/github.com/Azure/go-autorest/autorest/authorization.go", "Go", 308, 0, 0, 0, 0, 0, 46, 354
"/opt/projects/swiftkube/vendor/github.com/Azure/go-autorest/autorest/authorization_sas.go", "Go", 57, 0, 0, 0, 0, 0, 10, 67
"/opt/projects/swiftkube/vendor/github.com/Azure/go-autorest/autorest/authorization_storage.go", "Go", 271, 0, 0, 0, 0, 0, 37, 308
"/opt/projects/swiftkube/vendor/github.com/Azure/go-autorest/autorest/autorest.go", "Go", 122, 0, 0, 0, 0, 0, 29, 151
"/opt/projects/swiftkube/vendor/github.com/Azure/go-autorest/autorest/azure/async.go", "Go", 886, 0, 0, 0, 0, 0, 110, 996
"/opt/projects/swiftkube/vendor/github.com/Azure/go-autorest/autorest/azure/azure.go", "Go", 337, 0, 0, 0, 0, 0, 52, 389
"/opt/projects/swiftkube/vendor/github.com/Azure/go-autorest/autorest/azure/environments.go", "Go", 313, 0, 0, 0, 0, 0, 19, 332
"/opt/projects/swiftkube/vendor/github.com/Azure/go-autorest/autorest/azure/metadata_environment.go", "Go", 228, 0, 0, 0, 0, 0, 18, 246
"/opt/projects/swiftkube/vendor/github.com/Azure/go-autorest/autorest/azure/rp.go", "Go", 180, 0, 0, 0, 0, 0, 25, 205
"/opt/projects/swiftkube/vendor/github.com/Azure/go-autorest/autorest/client.go", "Go", 285, 0, 0, 0, 0, 0, 44, 329
"/opt/projects/swiftkube/vendor/github.com/Azure/go-autorest/autorest/date/date.go", "Go", 82, 0, 0, 0, 0, 0, 15, 97
"/opt/projects/swiftkube/vendor/github.com/Azure/go-autorest/autorest/date/go_mod_tidy_hack.go", "Go", 20, 0, 0, 0, 0, 0, 5, 25
"/opt/projects/swiftkube/vendor/github.com/Azure/go-autorest/autorest/date/time.go", "Go", 91, 0, 0, 0, 0, 0, 13, 104
"/opt/projects/swiftkube/vendor/github.com/Azure/go-autorest/autorest/date/timerfc1123.go", "Go", 87, 0, 0, 0, 0, 0, 14, 101
"/opt/projects/swiftkube/vendor/github.com/Azure/go-autorest/autorest/date/unixtime.go", "Go", 99, 0, 0, 0, 0, 0, 25, 124
"/opt/projects/swiftkube/vendor/github.com/Azure/go-autorest/autorest/date/utility.go", "Go", 22, 0, 0, 0, 0, 0, 4, 26
"/opt/projects/swiftkube/vendor/github.com/Azure/go-autorest/autorest/error.go", "Go", 86, 0, 0, 0, 0, 0, 18, 104
"/opt/projects/swiftkube/vendor/github.com/Azure/go-autorest/autorest/go_mod_tidy_hack.go", "Go", 21, 0, 0, 0, 0, 0, 5, 26
"/opt/projects/swiftkube/vendor/github.com/Azure/go-autorest/autorest/mocks/go_mod_tidy_hack.go", "Go", 21, 0, 0, 0, 0, 0, 5, 26
"/opt/projects/swiftkube/vendor/github.com/Azure/go-autorest/autorest/mocks/helpers.go", "Go", 145, 0, 0, 0, 0, 0, 27, 172
"/opt/projects/swiftkube/vendor/github.com/Azure/go-autorest/autorest/mocks/mocks.go", "Go", 206, 0, 0, 0, 0, 0, 33, 239
"/opt/projects/swiftkube/vendor/github.com/Azure/go-autorest/autorest/preparer.go", "Go", 493, 0, 0, 0, 0, 0, 57, 550
"/opt/projects/swiftkube/vendor/github.com/Azure/go-autorest/autorest/responder.go", "Go", 248, 0, 0, 0, 0, 0, 22, 270
"/opt/projects/swiftkube/vendor/github.com/Azure/go-autorest/autorest/retriablerequest.go", "Go", 47, 0, 0, 0, 0, 0, 6, 53
"/opt/projects/swiftkube/vendor/github.com/Azure/go-autorest/autorest/retriablerequest_1.7.go", "Go", 49, 0, 0, 0, 0, 0, 7, 56
"/opt/projects/swiftkube/vendor/github.com/Azure/go-autorest/autorest/retriablerequest_1.8.go", "Go", 61, 0, 0, 0, 0, 0, 7, 68
"/opt/projects/swiftkube/vendor/github.com/Azure/go-autorest/autorest/sender.go", "Go", 419, 0, 0, 0, 0, 0, 40, 459
"/opt/projects/swiftkube/vendor/github.com/Azure/go-autorest/autorest/to/convert.go", "Go", 132, 0, 0, 0, 0, 0, 21, 153
"/opt/projects/swiftkube/vendor/github.com/Azure/go-autorest/autorest/to/go_mod_tidy_hack.go", "Go", 20, 0, 0, 0, 0, 0, 5, 25
"/opt/projects/swiftkube/vendor/github.com/Azure/go-autorest/autorest/utility.go", "Go", 205, 0, 0, 0, 0, 0, 28, 233
"/opt/projects/swiftkube/vendor/github.com/Azure/go-autorest/autorest/utility_1.13.go", "Go", 25, 0, 0, 0, 0, 0, 6, 31
"/opt/projects/swiftkube/vendor/github.com/Azure/go-autorest/autorest/utility_legacy.go", "Go", 28, 0, 0, 0, 0, 0, 5, 33
"/opt/projects/swiftkube/vendor/github.com/Azure/go-autorest/autorest/validation/error.go", "Go", 41, 0, 0, 0, 0, 0, 8, 49
"/opt/projects/swiftkube/vendor/github.com/Azure/go-autorest/autorest/validation/go_mod_tidy_hack.go", "Go", 20, 0, 0, 0, 0, 0, 5, 25
"/opt/projects/swiftkube/vendor/github.com/Azure/go-autorest/autorest/validation/validation.go", "Go", 372, 0, 0, 0, 0, 0, 35, 407
"/opt/projects/swiftkube/vendor/github.com/Azure/go-autorest/autorest/version.go", "Go", 35, 0, 0, 0, 0, 0, 7, 42
"/opt/projects/swiftkube/vendor/github.com/Azure/go-autorest/doc.go", "Go", 17, 0, 0, 0, 0, 0, 2, 19
"/opt/projects/swiftkube/vendor/github.com/Azure/go-autorest/logger/go_mod_tidy_hack.go", "Go", 20, 0, 0, 0, 0, 0, 5, 25
"/opt/projects/swiftkube/vendor/github.com/Azure/go-autorest/logger/logger.go", "Go", 296, 0, 0, 0, 0, 0, 42, 338
"/opt/projects/swiftkube/vendor/github.com/Azure/go-autorest/tracing/go_mod_tidy_hack.go", "Go", 20, 0, 0, 0, 0, 0, 5, 25
"/opt/projects/swiftkube/vendor/github.com/Azure/go-autorest/tracing/tracing.go", "Go", 58, 0, 0, 0, 0, 0, 10, 68
"/opt/projects/swiftkube/vendor/github.com/GoogleCloudPlatform/k8s-cloud-provider/pkg/cloud/constants.go", "Go", 44, 0, 0, 0, 0, 0, 12, 56
"/opt/projects/swiftkube/vendor/github.com/GoogleCloudPlatform/k8s-cloud-provider/pkg/cloud/context.go", "Go", 24, 0, 0, 0, 0, 0, 8, 32
"/opt/projects/swiftkube/vendor/github.com/GoogleCloudPlatform/k8s-cloud-provider/pkg/cloud/doc.go", "Go", 113, 0, 0, 0, 0, 0, 5, 118
"/opt/projects/swiftkube/vendor/github.com/GoogleCloudPlatform/k8s-cloud-provider/pkg/cloud/filter/filter.go", "Go", 283, 0, 0, 0, 0, 0, 39, 322
"/opt/projects/swiftkube/vendor/github.com/GoogleCloudPlatform/k8s-cloud-provider/pkg/cloud/gce_projects.go", "Go", 85, 0, 0, 0, 0, 0, 15, 100
"/opt/projects/swiftkube/vendor/github.com/GoogleCloudPlatform/k8s-cloud-provider/pkg/cloud/gen.go", "Go", 35361, 0, 0, 0, 0, 0, 4757, 40118
"/opt/projects/swiftkube/vendor/github.com/GoogleCloudPlatform/k8s-cloud-provider/pkg/cloud/meta/doc.go", "Go", 15, 0, 0, 0, 0, 0, 5, 20
"/opt/projects/swiftkube/vendor/github.com/GoogleCloudPlatform/k8s-cloud-provider/pkg/cloud/meta/key.go", "Go", 92, 0, 0, 0, 0, 0, 17, 109
"/opt/projects/swiftkube/vendor/github.com/GoogleCloudPlatform/k8s-cloud-provider/pkg/cloud/meta/meta.go", "Go", 1065, 0, 0, 0, 0, 0, 13, 1078
"/opt/projects/swiftkube/vendor/github.com/GoogleCloudPlatform/k8s-cloud-provider/pkg/cloud/meta/method.go", "Go", 304, 0, 0, 0, 0, 0, 34, 338
"/opt/projects/swiftkube/vendor/github.com/GoogleCloudPlatform/k8s-cloud-provider/pkg/cloud/meta/service.go", "Go", 266, 0, 0, 0, 0, 0, 49, 315
"/opt/projects/swiftkube/vendor/github.com/GoogleCloudPlatform/k8s-cloud-provider/pkg/cloud/mock/mock.go", "Go", 957, 0, 0, 0, 0, 0, 209, 1166
"/opt/projects/swiftkube/vendor/github.com/GoogleCloudPlatform/k8s-cloud-provider/pkg/cloud/op.go", "Go", 188, 0, 0, 0, 0, 0, 32, 220
"/opt/projects/swiftkube/vendor/github.com/GoogleCloudPlatform/k8s-cloud-provider/pkg/cloud/project.go", "Go", 36, 0, 0, 0, 0, 0, 10, 46
"/opt/projects/swiftkube/vendor/github.com/GoogleCloudPlatform/k8s-cloud-provider/pkg/cloud/ratelimit.go", "Go", 91, 0, 0, 0, 0, 0, 16, 107
"/opt/projects/swiftkube/vendor/github.com/GoogleCloudPlatform/k8s-cloud-provider/pkg/cloud/service.go", "Go", 94, 0, 0, 0, 0, 0, 14, 108
"/opt/projects/swiftkube/vendor/github.com/GoogleCloudPlatform/k8s-cloud-provider/pkg/cloud/utils.go", "Go", 193, 0, 0, 0, 0, 0, 27, 220
"/opt/projects/swiftkube/vendor/github.com/JeffAshton/win_pdh/pdh.go", "Go", 409, 0, 0, 0, 0, 0, 45, 454
"/opt/projects/swiftkube/vendor/github.com/MakeNowJust/heredoc/heredoc.go", "Go", 91, 0, 0, 0, 0, 0, 15, 106
"/opt/projects/swiftkube/vendor/github.com/Microsoft/go-winio/backup.go", "Go", 264, 0, 0, 0, 0, 0, 27, 291
"/opt/projects/swiftkube/vendor/github.com/Microsoft/go-winio/doc.go", "Go", 22, 0, 0, 0, 0, 0, 1, 23
"/opt/projects/swiftkube/vendor/github.com/Microsoft/go-winio/ea.go", "Go", 118, 0, 0, 0, 0, 0, 20, 138
"/opt/projects/swiftkube/vendor/github.com/Microsoft/go-winio/file.go", "Go", 284, 0, 0, 0, 0, 0, 48, 332
"/opt/projects/swiftkube/vendor/github.com/Microsoft/go-winio/fileinfo.go", "Go", 82, 0, 0, 0, 0, 0, 11, 93
"/opt/projects/swiftkube/vendor/github.com/Microsoft/go-winio/hvsock.go", "Go", 498, 0, 0, 0, 0, 0, 78, 576
"/opt/projects/swiftkube/vendor/github.com/Microsoft/go-winio/internal/socket/rawaddr.go", "Go", 18, 0, 0, 0, 0, 0, 3, 21
"/opt/projects/swiftkube/vendor/github.com/Microsoft/go-winio/internal/socket/socket.go", "Go", 154, 0, 0, 0, 0, 0, 26, 180
"/opt/projects/swiftkube/vendor/github.com/Microsoft/go-winio/internal/socket/zsyscall_windows.go", "Go", 59, 0, 0, 0, 0, 0, 14, 73
"/opt/projects/swiftkube/vendor/github.com/Microsoft/go-winio/pipe.go", "Go", 464, 0, 0, 0, 0, 0, 58, 522
"/opt/projects/swiftkube/vendor/github.com/Microsoft/go-winio/pkg/guid/guid.go", "Go", 198, 0, 0, 0, 0, 0, 35, 233
"/opt/projects/swiftkube/vendor/github.com/Microsoft/go-winio/pkg/guid/guid_nonwindows.go", "Go", 14, 0, 0, 0, 0, 0, 3, 17
"/opt/projects/swiftkube/vendor/github.com/Microsoft/go-winio/pkg/guid/guid_windows.go", "Go", 10, 0, 0, 0, 0, 0, 4, 14
"/opt/projects/swiftkube/vendor/github.com/Microsoft/go-winio/pkg/guid/variant_string.go", "Go", 21, 0, 0, 0, 0, 0, 7, 28
"/opt/projects/swiftkube/vendor/github.com/Microsoft/go-winio/pkg/security/grantvmgroupaccess.go", "Go", 141, 0, 0, 0, 0, 0, 29, 170
"/opt/projects/swiftkube/vendor/github.com/Microsoft/go-winio/pkg/security/syscall_windows.go", "Go", 5, 0, 0, 0, 0, 0, 3, 8
"/opt/projects/swiftkube/vendor/github.com/Microsoft/go-winio/pkg/security/zsyscall_windows.go", "Go", 59, 0, 0, 0, 0, 0, 14, 73
"/opt/projects/swiftkube/vendor/github.com/Microsoft/go-winio/privilege.go", "Go", 172, 0, 0, 0, 0, 0, 26, 198
"/opt/projects/swiftkube/vendor/github.com/Microsoft/go-winio/reparse.go", "Go", 114, 0, 0, 0, 0, 0, 18, 132
"/opt/projects/swiftkube/vendor/github.com/Microsoft/go-winio/sd.go", "Go", 124, 0, 0, 0, 0, 0, 21, 145
"/opt/projects/swiftkube/vendor/github.com/Microsoft/go-winio/syscall.go", "Go", 3, 0, 0, 0, 0, 0, 3, 6
"/opt/projects/swiftkube/vendor/github.com/Microsoft/go-winio/tools.go", "Go", 3, 0, 0, 0, 0, 0, 3, 6
"/opt/projects/swiftkube/vendor/github.com/Microsoft/go-winio/vhd/vhd.go", "Go", 341, 0, 0, 0, 0, 0, 37, 378
"/opt/projects/swiftkube/vendor/github.com/Microsoft/go-winio/vhd/zvhd_windows.go", "Go", 91, 0, 0, 0, 0, 0, 18, 109
"/opt/projects/swiftkube/vendor/github.com/Microsoft/go-winio/zsyscall_windows.go", "Go", 388, 0, 0, 0, 0, 0, 51, 439
"/opt/projects/swiftkube/vendor/github.com/Microsoft/hcsshim/computestorage/attach.go", "Go", 33, 0, 0, 0, 0, 0, 6, 39
"/opt/projects/swiftkube/vendor/github.com/Microsoft/hcsshim/computestorage/destroy.go", "Go", 22, 0, 0, 0, 0, 0, 5, 27
"/opt/projects/swiftkube/vendor/github.com/Microsoft/hcsshim/computestorage/detach.go", "Go", 22, 0, 0, 0, 0, 0, 5, 27
"/opt/projects/swiftkube/vendor/github.com/Microsoft/hcsshim/computestorage/export.go", "Go", 40, 0, 0, 0, 0, 0, 7, 47
"/opt/projects/swiftkube/vendor/github.com/Microsoft/hcsshim/computestorage/format.go", "Go", 22, 0, 0, 0, 0, 0, 5, 27
"/opt/projects/swiftkube/vendor/github.com/Microsoft/hcsshim/computestorage/helpers.go", "Go", 173, 0, 0, 0, 0, 0, 21, 194
"/opt/projects/swiftkube/vendor/github.com/Microsoft/hcsshim/computestorage/import.go", "Go", 36, 0, 0, 0, 0, 0, 6, 42
"/opt/projects/swiftkube/vendor/github.com/Microsoft/hcsshim/computestorage/initialize.go", "Go", 33, 0, 0, 0, 0, 0, 6, 39
"/opt/projects/swiftkube/vendor/github.com/Microsoft/hcsshim/computestorage/mount.go", "Go", 23, 0, 0, 0, 0, 0, 5, 28
"/opt/projects/swiftkube/vendor/github.com/Microsoft/hcsshim/computestorage/setup.go", "Go", 66, 0, 0, 0, 0, 0, 9, 75
"/opt/projects/swiftkube/vendor/github.com/Microsoft/hcsshim/computestorage/storage.go", "Go", 42, 0, 0, 0, 0, 0, 9, 51
"/opt/projects/swiftkube/vendor/github.com/Microsoft/hcsshim/computestorage/zsyscall_windows.go", "Go", 292, 0, 0, 0, 0, 0, 28, 320
"/opt/projects/swiftkube/vendor/github.com/Microsoft/hcsshim/container.go", "Go", 184, 0, 0, 0, 0, 0, 40, 224
"/opt/projects/swiftkube/vendor/github.com/Microsoft/hcsshim/errors.go", "Go", 195, 0, 0, 0, 0, 0, 51, 246
"/opt/projects/swiftkube/vendor/github.com/Microsoft/hcsshim/hcsshim.go", "Go", 19, 0, 0, 0, 0, 0, 10, 29
"/opt/projects/swiftkube/vendor/github.com/Microsoft/hcsshim/hnsendpoint.go", "Go", 98, 0, 0, 0, 0, 0, 21, 119
"/opt/projects/swiftkube/vendor/github.com/Microsoft/hcsshim/hnsglobals.go", "Go", 12, 0, 0, 0, 0, 0, 5, 17
"/opt/projects/swiftkube/vendor/github.com/Microsoft/hcsshim/hnsnetwork.go", "Go", 28, 0, 0, 0, 0, 0, 9, 37
"/opt/projects/swiftkube/vendor/github.com/Microsoft/hcsshim/hnspolicy.go", "Go", 43, 0, 0, 0, 0, 0, 18, 61
"/opt/projects/swiftkube/vendor/github.com/Microsoft/hcsshim/hnspolicylist.go", "Go", 36, 0, 0, 0, 0, 0, 12, 48
"/opt/projects/swiftkube/vendor/github.com/Microsoft/hcsshim/hnssupport.go", "Go", 9, 0, 0, 0, 0, 0, 5, 14
"/opt/projects/swiftkube/vendor/github.com/Microsoft/hcsshim/interface.go", "Go", 83, 0, 0, 0, 0, 0, 32, 115
"/opt/projects/swiftkube/vendor/github.com/Microsoft/hcsshim/internal/cow/cow.go", "Go", 92, 0, 0, 0, 0, 0, 6, 98
"/opt/projects/swiftkube/vendor/github.com/Microsoft/hcsshim/internal/hcs/callback.go", "Go", 139, 0, 0, 0, 0, 0, 23, 162
"/opt/projects/swiftkube/vendor/github.com/Microsoft/hcsshim/internal/hcs/errors.go", "Go", 274, 0, 0, 0, 0, 0, 54, 328
"/opt/projects/swiftkube/vendor/github.com/Microsoft/hcsshim/internal/hcs/process.go", "Go", 437, 0, 0, 0, 0, 0, 85, 522
"/opt/projects/swiftkube/vendor/github.com/Microsoft/hcsshim/internal/hcs/schema1/schema1.go", "Go", 222, 0, 0, 0, 0, 0, 29, 251
"/opt/projects/swiftkube/vendor/github.com/Microsoft/hcsshim/internal/hcs/schema2/attachment.go", "Go", 20, 0, 0, 0, 0, 0, 11, 31
"/opt/projects/swiftkube/vendor/github.com/Microsoft/hcsshim/internal/hcs/schema2/battery.go", "Go", 11, 0, 0, 0, 0, 0, 3, 14
"/opt/projects/swiftkube/vendor/github.com/Microsoft/hcsshim/internal/hcs/schema2/cache_query_stats_response.go", "Go", 14, 0, 0, 0, 0, 0, 5, 19
"/opt/projects/swiftkube/vendor/github.com/Microsoft/hcsshim/internal/hcs/schema2/chipset.go", "Go", 19, 0, 0, 0, 0, 0, 9, 28
"/opt/projects/swiftkube/vendor/github.com/Microsoft/hcsshim/internal/hcs/schema2/close_handle.go", "Go", 12, 0, 0, 0, 0, 0, 3, 15
"/opt/projects/swiftkube/vendor/github.com/Microsoft/hcsshim/internal/hcs/schema2/com_port.go", "Go", 14, 0, 0, 0, 0, 0, 4, 18
"/opt/projects/swiftkube/vendor/github.com/Microsoft/hcsshim/internal/hcs/schema2/compute_system.go", "Go", 18, 0, 0, 0, 0, 0, 9, 27
"/opt/projects/swiftkube/vendor/github.com/Microsoft/hcsshim/internal/hcs/schema2/configuration.go", "Go", 58, 0, 0, 0, 0, 0, 15, 73
"/opt/projects/swiftkube/vendor/github.com/Microsoft/hcsshim/internal/hcs/schema2/console_size.go", "Go", 13, 0, 0, 0, 0, 0, 4, 17
"/opt/projects/swiftkube/vendor/github.com/Microsoft/hcsshim/internal/hcs/schema2/container.go", "Go", 22, 0, 0, 0, 0, 0, 13, 35
"/opt/projects/swiftkube/vendor/github.com/Microsoft/hcsshim/internal/hcs/schema2/container_credential_guard_add_instance_request.go", "Go", 14, 0, 0, 0, 0, 0, 3, 17
"/opt/projects/swiftkube/vendor/github.com/Microsoft/hcsshim/internal/hcs/schema2/container_credential_guard_hv_socket_service_config.go", "Go", 13, 0, 0, 0, 0, 0, 3, 16
"/opt/projects/swiftkube/vendor/github.com/Microsoft/hcsshim/internal/hcs/schema2/container_credential_guard_instance.go", "Go", 14, 0, 0, 0, 0, 0, 3, 17
"/opt/projects/swiftkube/vendor/github.com/Microsoft/hcsshim/internal/hcs/schema2/container_credential_guard_modify_operation.go", "Go", 14, 0, 0, 0, 0, 0, 4, 18
"/opt/projects/swiftkube/vendor/github.com/Microsoft/hcsshim/internal/hcs/schema2/container_credential_guard_operation_request.go", "Go", 13, 0, 0, 0, 0, 0, 3, 16
"/opt/projects/swiftkube/vendor/github.com/Microsoft/hcsshim/internal/hcs/schema2/container_credential_guard_remove_instance_request.go", "Go", 12, 0, 0, 0, 0, 0, 3, 15
"/opt/projects/swiftkube/vendor/github.com/Microsoft/hcsshim/internal/hcs/schema2/container_credential_guard_state.go", "Go", 19, 0, 0, 0, 0, 0, 7, 26
"/opt/projects/swiftkube/vendor/github.com/Microsoft/hcsshim/internal/hcs/schema2/container_credential_guard_system_info.go", "Go", 12, 0, 0, 0, 0, 0, 3, 15
"/opt/projects/swiftkube/vendor/github.com/Microsoft/hcsshim/internal/hcs/schema2/container_memory_information.go", "Go", 18, 0, 0, 0, 0, 0, 8, 26
"/opt/projects/swiftkube/vendor/github.com/Microsoft/hcsshim/internal/hcs/schema2/cpu_group.go", "Go", 13, 0, 0, 0, 0, 0, 3, 16
"/opt/projects/swiftkube/vendor/github.com/Microsoft/hcsshim/internal/hcs/schema2/cpu_group_affinity.go", "Go", 13, 0, 0, 0, 0, 0, 3, 16
"/opt/projects/swiftkube/vendor/github.com/Microsoft/hcsshim/internal/hcs/schema2/cpu_group_config.go", "Go", 16, 0, 0, 0, 0, 0, 3, 19
"/opt/projects/swiftkube/vendor/github.com/Microsoft/hcsshim/internal/hcs/schema2/cpu_group_configurations.go", "Go", 13, 0, 0, 0, 0, 0, 3, 16
"/opt/projects/swiftkube/vendor/github.com/Microsoft/hcsshim/internal/hcs/schema2/cpu_group_operations.go", "Go", 15, 0, 0, 0, 0, 0, 4, 19
"/opt/projects/swiftkube/vendor/github.com/Microsoft/hcsshim/internal/hcs/schema2/cpu_group_property.go", "Go", 13, 0, 0, 0, 0, 0, 3, 16
"/opt/projects/swiftkube/vendor/github.com/Microsoft/hcsshim/internal/hcs/schema2/create_group_operation.go", "Go", 15, 0, 0, 0, 0, 0, 3, 18
"/opt/projects/swiftkube/vendor/github.com/Microsoft/hcsshim/internal/hcs/schema2/delete_group_operation.go", "Go", 13, 0, 0, 0, 0, 0, 3, 16
"/opt/projects/swiftkube/vendor/github.com/Microsoft/hcsshim/internal/hcs/schema2/device.go", "Go", 23, 0, 0, 0, 0, 0, 5, 28
"/opt/projects/swiftkube/vendor/github.com/Microsoft/hcsshim/internal/hcs/schema2/devices.go", "Go", 29, 0, 0, 0, 0, 0, 18, 47
"/opt/projects/swiftkube/vendor/github.com/Microsoft/hcsshim/internal/hcs/schema2/enhanced_mode_video.go", "Go", 12, 0, 0, 0, 0, 0, 3, 15
"/opt/projects/swiftkube/vendor/github.com/Microsoft/hcsshim/internal/hcs/schema2/flexible_io_device.go", "Go", 14, 0, 0, 0, 0, 0, 5, 19
"/opt/projects/swiftkube/vendor/github.com/Microsoft/hcsshim/internal/hcs/schema2/guest_connection.go", "Go", 15, 0, 0, 0, 0, 0, 5, 20
"/opt/projects/swiftkube/vendor/github.com/Microsoft/hcsshim/internal/hcs/schema2/guest_connection_info.go", "Go", 16, 0, 0, 0, 0, 0, 6, 22
"/opt/projects/swiftkube/vendor/github.com/Microsoft/hcsshim/internal/hcs/schema2/guest_crash_reporting.go", "Go", 12, 0, 0, 0, 0, 0, 3, 15
"/opt/projects/swiftkube/vendor/github.com/Microsoft/hcsshim/internal/hcs/schema2/guest_os.go", "Go", 12, 0, 0, 0, 0, 0, 3, 15
"/opt/projects/swiftkube/vendor/github.com/Microsoft/hcsshim/internal/hcs/schema2/guest_state.go", "Go", 17, 0, 0, 0, 0, 0, 6, 23
"/opt/projects/swiftkube/vendor/github.com/Microsoft/hcsshim/internal/hcs/schema2/host_processor_modify_request.go", "Go", 14, 0, 0, 0, 0, 0, 3, 17
"/opt/projects/swiftkube/vendor/github.com/Microsoft/hcsshim/internal/hcs/schema2/hosted_system.go", "Go", 13, 0, 0, 0, 0, 0, 4, 17
"/opt/projects/swiftkube/vendor/github.com/Microsoft/hcsshim/internal/hcs/schema2/hv_socket.go", "Go", 13, 0, 0, 0, 0, 0, 4, 17
"/opt/projects/swiftkube/vendor/github.com/Microsoft/hcsshim/internal/hcs/schema2/hv_socket_2.go", "Go", 13, 0, 0, 0, 0, 0, 3, 16
"/opt/projects/swiftkube/vendor/github.com/Microsoft/hcsshim/internal/hcs/schema2/hv_socket_address.go", "Go", 15, 0, 0, 0, 0, 0, 3, 18
"/opt/projects/swiftkube/vendor/github.com/Microsoft/hcsshim/internal/hcs/schema2/hv_socket_service_config.go", "Go", 22, 0, 0, 0, 0, 0, 7, 29
"/opt/projects/swiftkube/vendor/github.com/Microsoft/hcsshim/internal/hcs/schema2/hv_socket_system_config.go", "Go", 17, 0, 0, 0, 0, 0, 6, 23
"/opt/projects/swiftkube/vendor/github.com/Microsoft/hcsshim/internal/hcs/schema2/interrupt_moderation_mode.go", "Go", 36, 0, 0, 0, 0, 0, 7, 43
"/opt/projects/swiftkube/vendor/github.com/Microsoft/hcsshim/internal/hcs/schema2/iov_settings.go", "Go", 18, 0, 0, 0, 0, 0, 5, 23
"/opt/projects/swiftkube/vendor/github.com/Microsoft/hcsshim/internal/hcs/schema2/keyboard.go", "Go", 11, 0, 0, 0, 0, 0, 3, 14
"/opt/projects/swiftkube/vendor/github.com/Microsoft/hcsshim/internal/hcs/schema2/layer.go", "Go", 16, 0, 0, 0, 0, 0, 6, 22
"/opt/projects/swiftkube/vendor/github.com/Microsoft/hcsshim/internal/hcs/schema2/linux_kernel_direct.go", "Go", 14, 0, 0, 0, 0, 0, 5, 19
"/opt/projects/swiftkube/vendor/github.com/Microsoft/hcsshim/internal/hcs/schema2/logical_processor.go", "Go", 16, 0, 0, 0, 0, 0, 3, 19
"/opt/projects/swiftkube/vendor/github.com/Microsoft/hcsshim/internal/hcs/schema2/mapped_directory.go", "Go", 15, 0, 0, 0, 0, 0, 6, 21
"/opt/projects/swiftkube/vendor/github.com/Microsoft/hcsshim/internal/hcs/schema2/mapped_pipe.go", "Go", 14, 0, 0, 0, 0, 0, 5, 19
"/opt/projects/swiftkube/vendor/github.com/Microsoft/hcsshim/internal/hcs/schema2/memory.go", "Go", 12, 0, 0, 0, 0, 0, 3, 15
"/opt/projects/swiftkube/vendor/github.com/Microsoft/hcsshim/internal/hcs/schema2/memory_2.go", "Go", 38, 0, 0, 0, 0, 0, 12, 50
"/opt/projects/swiftkube/vendor/github.com/Microsoft/hcsshim/internal/hcs/schema2/memory_information_for_vm.go", "Go", 14, 0, 0, 0, 0, 0, 5, 19
"/opt/projects/swiftkube/vendor/github.com/Microsoft/hcsshim/internal/hcs/schema2/memory_stats.go", "Go", 15, 0, 0, 0, 0, 0, 5, 20
"/opt/projects/swiftkube/vendor/github.com/Microsoft/hcsshim/internal/hcs/schema2/modification_request.go", "Go", 13, 0, 0, 0, 0, 0, 3, 16
"/opt/projects/swiftkube/vendor/github.com/Microsoft/hcsshim/internal/hcs/schema2/modify_setting_request.go", "Go", 15, 0, 0, 0, 0, 0, 6, 21
"/opt/projects/swiftkube/vendor/github.com/Microsoft/hcsshim/internal/hcs/schema2/mouse.go", "Go", 11, 0, 0, 0, 0, 0, 3, 14
"/opt/projects/swiftkube/vendor/github.com/Microsoft/hcsshim/internal/hcs/schema2/network_adapter.go", "Go", 15, 0, 0, 0, 0, 0, 3, 18
"/opt/projects/swiftkube/vendor/github.com/Microsoft/hcsshim/internal/hcs/schema2/networking.go", "Go", 17, 0, 0, 0, 0, 0, 7, 24
"/opt/projects/swiftkube/vendor/github.com/Microsoft/hcsshim/internal/hcs/schema2/pause_notification.go", "Go", 13, 0, 0, 0, 0, 0, 3, 16
"/opt/projects/swiftkube/vendor/github.com/Microsoft/hcsshim/internal/hcs/schema2/pause_options.go", "Go", 14, 0, 0, 0, 0, 0, 4, 18
"/opt/projects/swiftkube/vendor/github.com/Microsoft/hcsshim/internal/hcs/schema2/plan9.go", "Go", 12, 0, 0, 0, 0, 0, 3, 15
"/opt/projects/swiftkube/vendor/github.com/Microsoft/hcsshim/internal/hcs/schema2/plan9_share.go", "Go", 25, 0, 0, 0, 0, 0, 10, 35
"/opt/projects/swiftkube/vendor/github.com/Microsoft/hcsshim/internal/hcs/schema2/process_details.go", "Go", 23, 0, 0, 0, 0, 0, 11, 34
"/opt/projects/swiftkube/vendor/github.com/Microsoft/hcsshim/internal/hcs/schema2/process_modify_request.go", "Go", 15, 0, 0, 0, 0, 0, 5, 20
"/opt/projects/swiftkube/vendor/github.com/Microsoft/hcsshim/internal/hcs/schema2/process_parameters.go", "Go", 31, 0, 0, 0, 0, 0, 16, 47
"/opt/projects/swiftkube/vendor/github.com/Microsoft/hcsshim/internal/hcs/schema2/process_status.go", "Go", 16, 0, 0, 0, 0, 0, 6, 22
"/opt/projects/swiftkube/vendor/github.com/Microsoft/hcsshim/internal/hcs/schema2/processor.go", "Go", 14, 0, 0, 0, 0, 0, 5, 19
"/opt/projects/swiftkube/vendor/github.com/Microsoft/hcsshim/internal/hcs/schema2/processor_2.go", "Go", 17, 0, 0, 0, 0, 0, 7, 24
"/opt/projects/swiftkube/vendor/github.com/Microsoft/hcsshim/internal/hcs/schema2/processor_stats.go", "Go", 15, 0, 0, 0, 0, 0, 5, 20
"/opt/projects/swiftkube/vendor/github.com/Microsoft/hcsshim/internal/hcs/schema2/processor_topology.go", "Go", 13, 0, 0, 0, 0, 0, 3, 16
"/opt/projects/swiftkube/vendor/github.com/Microsoft/hcsshim/internal/hcs/schema2/properties.go", "Go", 34, 0, 0, 0, 0, 0, 21, 55
"/opt/projects/swiftkube/vendor/github.com/Microsoft/hcsshim/internal/hcs/schema2/property_query.go", "Go", 13, 0, 0, 0, 0, 0, 3, 16
"/opt/projects/swiftkube/vendor/github.com/Microsoft/hcsshim/internal/hcs/schema2/property_type.go", "Go", 23, 0, 0, 0, 0, 0, 4, 27
"/opt/projects/swiftkube/vendor/github.com/Microsoft/hcsshim/internal/hcs/schema2/rdp_connection_options.go", "Go", 13, 0, 0, 0, 0, 0, 4, 17
"/opt/projects/swiftkube/vendor/github.com/Microsoft/hcsshim/internal/hcs/schema2/registry_changes.go", "Go", 13, 0, 0, 0, 0, 0, 4, 17
"/opt/projects/swiftkube/vendor/github.com/Microsoft/hcsshim/internal/hcs/schema2/registry_key.go", "Go", 14, 0, 0, 0, 0, 0, 5, 19
"/opt/projects/swiftkube/vendor/github.com/Microsoft/hcsshim/internal/hcs/schema2/registry_value.go", "Go", 21, 0, 0, 0, 0, 0, 10, 31
"/opt/projects/swiftkube/vendor/github.com/Microsoft/hcsshim/internal/hcs/schema2/restore_state.go", "Go", 15, 0, 0, 0, 0, 0, 5, 20
"/opt/projects/swiftkube/vendor/github.com/Microsoft/hcsshim/internal/hcs/schema2/save_options.go", "Go", 15, 0, 0, 0, 0, 0, 5, 20
"/opt/projects/swiftkube/vendor/github.com/Microsoft/hcsshim/internal/hcs/schema2/scsi.go", "Go", 13, 0, 0, 0, 0, 0, 4, 17
"/opt/projects/swiftkube/vendor/github.com/Microsoft/hcsshim/internal/hcs/schema2/service_properties.go", "Go", 15, 0, 0, 0, 0, 0, 4, 19
"/opt/projects/swiftkube/vendor/github.com/Microsoft/hcsshim/internal/hcs/schema2/shared_memory_configuration.go", "Go", 12, 0, 0, 0, 0, 0, 3, 15
"/opt/projects/swiftkube/vendor/github.com/Microsoft/hcsshim/internal/hcs/schema2/shared_memory_region.go", "Go", 16, 0, 0, 0, 0, 0, 7, 23
"/opt/projects/swiftkube/vendor/github.com/Microsoft/hcsshim/internal/hcs/schema2/shared_memory_region_info.go", "Go", 13, 0, 0, 0, 0, 0, 4, 17
"/opt/projects/swiftkube/vendor/github.com/Microsoft/hcsshim/internal/hcs/schema2/silo_properties.go", "Go", 14, 0, 0, 0, 0, 0, 4, 18
"/opt/projects/swiftkube/vendor/github.com/Microsoft/hcsshim/internal/hcs/schema2/statistics.go", "Go", 21, 0, 0, 0, 0, 0, 9, 30
"/opt/projects/swiftkube/vendor/github.com/Microsoft/hcsshim/internal/hcs/schema2/storage.go", "Go", 16, 0, 0, 0, 0, 0, 6, 22
"/opt/projects/swiftkube/vendor/github.com/Microsoft/hcsshim/internal/hcs/schema2/storage_qo_s.go", "Go", 13, 0, 0, 0, 0, 0, 4, 17
"/opt/projects/swiftkube/vendor/github.com/Microsoft/hcsshim/internal/hcs/schema2/storage_stats.go", "Go", 16, 0, 0, 0, 0, 0, 6, 22
"/opt/projects/swiftkube/vendor/github.com/Microsoft/hcsshim/internal/hcs/schema2/topology.go", "Go", 13, 0, 0, 0, 0, 0, 4, 17
"/opt/projects/swiftkube/vendor/github.com/Microsoft/hcsshim/internal/hcs/schema2/uefi.go", "Go", 15, 0, 0, 0, 0, 0, 6, 21
"/opt/projects/swiftkube/vendor/github.com/Microsoft/hcsshim/internal/hcs/schema2/uefi_boot_entry.go", "Go", 16, 0, 0, 0, 0, 0, 7, 23
"/opt/projects/swiftkube/vendor/github.com/Microsoft/hcsshim/internal/hcs/schema2/version.go", "Go", 13, 0, 0, 0, 0, 0, 4, 17
"/opt/projects/swiftkube/vendor/github.com/Microsoft/hcsshim/internal/hcs/schema2/video_monitor.go", "Go", 14, 0, 0, 0, 0, 0, 5, 19
"/opt/projects/swiftkube/vendor/github.com/Microsoft/hcsshim/internal/hcs/schema2/virtual_machine.go", "Go", 21, 0, 0, 0, 0, 0, 12, 33
"/opt/projects/swiftkube/vendor/github.com/Microsoft/hcsshim/internal/hcs/schema2/virtual_node_info.go", "Go", 15, 0, 0, 0, 0, 0, 6, 21
"/opt/projects/swiftkube/vendor/github.com/Microsoft/hcsshim/internal/hcs/schema2/virtual_p_mem_controller.go", "Go", 15, 0, 0, 0, 0, 0, 6, 21
"/opt/projects/swiftkube/vendor/github.com/Microsoft/hcsshim/internal/hcs/schema2/virtual_p_mem_device.go", "Go", 14, 0, 0, 0, 0, 0, 5, 19
"/opt/projects/swiftkube/vendor/github.com/Microsoft/hcsshim/internal/hcs/schema2/virtual_pci_device.go", "Go", 14, 0, 0, 0, 0, 0, 3, 17
"/opt/projects/swiftkube/vendor/github.com/Microsoft/hcsshim/internal/hcs/schema2/virtual_pci_function.go", "Go", 15, 0, 0, 0, 0, 0, 4, 19
"/opt/projects/swiftkube/vendor/github.com/Microsoft/hcsshim/internal/hcs/schema2/virtual_smb.go", "Go", 13, 0, 0, 0, 0, 0, 4, 17
"/opt/projects/swiftkube/vendor/github.com/Microsoft/hcsshim/internal/hcs/schema2/virtual_smb_share.go", "Go", 15, 0, 0, 0, 0, 0, 6, 21
"/opt/projects/swiftkube/vendor/github.com/Microsoft/hcsshim/internal/hcs/schema2/virtual_smb_share_options.go", "Go", 44, 0, 0, 0, 0, 0, 19, 63
"/opt/projects/swiftkube/vendor/github.com/Microsoft/hcsshim/internal/hcs/schema2/vm_memory.go", "Go", 18, 0, 0, 0, 0, 0, 9, 27
"/opt/projects/swiftkube/vendor/github.com/Microsoft/hcsshim/internal/hcs/schema2/vm_processor_limits.go", "Go", 20, 0, 0, 0, 0, 0, 3, 23
"/opt/projects/swiftkube/vendor/github.com/Microsoft/hcsshim/internal/hcs/schema2/windows_crash_reporting.go", "Go", 13, 0, 0, 0, 0, 0, 4, 17
"/opt/projects/swiftkube/vendor/github.com/Microsoft/hcsshim/internal/hcs/service.go", "Go", 42, 0, 0, 0, 0, 0, 8, 50
"/opt/projects/swiftkube/vendor/github.com/Microsoft/hcsshim/internal/hcs/system.go", "Go", 529, 0, 0, 0, 0, 0, 117, 646
"/opt/projects/swiftkube/vendor/github.com/Microsoft/hcsshim/internal/hcs/utils.go", "Go", 55, 0, 0, 0, 0, 0, 8, 63
"/opt/projects/swiftkube/vendor/github.com/Microsoft/hcsshim/internal/hcs/waithelper.go", "Go", 60, 0, 0, 0, 0, 0, 9, 69
"/opt/projects/swiftkube/vendor/github.com/Microsoft/hcsshim/internal/hcserror/hcserror.go", "Go", 41, 0, 0, 0, 0, 0, 7, 48
"/opt/projects/swiftkube/vendor/github.com/Microsoft/hcsshim/internal/hns/hns.go", "Go", 16, 0, 0, 0, 0, 0, 8, 24
"/opt/projects/swiftkube/vendor/github.com/Microsoft/hcsshim/internal/hns/hnsendpoint.go", "Go", 287, 0, 0, 0, 0, 0, 51, 338
"/opt/projects/swiftkube/vendor/github.com/Microsoft/hcsshim/internal/hns/hnsfuncs.go", "Go", 40, 0, 0, 0, 0, 0, 10, 50
"/opt/projects/swiftkube/vendor/github.com/Microsoft/hcsshim/internal/hns/hnsglobals.go", "Go", 22, 0, 0, 0, 0, 0, 7, 29
"/opt/projects/swiftkube/vendor/github.com/Microsoft/hcsshim/internal/hns/hnsnetwork.go", "Go", 121, 0, 0, 0, 0, 0, 21, 142
"/opt/projects/swiftkube/vendor/github.com/Microsoft/hcsshim/internal/hns/hnspolicy.go", "Go", 93, 0, 0, 0, 0, 0, 17, 110
"/opt/projects/swiftkube/vendor/github.com/Microsoft/hcsshim/internal/hns/hnspolicylist.go", "Go", 164, 0, 0, 0, 0, 0, 38, 202
"/opt/projects/swiftkube/vendor/github.com/Microsoft/hcsshim/internal/hns/hnssupport.go", "Go", 41, 0, 0, 0, 0, 0, 9, 50
"/opt/projects/swiftkube/vendor/github.com/Microsoft/hcsshim/internal/hns/namespace.go", "Go", 99, 0, 0, 0, 0, 0, 13, 112
"/opt/projects/swiftkube/vendor/github.com/Microsoft/hcsshim/internal/hns/zsyscall_windows.go", "Go", 65, 0, 0, 0, 0, 0, 12, 77
"/opt/projects/swiftkube/vendor/github.com/Microsoft/hcsshim/internal/interop/interop.go", "Go", 18, 0, 0, 0, 0, 0, 6, 24
"/opt/projects/swiftkube/vendor/github.com/Microsoft/hcsshim/internal/interop/zsyscall_windows.go", "Go", 38, 0, 0, 0, 0, 0, 11, 49
"/opt/projects/swiftkube/vendor/github.com/Microsoft/hcsshim/internal/log/g.go", "Go", 20, 0, 0, 0, 0, 0, 4, 24
"/opt/projects/swiftkube/vendor/github.com/Microsoft/hcsshim/internal/logfields/fields.go", "Go", 22, 0, 0, 0, 0, 0, 11, 33
"/opt/projects/swiftkube/vendor/github.com/Microsoft/hcsshim/internal/longpath/longpath.go", "Go", 22, 0, 0, 0, 0, 0, 3, 25
"/opt/projects/swiftkube/vendor/github.com/Microsoft/hcsshim/internal/mergemaps/merge.go", "Go", 49, 0, 0, 0, 0, 0, 4, 53
"/opt/projects/swiftkube/vendor/github.com/Microsoft/hcsshim/internal/oc/exporter.go", "Go", 38, 0, 0, 0, 0, 0, 6, 44
"/opt/projects/swiftkube/vendor/github.com/Microsoft/hcsshim/internal/oc/span.go", "Go", 15, 0, 0, 0, 0, 0, 3, 18
"/opt/projects/swiftkube/vendor/github.com/Microsoft/hcsshim/internal/safefile/safeopen.go", "Go", 340, 0, 0, 0, 0, 0, 36, 376
"/opt/projects/swiftkube/vendor/github.com/Microsoft/hcsshim/internal/timeout/timeout.go", "Go", 59, 0, 0, 0, 0, 0, 16, 75
"/opt/projects/swiftkube/vendor/github.com/Microsoft/hcsshim/internal/vmcompute/vmcompute.go", "Go", 546, 0, 0, 0, 0, 0, 65, 611
"/opt/projects/swiftkube/vendor/github.com/Microsoft/hcsshim/internal/vmcompute/zsyscall_windows.go", "Go", 530, 0, 0, 0, 0, 0, 52, 582
"/opt/projects/swiftkube/vendor/github.com/Microsoft/hcsshim/internal/wclayer/activatelayer.go", "Go", 23, 0, 0, 0, 0, 0, 5, 28
"/opt/projects/swiftkube/vendor/github.com/Microsoft/hcsshim/internal/wclayer/baselayer.go", "Go", 156, 0, 0, 0, 0, 0, 27, 183
"/opt/projects/swiftkube/vendor/github.com/Microsoft/hcsshim/internal/wclayer/createlayer.go", "Go", 23, 0, 0, 0, 0, 0, 5, 28
"/opt/projects/swiftkube/vendor/github.com/Microsoft/hcsshim/internal/wclayer/createscratchlayer.go", "Go", 29, 0, 0, 0, 0, 0, 6, 35
"/opt/projects/swiftkube/vendor/github.com/Microsoft/hcsshim/internal/wclayer/deactivatelayer.go", "Go", 20, 0, 0, 0, 0, 0, 5, 25
"/opt/projects/swiftkube/vendor/github.com/Microsoft/hcsshim/internal/wclayer/destroylayer.go", "Go", 21, 0, 0, 0, 0, 0, 5, 26
"/opt/projects/swiftkube/vendor/github.com/Microsoft/hcsshim/internal/wclayer/expandscratchsize.go", "Go", 126, 0, 0, 0, 0, 0, 15, 141
"/opt/projects/swiftkube/vendor/github.com/Microsoft/hcsshim/internal/wclayer/exportlayer.go", "Go", 82, 0, 0, 0, 0, 0, 13, 95
"/opt/projects/swiftkube/vendor/github.com/Microsoft/hcsshim/internal/wclayer/getlayermountpath.go", "Go", 42, 0, 0, 0, 0, 0, 9, 51
"/opt/projects/swiftkube/vendor/github.com/Microsoft/hcsshim/internal/wclayer/getsharedbaseimages.go", "Go", 25, 0, 0, 0, 0, 0, 5, 30
"/opt/projects/swiftkube/vendor/github.com/Microsoft/hcsshim/internal/wclayer/grantvmaccess.go", "Go", 22, 0, 0, 0, 0, 0, 5, 27
"/opt/projects/swiftkube/vendor/github.com/Microsoft/hcsshim/internal/wclayer/importlayer.go", "Go", 150, 0, 0, 0, 0, 0, 17, 167
"/opt/projects/swiftkube/vendor/github.com/Microsoft/hcsshim/internal/wclayer/layerexists.go", "Go", 24, 0, 0, 0, 0, 0, 5, 29
"/opt/projects/swiftkube/vendor/github.com/Microsoft/hcsshim/internal/wclayer/layerid.go", "Go", 18, 0, 0, 0, 0, 0, 5, 23
"/opt/projects/swiftkube/vendor/github.com/Microsoft/hcsshim/internal/wclayer/layerutils.go", "Go", 77, 0, 0, 0, 0, 0, 21, 98
"/opt/projects/swiftkube/vendor/github.com/Microsoft/hcsshim/internal/wclayer/legacy.go", "Go", 730, 0, 0, 0, 0, 0, 82, 812
"/opt/projects/swiftkube/vendor/github.com/Microsoft/hcsshim/internal/wclayer/nametoguid.go", "Go", 25, 0, 0, 0, 0, 0, 5, 30
"/opt/projects/swiftkube/vendor/github.com/Microsoft/hcsshim/internal/wclayer/preparelayer.go", "Go", 38, 0, 0, 0, 0, 0, 7, 45
"/opt/projects/swiftkube/vendor/github.com/Microsoft/hcsshim/internal/wclayer/processimage.go", "Go", 35, 0, 0, 0, 0, 0, 7, 42
"/opt/projects/swiftkube/vendor/github.com/Microsoft/hcsshim/internal/wclayer/unpreparelayer.go", "Go", 21, 0, 0, 0, 0, 0, 5, 26
"/opt/projects/swiftkube/vendor/github.com/Microsoft/hcsshim/internal/wclayer/wclayer.go", "Go", 28, 0, 0, 0, 0, 0, 8, 36
"/opt/projects/swiftkube/vendor/github.com/Microsoft/hcsshim/internal/wclayer/zsyscall_windows.go", "Go", 520, 0, 0, 0, 0, 0, 50, 570
"/opt/projects/swiftkube/vendor/github.com/Microsoft/hcsshim/internal/winapi/devices.go", "Go", 10, 0, 0, 0, 0, 0, 4, 14
"/opt/projects/swiftkube/vendor/github.com/Microsoft/hcsshim/internal/winapi/errors.go", "Go", 11, 0, 0, 0, 0, 0, 5, 16
"/opt/projects/swiftkube/vendor/github.com/Microsoft/hcsshim/internal/winapi/filesystem.go", "Go", 94, 0, 0, 0, 0, 0, 17, 111
"/opt/projects/swiftkube/vendor/github.com/Microsoft/hcsshim/internal/winapi/iocp.go", "Go", 2, 0, 0, 0, 0, 0, 2, 4
"/opt/projects/swiftkube/vendor/github.com/Microsoft/hcsshim/internal/winapi/jobobject.go", "Go", 189, 0, 0, 0, 0, 0, 27, 216
"/opt/projects/swiftkube/vendor/github.com/Microsoft/hcsshim/internal/winapi/logon.go", "Go", 27, 0, 0, 0, 0, 0, 4, 31
"/opt/projects/swiftkube/vendor/github.com/Microsoft/hcsshim/internal/winapi/memory.go", "Go", 22, 0, 0, 0, 0, 0, 6, 28
"/opt/projects/swiftkube/vendor/github.com/Microsoft/hcsshim/internal/winapi/net.go", "Go", 2, 0, 0, 0, 0, 0, 2, 4
"/opt/projects/swiftkube/vendor/github.com/Microsoft/hcsshim/internal/winapi/path.go", "Go", 10, 0, 0, 0, 0, 0, 2, 12
"/opt/projects/swiftkube/vendor/github.com/Microsoft/hcsshim/internal/winapi/process.go", "Go", 8, 0, 0, 0, 0, 0, 3, 11
"/opt/projects/swiftkube/vendor/github.com/Microsoft/hcsshim/internal/winapi/processor.go", "Go", 5, 0, 0, 0, 0, 0, 3, 8
"/opt/projects/swiftkube/vendor/github.com/Microsoft/hcsshim/internal/winapi/system.go", "Go", 47, 0, 0, 0, 0, 0, 6, 53
"/opt/projects/swiftkube/vendor/github.com/Microsoft/hcsshim/internal/winapi/thread.go", "Go", 11, 0, 0, 0, 0, 0, 2, 13
"/opt/projects/swiftkube/vendor/github.com/Microsoft/hcsshim/internal/winapi/utils.go", "Go", 69, 0, 0, 0, 0, 0, 12, 81
"/opt/projects/swiftkube/vendor/github.com/Microsoft/hcsshim/internal/winapi/winapi.go", "Go", 4, 0, 0, 0, 0, 0, 2, 6
"/opt/projects/swiftkube/vendor/github.com/Microsoft/hcsshim/internal/winapi/zsyscall_windows.go", "Go", 333, 0, 0, 0, 0, 0, 39, 372
"/opt/projects/swiftkube/vendor/github.com/Microsoft/hcsshim/layer.go", "Go", 91, 0, 0, 0, 0, 0, 17, 108
"/opt/projects/swiftkube/vendor/github.com/Microsoft/hcsshim/osversion/osversion_windows.go", "Go", 43, 0, 0, 0, 0, 0, 8, 51
"/opt/projects/swiftkube/vendor/github.com/Microsoft/hcsshim/osversion/windowsbuilds.go", "Go", 29, 0, 0, 0, 0, 0, 10, 39
"/opt/projects/swiftkube/vendor/github.com/Microsoft/hcsshim/process.go", "Go", 86, 0, 0, 0, 0, 0, 13, 99
"/opt/projects/swiftkube/vendor/github.com/Microsoft/hcsshim/zsyscall_windows.go", "Go", 44, 0, 0, 0, 0, 0, 11, 55
"/opt/projects/swiftkube/vendor/github.com/NYTimes/gziphandler/gzip.go", "Go", 460, 0, 0, 0, 0, 0, 73, 533
"/opt/projects/swiftkube/vendor/github.com/NYTimes/gziphandler/gzip_go18.go", "Go", 35, 0, 0, 0, 0, 0, 9, 44
"/opt/projects/swiftkube/vendor/github.com/antlr/antlr4/runtime/Go/antlr/v4/antlrdoc.go", "Go", 48, 0, 0, 0, 0, 0, 21, 69
"/opt/projects/swiftkube/vendor/github.com/antlr/antlr4/runtime/Go/antlr/v4/atn.go", "Go", 141, 0, 0, 0, 0, 0, 36, 177
"/opt/projects/swiftkube/vendor/github.com/antlr/antlr4/runtime/Go/antlr/v4/atn_config.go", "Go", 246, 0, 0, 0, 0, 0, 58, 304
"/opt/projects/swiftkube/vendor/github.com/antlr/antlr4/runtime/Go/antlr/v4/atn_config_set.go", "Go", 340, 0, 0, 0, 0, 0, 102, 442
"/opt/projects/swiftkube/vendor/github.com/antlr/antlr4/runtime/Go/antlr/v4/atn_deserialization_options.go", "Go", 49, 0, 0, 0, 0, 0, 13, 62
"/opt/projects/swiftkube/vendor/github.com/antlr/antlr4/runtime/Go/antlr/v4/atn_deserializer.go", "Go", 503, 0, 0, 0, 0, 0, 181, 684
"/opt/projects/swiftkube/vendor/github.com/antlr/antlr4/runtime/Go/antlr/v4/atn_simulator.go", "Go", 37, 0, 0, 0, 0, 0, 14, 51
"/opt/projects/swiftkube/vendor/github.com/antlr/antlr4/runtime/Go/antlr/v4/atn_state.go", "Go", 288, 0, 0, 0, 0, 0, 106, 394
"/opt/projects/swiftkube/vendor/github.com/antlr/antlr4/runtime/Go/antlr/v4/atn_type.go", "Go", 9, 0, 0, 0, 0, 0, 3, 12
"/opt/projects/swiftkube/vendor/github.com/antlr/antlr4/runtime/Go/antlr/v4/char_stream.go", "Go", 10, 0, 0, 0, 0, 0, 3, 13
"/opt/projects/swiftkube/vendor/github.com/antlr/antlr4/runtime/Go/antlr/v4/common_token_factory.go", "Go", 45, 0, 0, 0, 0, 0, 12, 57
"/opt/projects/swiftkube/vendor/github.com/antlr/antlr4/runtime/Go/antlr/v4/common_token_stream.go", "Go", 345, 0, 0, 0, 0, 0, 105, 450
"/opt/projects/swiftkube/vendor/github.com/antlr/antlr4/runtime/Go/antlr/v4/comparators.go", "Go", 117, 0, 0, 0, 0, 0, 31, 148
"/opt/projects/swiftkube/vendor/github.com/antlr/antlr4/runtime/Go/antlr/v4/dfa.go", "Go", 119, 0, 0, 0, 0, 0, 30, 149
"/opt/projects/swiftkube/vendor/github.com/antlr/antlr4/runtime/Go/antlr/v4/dfa_serializer.go", "Go", 125, 0, 0, 0, 0, 0, 34, 159
"/opt/projects/swiftkube/vendor/github.com/antlr/antlr4/runtime/Go/antlr/v4/dfa_state.go", "Go", 140, 0, 0, 0, 0, 0, 30, 170
"/opt/projects/swiftkube/vendor/github.com/antlr/antlr4/runtime/Go/antlr/v4/diagnostic_error_listener.go", "Go", 93, 0, 0, 0, 0, 0, 17, 110
"/opt/projects/swiftkube/vendor/github.com/antlr/antlr4/runtime/Go/antlr/v4/error_listener.go", "Go", 84, 0, 0, 0, 0, 0, 21, 105
"/opt/projects/swiftkube/vendor/github.com/antlr/antlr4/runtime/Go/antlr/v4/error_strategy.go", "Go", 682, 0, 0, 0, 0, 0, 53, 735
"/opt/projects/swiftkube/vendor/github.com/antlr/antlr4/runtime/Go/antlr/v4/errors.go", "Go", 186, 0, 0, 0, 0, 0, 53, 239
"/opt/projects/swiftkube/vendor/github.com/antlr/antlr4/runtime/Go/antlr/v4/file_stream.go", "Go", 35, 0, 0, 0, 0, 0, 15, 50
"/opt/projects/swiftkube/vendor/github.com/antlr/antlr4/runtime/Go/antlr/v4/input_stream.go", "Go", 88, 0, 0, 0, 0, 0, 26, 114
"/opt/projects/swiftkube/vendor/github.com/antlr/antlr4/runtime/Go/antlr/v4/int_stream.go", "Go", 14, 0, 0, 0, 0, 0, 3, 17
"/opt/projects/swiftkube/vendor/github.com/antlr/antlr4/runtime/Go/antlr/v4/interval_set.go", "Go", 268, 0, 0, 0, 0, 0, 45, 313
"/opt/projects/swiftkube/vendor/github.com/antlr/antlr4/runtime/Go/antlr/v4/jcollect.go", "Go", 166, 0, 0, 0, 0, 0, 33, 199
"/opt/projects/swiftkube/vendor/github.com/antlr/antlr4/runtime/Go/antlr/v4/lexer.go", "Go", 346, 0, 0, 0, 0, 0, 71, 417
"/opt/projects/swiftkube/vendor/github.com/antlr/antlr4/runtime/Go/antlr/v4/lexer_action.go", "Go", 352, 0, 0, 0, 0, 0, 81, 433
"/opt/projects/swiftkube/vendor/github.com/antlr/antlr4/runtime/Go/antlr/v4/lexer_action_executor.go", "Go", 164, 0, 0, 0, 0, 0, 23, 187
"/opt/projects/swiftkube/vendor/github.com/antlr/antlr4/runtime/Go/antlr/v4/lexer_atn_simulator.go", "Go", 592, 0, 0, 0, 0, 0, 93, 685
"/opt/projects/swiftkube/vendor/github.com/antlr/antlr4/runtime/Go/antlr/v4/ll1_analyzer.go", "Go", 189, 0, 0, 0, 0, 0, 28, 217
"/opt/projects/swiftkube/vendor/github.com/antlr/antlr4/runtime/Go/antlr/v4/parser.go", "Go", 617, 0, 0, 0, 0, 0, 92, 709
"/opt/projects/swiftkube/vendor/github.com/antlr/antlr4/runtime/Go/antlr/v4/parser_atn_simulator.go", "Go", 1417, 0, 0, 0, 0, 0, 143, 1560
"/opt/projects/swiftkube/vendor/github.com/antlr/antlr4/runtime/Go/antlr/v4/parser_rule_context.go", "Go", 285, 0, 0, 0, 0, 0, 78, 363
"/opt/projects/swiftkube/vendor/github.com/antlr/antlr4/runtime/Go/antlr/v4/prediction_context.go", "Go", 707, 0, 0, 0, 0, 0, 100, 807
"/opt/projects/swiftkube/vendor/github.com/antlr/antlr4/runtime/Go/antlr/v4/prediction_mode.go", "Go", 502, 0, 0, 0, 0, 0, 28, 530
"/opt/projects/swiftkube/vendor/github.com/antlr/antlr4/runtime/Go/antlr/v4/recognizer.go", "Go", 185, 0, 0, 0, 0, 0, 32, 217
"/opt/projects/swiftkube/vendor/github.com/antlr/antlr4/runtime/Go/antlr/v4/rule_context.go", "Go", 91, 0, 0, 0, 0, 0, 24, 115
"/opt/projects/swiftkube/vendor/github.com/antlr/antlr4/runtime/Go/antlr/v4/semantic_context.go", "Go", 385, 0, 0, 0, 0, 0, 85, 470
"/opt/projects/swiftkube/vendor/github.com/antlr/antlr4/runtime/Go/antlr/v4/token.go", "Go", 168, 0, 0, 0, 0, 0, 42, 210
"/opt/projects/swiftkube/vendor/github.com/antlr/antlr4/runtime/Go/antlr/v4/token_source.go", "Go", 15, 0, 0, 0, 0, 0, 3, 18
"/opt/projects/swiftkube/vendor/github.com/antlr/antlr4/runtime/Go/antlr/v4/token_stream.go", "Go", 15, 0, 0, 0, 0, 0, 6, 21
"/opt/projects/swiftkube/vendor/github.com/antlr/antlr4/runtime/Go/antlr/v4/tokenstream_rewriter.go", "Go", 580, 0, 0, 0, 0, 0, 80, 660
"/opt/projects/swiftkube/vendor/github.com/antlr/antlr4/runtime/Go/antlr/v4/trace_listener.go", "Go", 24, 0, 0, 0, 0, 0, 9, 33
"/opt/projects/swiftkube/vendor/github.com/antlr/antlr4/runtime/Go/antlr/v4/transition.go", "Go", 328, 0, 0, 0, 0, 0, 101, 429
"/opt/projects/swiftkube/vendor/github.com/antlr/antlr4/runtime/Go/antlr/v4/tree.go", "Go", 197, 0, 0, 0, 0, 0, 57, 254
"/opt/projects/swiftkube/vendor/github.com/antlr/antlr4/runtime/Go/antlr/v4/trees.go", "Go", 117, 0, 0, 0, 0, 0, 22, 139
"/opt/projects/swiftkube/vendor/github.com/antlr/antlr4/runtime/Go/antlr/v4/utils.go", "Go", 284, 0, 0, 0, 0, 0, 69, 353
"/opt/projects/swiftkube/vendor/github.com/antlr/antlr4/runtime/Go/antlr/v4/utils_set.go", "Go", 193, 0, 0, 0, 0, 0, 43, 236
"/opt/projects/swiftkube/vendor/github.com/armon/circbuf/circbuf.go", "Go", 79, 0, 0, 0, 0, 0, 14, 93
"/opt/projects/swiftkube/vendor/github.com/asaskevich/govalidator/arrays.go", "Go", 50, 0, 0, 0, 0, 0, 9, 59
"/opt/projects/swiftkube/vendor/github.com/asaskevich/govalidator/converter.go", "Go", 56, 0, 0, 0, 0, 0, 9, 65
"/opt/projects/swiftkube/vendor/github.com/asaskevich/govalidator/error.go", "Go", 34, 0, 0, 0, 0, 0, 10, 44
"/opt/projects/swiftkube/vendor/github.com/asaskevich/govalidator/numerics.go", "Go", 82, 0, 0, 0, 0, 0, 16, 98
"/opt/projects/swiftkube/vendor/github.com/asaskevich/govalidator/patterns.go", "Go", 97, 0, 0, 0, 0, 0, 5, 102
"/opt/projects/swiftkube/vendor/github.com/asaskevich/govalidator/types.go", "Go", 613, 0, 0, 0, 0, 0, 24, 637
"/opt/projects/swiftkube/vendor/github.com/asaskevich/govalidator/utils.go", "Go", 233, 0, 0, 0, 0, 0, 38, 271
"/opt/projects/swiftkube/vendor/github.com/asaskevich/govalidator/validator.go", "Go", 1130, 0, 0, 0, 0, 0, 149, 1279
"/opt/projects/swiftkube/vendor/github.com/beorn7/perks/quantile/stream.go", "Go", 282, 0, 0, 0, 0, 0, 35, 317
"/opt/projects/swiftkube/vendor/github.com/blang/semver/v4/json.go", "Go", 17, 0, 0, 0, 0, 0, 7, 24
"/opt/projects/swiftkube/vendor/github.com/blang/semver/v4/range.go", "Go", 374, 0, 0, 0, 0, 0, 43, 417
"/opt/projects/swiftkube/vendor/github.com/blang/semver/v4/semver.go", "Go", 414, 0, 0, 0, 0, 0, 63, 477
"/opt/projects/swiftkube/vendor/github.com/blang/semver/v4/sort.go", "Go", 22, 0, 0, 0, 0, 0, 7, 29
"/opt/projects/swiftkube/vendor/github.com/blang/semver/v4/sql.go", "Go", 25, 0, 0, 0, 0, 0, 6, 31
"/opt/projects/swiftkube/vendor/github.com/cenkalti/backoff/v4/backoff.go", "Go", 53, 0, 0, 0, 0, 0, 14, 67
"/opt/projects/swiftkube/vendor/github.com/cenkalti/backoff/v4/context.go", "Go", 53, 0, 0, 0, 0, 0, 10, 63
"/opt/projects/swiftkube/vendor/github.com/cenkalti/backoff/v4/exponential.go", "Go", 133, 0, 0, 0, 0, 0, 29, 162
"/opt/projects/swiftkube/vendor/github.com/cenkalti/backoff/v4/retry.go", "Go", 120, 0, 0, 0, 0, 0, 27, 147
"/opt/projects/swiftkube/vendor/github.com/cenkalti/backoff/v4/ticker.go", "Go", 85, 0, 0, 0, 0, 0, 13, 98
"/opt/projects/swiftkube/vendor/github.com/cenkalti/backoff/v4/timer.go", "Go", 29, 0, 0, 0, 0, 0, 7, 36
"/opt/projects/swiftkube/vendor/github.com/cenkalti/backoff/v4/tries.go", "Go", 32, 0, 0, 0, 0, 0, 7, 39
"/opt/projects/swiftkube/vendor/github.com/cespare/xxhash/v2/xxhash.go", "Go", 197, 0, 0, 0, 0, 0, 32, 229
"/opt/projects/swiftkube/vendor/github.com/cespare/xxhash/v2/xxhash_asm.go", "Go", 12, 0, 0, 0, 0, 0, 4, 16
"/opt/projects/swiftkube/vendor/github.com/cespare/xxhash/v2/xxhash_other.go", "Go", 67, 0, 0, 0, 0, 0, 10, 77
"/opt/projects/swiftkube/vendor/github.com/cespare/xxhash/v2/xxhash_safe.go", "Go", 12, 0, 0, 0, 0, 0, 5, 17
"/opt/projects/swiftkube/vendor/github.com/cespare/xxhash/v2/xxhash_unsafe.go", "Go", 50, 0, 0, 0, 0, 0, 9, 59
"/opt/projects/swiftkube/vendor/github.com/chai2010/gettext-go/doc.go", "Go", 56, 0, 0, 0, 0, 0, 12, 68
"/opt/projects/swiftkube/vendor/github.com/chai2010/gettext-go/fs.go", "Go", 72, 0, 0, 0, 0, 0, 13, 85
"/opt/projects/swiftkube/vendor/github.com/chai2010/gettext-go/fs_json.go", "Go", 58, 0, 0, 0, 0, 0, 9, 67
"/opt/projects/swiftkube/vendor/github.com/chai2010/gettext-go/fs_os.go", "Go", 80, 0, 0, 0, 0, 0, 12, 92
"/opt/projects/swiftkube/vendor/github.com/chai2010/gettext-go/fs_zip.go", "Go", 127, 0, 0, 0, 0, 0, 16, 143
"/opt/projects/swiftkube/vendor/github.com/chai2010/gettext-go/gettext.go", "Go", 194, 0, 0, 0, 0, 0, 26, 220
"/opt/projects/swiftkube/vendor/github.com/chai2010/gettext-go/locale.go", "Go", 171, 0, 0, 0, 0, 0, 35, 206
"/opt/projects/swiftkube/vendor/github.com/chai2010/gettext-go/mo/doc.go", "Go", 68, 0, 0, 0, 0, 0, 7, 75
"/opt/projects/swiftkube/vendor/github.com/chai2010/gettext-go/mo/encoder.go", "Go", 93, 0, 0, 0, 0, 0, 13, 106
"/opt/projects/swiftkube/vendor/github.com/chai2010/gettext-go/mo/file.go", "Go", 176, 0, 0, 0, 0, 0, 22, 198
"/opt/projects/swiftkube/vendor/github.com/chai2010/gettext-go/mo/header.go", "Go", 103, 0, 0, 0, 0, 0, 7, 110
"/opt/projects/swiftkube/vendor/github.com/chai2010/gettext-go/mo/message.go", "Go", 47, 0, 0, 0, 0, 0, 6, 53
"/opt/projects/swiftkube/vendor/github.com/chai2010/gettext-go/mo/util.go", "Go", 105, 0, 0, 0, 0, 0, 6, 111
"/opt/projects/swiftkube/vendor/github.com/chai2010/gettext-go/plural/doc.go", "Go", 31, 0, 0, 0, 0, 0, 6, 37
"/opt/projects/swiftkube/vendor/github.com/chai2010/gettext-go/plural/formula.go", "Go", 175, 0, 0, 0, 0, 0, 7, 182
"/opt/projects/swiftkube/vendor/github.com/chai2010/gettext-go/plural/table.go", "Go", 53, 0, 0, 0, 0, 0, 3, 56
"/opt/projects/swiftkube/vendor/github.com/chai2010/gettext-go/po/comment.go", "Go", 253, 0, 0, 0, 0, 0, 18, 271
"/opt/projects/swiftkube/vendor/github.com/chai2010/gettext-go/po/doc.go", "Go", 20, 0, 0, 0, 0, 0, 5, 25
"/opt/projects/swiftkube/vendor/github.com/chai2010/gettext-go/po/file.go", "Go", 71, 0, 0, 0, 0, 0, 11, 82
"/opt/projects/swiftkube/vendor/github.com/chai2010/gettext-go/po/header.go", "Go", 101, 0, 0, 0, 0, 0, 6, 107
"/opt/projects/swiftkube/vendor/github.com/chai2010/gettext-go/po/line_reader.go", "Go", 53, 0, 0, 0, 0, 0, 10, 63
"/opt/projects/swiftkube/vendor/github.com/chai2010/gettext-go/po/message.go", "Go", 179, 0, 0, 0, 0, 0, 15, 194
"/opt/projects/swiftkube/vendor/github.com/chai2010/gettext-go/po/re.go", "Go", 50, 0, 0, 0, 0, 0, 9, 59
"/opt/projects/swiftkube/vendor/github.com/chai2010/gettext-go/po/util.go", "Go", 109, 0, 0, 0, 0, 0, 6, 115
"/opt/projects/swiftkube/vendor/github.com/chai2010/gettext-go/tr.go", "Go", 158, 0, 0, 0, 0, 0, 18, 176
"/opt/projects/swiftkube/vendor/github.com/chai2010/gettext-go/util.go", "Go", 30, 0, 0, 0, 0, 0, 5, 35
"/opt/projects/swiftkube/vendor/github.com/checkpoint-restore/go-criu/v5/features.go", "Go", 38, 0, 0, 0, 0, 0, 8, 46
"/opt/projects/swiftkube/vendor/github.com/checkpoint-restore/go-criu/v5/main.go", "Go", 218, 0, 0, 0, 0, 0, 47, 265
"/opt/projects/swiftkube/vendor/github.com/checkpoint-restore/go-criu/v5/notify.go", "Go", 51, 0, 0, 0, 0, 0, 12, 63
"/opt/projects/swiftkube/vendor/github.com/checkpoint-restore/go-criu/v5/rpc/rpc.pb.go", "Go", 1983, 0, 0, 0, 0, 0, 255, 2238
"/opt/projects/swiftkube/vendor/github.com/checkpoint-restore/go-criu/v5/rpc/rpc.proto", "Protocol Buffers", 0, 0, 192, 0, 0, 1, 47, 240
"/opt/projects/swiftkube/vendor/github.com/cilium/ebpf/asm/alu.go", "Go", 131, 0, 0, 0, 0, 0, 19, 150
"/opt/projects/swiftkube/vendor/github.com/cilium/ebpf/asm/alu_string.go", "Go", 97, 0, 0, 0, 0, 0, 11, 108
"/opt/projects/swiftkube/vendor/github.com/cilium/ebpf/asm/doc.go", "Go", 2, 0, 0, 0, 0, 0, 1, 3
"/opt/projects/swiftkube/vendor/github.com/cilium/ebpf/asm/func.go", "Go", 236, 0, 0, 0, 0, 0, 7, 243
"/opt/projects/swiftkube/vendor/github.com/cilium/ebpf/asm/func_string.go", "Go", 221, 0, 0, 0, 0, 0, 7, 228
"/opt/projects/swiftkube/vendor/github.com/cilium/ebpf/asm/instruction.go", "Go", 714, 0, 0, 0, 0, 0, 146, 860
"/opt/projects/swiftkube/vendor/github.com/cilium/ebpf/asm/jump.go", "Go", 113, 0, 0, 0, 0, 0, 15, 128
"/opt/projects/swiftkube/vendor/github.com/cilium/ebpf/asm/jump_string.go", "Go", 47, 0, 0, 0, 0, 0, 7, 54
"/opt/projects/swiftkube/vendor/github.com/cilium/ebpf/asm/load_store.go", "Go", 178, 0, 0, 0, 0, 0, 27, 205
"/opt/projects/swiftkube/vendor/github.com/cilium/ebpf/asm/load_store_string.go", "Go", 73, 0, 0, 0, 0, 0, 8, 81
"/opt/projects/swiftkube/vendor/github.com/cilium/ebpf/asm/metadata.go", "Go", 69, 0, 0, 0, 0, 0, 12, 81
"/opt/projects/swiftkube/vendor/github.com/cilium/ebpf/asm/opcode.go", "Go", 225, 0, 0, 0, 0, 0, 47, 272
"/opt/projects/swiftkube/vendor/github.com/cilium/ebpf/asm/opcode_string.go", "Go", 24, 0, 0, 0, 0, 0, 7, 31
"/opt/projects/swiftkube/vendor/github.com/cilium/ebpf/asm/register.go", "Go", 42, 0, 0, 0, 0, 0, 9, 51
"/opt/projects/swiftkube/vendor/github.com/cilium/ebpf/attachtype_string.go", "Go", 59, 0, 0, 0, 0, 0, 7, 66
"/opt/projects/swiftkube/vendor/github.com/cilium/ebpf/btf/btf.go", "Go", 739, 0, 0, 0, 0, 0, 159, 898
"/opt/projects/swiftkube/vendor/github.com/cilium/ebpf/btf/btf_types.go", "Go", 293, 0, 0, 0, 0, 0, 51, 344
"/opt/projects/swiftkube/vendor/github.com/cilium/ebpf/btf/btf_types_string.go", "Go", 35, 0, 0, 0, 0, 0, 10, 45
"/opt/projects/swiftkube/vendor/github.com/cilium/ebpf/btf/core.go", "Go", 818, 0, 0, 0, 0, 0, 155, 973
"/opt/projects/swiftkube/vendor/github.com/cilium/ebpf/btf/doc.go", "Go", 5, 0, 0, 0, 0, 0, 1, 6
"/opt/projects/swiftkube/vendor/github.com/cilium/ebpf/btf/ext_info.go", "Go", 600, 0, 0, 0, 0, 0, 122, 722
"/opt/projects/swiftkube/vendor/github.com/cilium/ebpf/btf/format.go", "Go", 258, 0, 0, 0, 0, 0, 62, 320
"/opt/projects/swiftkube/vendor/github.com/cilium/ebpf/btf/handle.go", "Go", 102, 0, 0, 0, 0, 0, 20, 122
"/opt/projects/swiftkube/vendor/github.com/cilium/ebpf/btf/strings.go", "Go", 110, 0, 0, 0, 0, 0, 19, 129
"/opt/projects/swiftkube/vendor/github.com/cilium/ebpf/btf/types.go", "Go", 1006, 0, 0, 0, 0, 0, 207, 1213
"/opt/projects/swiftkube/vendor/github.com/cilium/ebpf/collection.go", "Go", 648, 0, 0, 0, 0, 0, 125, 773
"/opt/projects/swiftkube/vendor/github.com/cilium/ebpf/doc.go", "Go", 25, 0, 0, 0, 0, 0, 1, 26
"/opt/projects/swiftkube/vendor/github.com/cilium/ebpf/elf_reader.go", "Go", 1007, 0, 0, 0, 0, 0, 191, 1198
"/opt/projects/swiftkube/vendor/github.com/cilium/ebpf/info.go", "Go", 281, 0, 0, 0, 0, 0, 43, 324
"/opt/projects/swiftkube/vendor/github.com/cilium/ebpf/internal/align.go", "Go", 5, 0, 0, 0, 0, 0, 2, 7
"/opt/projects/swiftkube/vendor/github.com/cilium/ebpf/internal/cpu.go", "Go", 52, 0, 0, 0, 0, 0, 11, 63
"/opt/projects/swiftkube/vendor/github.com/cilium/ebpf/internal/elf.go", "Go", 85, 0, 0, 0, 0, 0, 18, 103
"/opt/projects/swiftkube/vendor/github.com/cilium/ebpf/internal/endian_be.go", "Go", 9, 0, 0, 0, 0, 0, 5, 14
"/opt/projects/swiftkube/vendor/github.com/cilium/ebpf/internal/endian_le.go", "Go", 9, 0, 0, 0, 0, 0, 5, 14
"/opt/projects/swiftkube/vendor/github.com/cilium/ebpf/internal/errors.go", "Go", 173, 0, 0, 0, 0, 0, 34, 207
"/opt/projects/swiftkube/vendor/github.com/cilium/ebpf/internal/feature.go", "Go", 87, 0, 0, 0, 0, 0, 14, 101
"/opt/projects/swiftkube/vendor/github.com/cilium/ebpf/internal/io.go", "Go", 54, 0, 0, 0, 0, 0, 9, 63
"/opt/projects/swiftkube/vendor/github.com/cilium/ebpf/internal/output.go", "Go", 71, 0, 0, 0, 0, 0, 14, 85
"/opt/projects/swiftkube/vendor/github.com/cilium/ebpf/internal/pinning.go", "Go", 66, 0, 0, 0, 0, 0, 12, 78
"/opt/projects/swiftkube/vendor/github.com/cilium/ebpf/internal/sys/doc.go", "Go", 4, 0, 0, 0, 0, 0, 3, 7
"/opt/projects/swiftkube/vendor/github.com/cilium/ebpf/internal/sys/fd.go", "Go", 77, 0, 0, 0, 0, 0, 20, 97
"/opt/projects/swiftkube/vendor/github.com/cilium/ebpf/internal/sys/ptr.go", "Go", 30, 0, 0, 0, 0, 0, 9, 39
"/opt/projects/swiftkube/vendor/github.com/cilium/ebpf/internal/sys/ptr_32_be.go", "Go", 12, 0, 0, 0, 0, 0, 4, 16
"/opt/projects/swiftkube/vendor/github.com/cilium/ebpf/internal/sys/ptr_32_le.go", "Go", 12, 0, 0, 0, 0, 0, 4, 16
"/opt/projects/swiftkube/vendor/github.com/cilium/ebpf/internal/sys/ptr_64.go", "Go", 11, 0, 0, 0, 0, 0, 4, 15
"/opt/projects/swiftkube/vendor/github.com/cilium/ebpf/internal/sys/syscall.go", "Go", 100, 0, 0, 0, 0, 0, 27, 127
"/opt/projects/swiftkube/vendor/github.com/cilium/ebpf/internal/sys/types.go", "Go", 944, 0, 0, 0, 0, 0, 109, 1053
"/opt/projects/swiftkube/vendor/github.com/cilium/ebpf/internal/unix/types_linux.go", "Go", 174, 0, 0, 0, 0, 0, 37, 211
"/opt/projects/swiftkube/vendor/github.com/cilium/ebpf/internal/unix/types_other.go", "Go", 241, 0, 0, 0, 0, 0, 38, 279
"/opt/projects/swiftkube/vendor/github.com/cilium/ebpf/internal/vdso.go", "Go", 129, 0, 0, 0, 0, 0, 22, 151
"/opt/projects/swiftkube/vendor/github.com/cilium/ebpf/internal/version.go", "Go", 104, 0, 0, 0, 0, 0, 19, 123
"/opt/projects/swiftkube/vendor/github.com/cilium/ebpf/link/cgroup.go", "Go", 136, 0, 0, 0, 0, 0, 30, 166
"/opt/projects/swiftkube/vendor/github.com/cilium/ebpf/link/doc.go", "Go", 2, 0, 0, 0, 0, 0, 1, 3
"/opt/projects/swiftkube/vendor/github.com/cilium/ebpf/link/iter.go", "Go", 70, 0, 0, 0, 0, 0, 16, 86
"/opt/projects/swiftkube/vendor/github.com/cilium/ebpf/link/kprobe.go", "Go", 501, 0, 0, 0, 0, 0, 68, 569
"/opt/projects/swiftkube/vendor/github.com/cilium/ebpf/link/link.go", "Go", 269, 0, 0, 0, 0, 0, 45, 314
"/opt/projects/swiftkube/vendor/github.com/cilium/ebpf/link/netns.go", "Go", 30, 0, 0, 0, 0, 0, 7, 37
"/opt/projects/swiftkube/vendor/github.com/cilium/ebpf/link/perf_event.go", "Go", 339, 0, 0, 0, 0, 0, 56, 395
"/opt/projects/swiftkube/vendor/github.com/cilium/ebpf/link/platform.go", "Go", 20, 0, 0, 0, 0, 0, 6, 26
"/opt/projects/swiftkube/vendor/github.com/cilium/ebpf/link/program.go", "Go", 65, 0, 0, 0, 0, 0, 12, 77
"/opt/projects/swiftkube/vendor/github.com/cilium/ebpf/link/raw_tracepoint.go", "Go", 68, 0, 0, 0, 0, 0, 20, 88
"/opt/projects/swiftkube/vendor/github.com/cilium/ebpf/link/socket_filter.go", "Go", 36, 0, 0, 0, 0, 0, 5, 41
"/opt/projects/swiftkube/vendor/github.com/cilium/ebpf/link/syscalls.go", "Go", 92, 0, 0, 0, 0, 0, 12, 104
"/opt/projects/swiftkube/vendor/github.com/cilium/ebpf/link/tracepoint.go", "Go", 67, 0, 0, 0, 0, 0, 11, 78
"/opt/projects/swiftkube/vendor/github.com/cilium/ebpf/link/tracing.go", "Go", 119, 0, 0, 0, 0, 0, 23, 142
"/opt/projects/swiftkube/vendor/github.com/cilium/ebpf/link/uprobe.go", "Go", 322, 0, 0, 0, 0, 0, 52, 374
"/opt/projects/swiftkube/vendor/github.com/cilium/ebpf/link/xdp.go", "Go", 43, 0, 0, 0, 0, 0, 12, 55
"/opt/projects/swiftkube/vendor/github.com/cilium/ebpf/linker.go", "Go", 198, 0, 0, 0, 0, 0, 41, 239
"/opt/projects/swiftkube/vendor/github.com/cilium/ebpf/map.go", "Go", 1205, 0, 0, 0, 0, 0, 220, 1425
"/opt/projects/swiftkube/vendor/github.com/cilium/ebpf/marshalers.go", "Go", 219, 0, 0, 0, 0, 0, 29, 248
"/opt/projects/swiftkube/vendor/github.com/cilium/ebpf/prog.go", "Go", 746, 0, 0, 0, 0, 0, 130, 876
"/opt/projects/swiftkube/vendor/github.com/cilium/ebpf/syscalls.go", "Go", 232, 0, 0, 0, 0, 0, 33, 265
"/opt/projects/swiftkube/vendor/github.com/cilium/ebpf/types.go", "Go", 260, 0, 0, 0, 0, 0, 25, 285
"/opt/projects/swiftkube/vendor/github.com/cilium/ebpf/types_string.go", "Go", 108, 0, 0, 0, 0, 0, 13, 121
"/opt/projects/swiftkube/vendor/github.com/container-storage-interface/spec/lib/go/csi/csi.pb.go", "Go", 6512, 0, 0, 0, 0, 0, 693, 7205
"/opt/projects/swiftkube/vendor/github.com/containerd/cgroups/blkio.go", "Go", 328, 0, 0, 0, 0, 0, 34, 362
"/opt/projects/swiftkube/vendor/github.com/containerd/cgroups/cgroup.go", "Go", 509, 0, 0, 0, 0, 0, 35, 544
"/opt/projects/swiftkube/vendor/github.com/containerd/cgroups/control.go", "Go", 87, 0, 0, 0, 0, 0, 13, 100
"/opt/projects/swiftkube/vendor/github.com/containerd/cgroups/cpu.go", "Go", 112, 0, 0, 0, 0, 0, 14, 126
"/opt/projects/swiftkube/vendor/github.com/containerd/cgroups/cpuacct.go", "Go", 114, 0, 0, 0, 0, 0, 16, 130
"/opt/projects/swiftkube/vendor/github.com/containerd/cgroups/cpuset.go", "Go", 142, 0, 0, 0, 0, 0, 17, 159
"/opt/projects/swiftkube/vendor/github.com/containerd/cgroups/devices.go", "Go", 77, 0, 0, 0, 0, 0, 16, 93
"/opt/projects/swiftkube/vendor/github.com/containerd/cgroups/errors.go", "Go", 38, 0, 0, 0, 0, 0, 10, 48
"/opt/projects/swiftkube/vendor/github.com/containerd/cgroups/freezer.go", "Go", 68, 0, 0, 0, 0, 0, 15, 83
"/opt/projects/swiftkube/vendor/github.com/containerd/cgroups/hierarchy.go", "Go", 15, 0, 0, 0, 0, 0, 6, 21
"/opt/projects/swiftkube/vendor/github.com/containerd/cgroups/hugetlb.go", "Go", 95, 0, 0, 0, 0, 0, 15, 110
"/opt/projects/swiftkube/vendor/github.com/containerd/cgroups/memory.go", "Go", 440, 0, 0, 0, 0, 0, 41, 481
"/opt/projects/swiftkube/vendor/github.com/containerd/cgroups/named.go", "Go", 30, 0, 0, 0, 0, 0, 10, 40
"/opt/projects/swiftkube/vendor/github.com/containerd/cgroups/net_cls.go", "Go", 49, 0, 0, 0, 0, 0, 13, 62
"/opt/projects/swiftkube/vendor/github.com/containerd/cgroups/net_prio.go", "Go", 53, 0, 0, 0, 0, 0, 13, 66
"/opt/projects/swiftkube/vendor/github.com/containerd/cgroups/opts.go", "Go", 49, 0, 0, 0, 0, 0, 13, 62
"/opt/projects/swiftkube/vendor/github.com/containerd/cgroups/paths.go", "Go", 92, 0, 0, 0, 0, 0, 15, 107
"/opt/projects/swiftkube/vendor/github.com/containerd/cgroups/perf_event.go", "Go", 28, 0, 0, 0, 0, 0, 10, 38
"/opt/projects/swiftkube/vendor/github.com/containerd/cgroups/pids.go", "Go", 72, 0, 0, 0, 0, 0, 14, 86
"/opt/projects/swiftkube/vendor/github.com/containerd/cgroups/rdma.go", "Go", 128, 0, 0, 0, 0, 0, 27, 155
"/opt/projects/swiftkube/vendor/github.com/containerd/cgroups/state.go", "Go", 22, 0, 0, 0, 0, 0, 7, 29
"/opt/projects/swiftkube/vendor/github.com/containerd/cgroups/stats/v1/doc.go", "Go", 13, 0, 0, 0, 0, 0, 5, 18
"/opt/projects/swiftkube/vendor/github.com/containerd/cgroups/stats/v1/metrics.pb.go", "Go", 5996, 0, 0, 0, 0, 0, 130, 6126
"/opt/projects/swiftkube/vendor/github.com/containerd/cgroups/stats/v1/metrics.proto", "Protocol Buffers", 0, 0, 132, 0, 0, 7, 20, 159
"/opt/projects/swiftkube/vendor/github.com/containerd/cgroups/subsystem.go", "Go", 100, 0, 0, 0, 0, 0, 17, 117
"/opt/projects/swiftkube/vendor/github.com/containerd/cgroups/systemd.go", "Go", 138, 0, 0, 0, 0, 0, 21, 159
"/opt/projects/swiftkube/vendor/github.com/containerd/cgroups/ticks.go", "Go", 21, 0, 0, 0, 0, 0, 6, 27
"/opt/projects/swiftkube/vendor/github.com/containerd/cgroups/utils.go", "Go", 361, 0, 0, 0, 0, 0, 31, 392
"/opt/projects/swiftkube/vendor/github.com/containerd/cgroups/v1.go", "Go", 66, 0, 0, 0, 0, 0, 8, 74
"/opt/projects/swiftkube/vendor/github.com/containerd/console/console.go", "Go", 74, 0, 0, 0, 0, 0, 14, 88
"/opt/projects/swiftkube/vendor/github.com/containerd/console/console_linux.go", "Go", 257, 0, 0, 0, 0, 0, 24, 281
"/opt/projects/swiftkube/vendor/github.com/containerd/console/console_unix.go", "Go", 132, 0, 0, 0, 0, 0, 25, 157
"/opt/projects/swiftkube/vendor/github.com/containerd/console/console_windows.go", "Go", 175, 0, 0, 0, 0, 0, 42, 217
"/opt/projects/swiftkube/vendor/github.com/containerd/console/console_zos.go", "Go", 138, 0, 0, 0, 0, 0, 26, 164
"/opt/projects/swiftkube/vendor/github.com/containerd/console/pty_freebsd_cgo.go", "Go", 37, 0, 0, 0, 0, 0, 9, 46
"/opt/projects/swiftkube/vendor/github.com/containerd/console/pty_freebsd_nocgo.go", "Go", 28, 0, 0, 0, 0, 0, 9, 37
"/opt/projects/swiftkube/vendor/github.com/containerd/console/pty_unix.go", "Go", 22, 0, 0, 0, 0, 0, 9, 31
"/opt/projects/swiftkube/vendor/github.com/containerd/console/tc_darwin.go", "Go", 35, 0, 0, 0, 0, 0, 10, 45
"/opt/projects/swiftkube/vendor/github.com/containerd/console/tc_freebsd_cgo.go", "Go", 46, 0, 0, 0, 0, 0, 12, 58
"/opt/projects/swiftkube/vendor/github.com/containerd/console/tc_freebsd_nocgo.go", "Go", 44, 0, 0, 0, 0, 0, 12, 56
"/opt/projects/swiftkube/vendor/github.com/containerd/console/tc_linux.go", "Go", 42, 0, 0, 0, 0, 0, 10, 52
"/opt/projects/swiftkube/vendor/github.com/containerd/console/tc_netbsd.go", "Go", 36, 0, 0, 0, 0, 0, 10, 46
"/opt/projects/swiftkube/vendor/github.com/containerd/console/tc_openbsd_cgo.go", "Go", 40, 0, 0, 0, 0, 0, 12, 52
"/opt/projects/swiftkube/vendor/github.com/containerd/console/tc_openbsd_nocgo.go", "Go", 36, 0, 0, 0, 0, 0, 12, 48
"/opt/projects/swiftkube/vendor/github.com/containerd/console/tc_solaris_cgo.go", "Go", 40, 0, 0, 0, 0, 0, 12, 52
"/opt/projects/swiftkube/vendor/github.com/containerd/console/tc_solaris_nocgo.go", "Go", 36, 0, 0, 0, 0, 0, 12, 48
"/opt/projects/swiftkube/vendor/github.com/containerd/console/tc_unix.go", "Go", 74, 0, 0, 0, 0, 0, 18, 92
"/opt/projects/swiftkube/vendor/github.com/containerd/console/tc_zos.go", "Go", 20, 0, 0, 0, 0, 0, 7, 27
"/opt/projects/swiftkube/vendor/github.com/containerd/ttrpc/channel.go", "Go", 153, 0, 0, 0, 0, 0, 30, 183
"/opt/projects/swiftkube/vendor/github.com/containerd/ttrpc/client.go", "Go", 438, 0, 0, 0, 0, 0, 75, 513
"/opt/projects/swiftkube/vendor/github.com/containerd/ttrpc/codec.go", "Go", 34, 0, 0, 0, 0, 0, 10, 44
"/opt/projects/swiftkube/vendor/github.com/containerd/ttrpc/config.go", "Go", 43, 0, 0, 0, 0, 0, 10, 53
"/opt/projects/swiftkube/vendor/github.com/containerd/ttrpc/doc.go", "Go", 19, 0, 0, 0, 0, 0, 5, 24
"/opt/projects/swiftkube/vendor/github.com/containerd/ttrpc/errors.go", "Go", 25, 0, 0, 0, 0, 0, 10, 35
"/opt/projects/swiftkube/vendor/github.com/containerd/ttrpc/handshake.go", "Go", 41, 0, 0, 0, 0, 0, 10, 51
"/opt/projects/swiftkube/vendor/github.com/containerd/ttrpc/interceptor.go", "Go", 48, 0, 0, 0, 0, 0, 18, 66
"/opt/projects/swiftkube/vendor/github.com/containerd/ttrpc/metadata.go", "Go", 89, 0, 0, 0, 0, 0, 19, 108
"/opt/projects/swiftkube/vendor/github.com/containerd/ttrpc/request.pb.go", "Go", 349, 0, 0, 0, 0, 0, 48, 397
"/opt/projects/swiftkube/vendor/github.com/containerd/ttrpc/request.proto", "Protocol Buffers", 0, 0, 22, 0, 0, 0, 8, 30
"/opt/projects/swiftkube/vendor/github.com/containerd/ttrpc/server.go", "Go", 497, 0, 0, 0, 0, 0, 83, 580
"/opt/projects/swiftkube/vendor/github.com/containerd/ttrpc/services.go", "Go", 236, 0, 0, 0, 0, 0, 40, 276
"/opt/projects/swiftkube/vendor/github.com/containerd/ttrpc/stream.go", "Go", 70, 0, 0, 0, 0, 0, 15, 85
"/opt/projects/swiftkube/vendor/github.com/containerd/ttrpc/stream_server.go", "Go", 17, 0, 0, 0, 0, 0, 6, 23
"/opt/projects/swiftkube/vendor/github.com/containerd/ttrpc/test.proto", "Protocol Buffers", 0, 0, 12, 0, 0, 0, 5, 17
"/opt/projects/swiftkube/vendor/github.com/containerd/ttrpc/unixcreds_linux.go", "Go", 87, 0, 0, 0, 0, 0, 19, 106
"/opt/projects/swiftkube/vendor/github.com/coreos/go-semver/semver/semver.go", "Go", 243, 0, 0, 0, 0, 0, 54, 297
"/opt/projects/swiftkube/vendor/github.com/coreos/go-semver/semver/sort.go", "Go", 31, 0, 0, 0, 0, 0, 8, 39
"/opt/projects/swiftkube/vendor/github.com/coreos/go-systemd/v22/daemon/sdnotify.go", "Go", 73, 0, 0, 0, 0, 0, 12, 85
"/opt/projects/swiftkube/vendor/github.com/coreos/go-systemd/v22/daemon/watchdog.go", "Go", 67, 0, 0, 0, 0, 0, 7, 74
"/opt/projects/swiftkube/vendor/github.com/coreos/go-systemd/v22/dbus/dbus.go", "Go", 231, 0, 0, 0, 0, 0, 36, 267
"/opt/projects/swiftkube/vendor/github.com/coreos/go-systemd/v22/dbus/methods.go", "Go", 723, 0, 0, 0, 0, 0, 142, 865
"/opt/projects/swiftkube/vendor/github.com/coreos/go-systemd/v22/dbus/properties.go", "Go", 204, 0, 0, 0, 0, 0, 34, 238
"/opt/projects/swiftkube/vendor/github.com/coreos/go-systemd/v22/dbus/set.go", "Go", 39, 0, 0, 0, 0, 0, 9, 48
"/opt/projects/swiftkube/vendor/github.com/coreos/go-systemd/v22/dbus/subscription.go", "Go", 286, 0, 0, 0, 0, 0, 48, 334
"/opt/projects/swiftkube/vendor/github.com/coreos/go-systemd/v22/dbus/subscription_set.go", "Go", 50, 0, 0, 0, 0, 0, 8, 58
"/opt/projects/swiftkube/vendor/github.com/coreos/go-systemd/v22/journal/journal.go", "Go", 41, 0, 0, 0, 0, 0, 6, 47
"/opt/projects/swiftkube/vendor/github.com/coreos/go-systemd/v22/journal/journal_unix.go", "Go", 236, 0, 0, 0, 0, 0, 32, 268
"/opt/projects/swiftkube/vendor/github.com/coreos/go-systemd/v22/journal/journal_windows.go", "Go", 37, 0, 0, 0, 0, 0, 7, 44
"/opt/projects/swiftkube/vendor/github.com/cyphar/filepath-securejoin/join.go", "Go", 103, 0, 0, 0, 0, 0, 13, 116
"/opt/projects/swiftkube/vendor/github.com/cyphar/filepath-securejoin/vfs.go", "Go", 33, 0, 0, 0, 0, 0, 9, 42
"/opt/projects/swiftkube/vendor/github.com/davecgh/go-spew/spew/bypass.go", "Go", 128, 0, 0, 0, 0, 0, 18, 146
"/opt/projects/swiftkube/vendor/github.com/davecgh/go-spew/spew/bypasssafe.go", "Go", 33, 0, 0, 0, 0, 0, 6, 39
"/opt/projects/swiftkube/vendor/github.com/davecgh/go-spew/spew/common.go", "Go", 312, 0, 0, 0, 0, 0, 30, 342
"/opt/projects/swiftkube/vendor/github.com/davecgh/go-spew/spew/config.go", "Go", 273, 0, 0, 0, 0, 0, 34, 307
"/opt/projects/swiftkube/vendor/github.com/davecgh/go-spew/spew/doc.go", "Go", 166, 0, 0, 0, 0, 0, 46, 212
"/opt/projects/swiftkube/vendor/github.com/davecgh/go-spew/spew/dump.go", "Go", 452, 0, 0, 0, 0, 0, 58, 510
"/opt/projects/swiftkube/vendor/github.com/davecgh/go-spew/spew/format.go", "Go", 363, 0, 0, 0, 0, 0, 57, 420
"/opt/projects/swiftkube/vendor/github.com/davecgh/go-spew/spew/spew.go", "Go", 135, 0, 0, 0, 0, 0, 14, 149
"/opt/projects/swiftkube/vendor/github.com/daviddengcn/go-colortext/ct.go", "Go", 44, 0, 0, 0, 0, 0, 10, 54
"/opt/projects/swiftkube/vendor/github.com/daviddengcn/go-colortext/ct_ansi.go", "Go", 45, 0, 0, 0, 0, 0, 7, 52
"/opt/projects/swiftkube/vendor/github.com/daviddengcn/go-colortext/ct_win.go", "Go", 111, 0, 0, 0, 0, 0, 23, 134
"/opt/projects/swiftkube/vendor/github.com/docker/distribution/digestset/set.go", "Go", 225, 0, 0, 0, 0, 0, 23, 248
"/opt/projects/swiftkube/vendor/github.com/docker/distribution/reference/helpers.go", "Go", 37, 0, 0, 0, 0, 0, 6, 43
"/opt/projects/swiftkube/vendor/github.com/docker/distribution/reference/normalize.go", "Go", 180, 0, 0, 0, 0, 0, 20, 200
"/opt/projects/swiftkube/vendor/github.com/docker/distribution/reference/reference.go", "Go", 373, 0, 0, 0, 0, 0, 61, 434
"/opt/projects/swiftkube/vendor/github.com/docker/distribution/reference/regexp.go", "Go", 115, 0, 0, 0, 0, 0, 29, 144
"/opt/projects/swiftkube/vendor/github.com/docker/go-units/duration.go", "Go", 33, 0, 0, 0, 0, 0, 3, 36
"/opt/projects/swiftkube/vendor/github.com/docker/go-units/size.go", "Go", 131, 0, 0, 0, 0, 0, 24, 155
"/opt/projects/swiftkube/vendor/github.com/docker/go-units/ulimit.go", "Go", 110, 0, 0, 0, 0, 0, 14, 124
"/opt/projects/swiftkube/vendor/github.com/emicklei/go-restful/v3/compress.go", "Go", 113, 0, 0, 0, 0, 0, 15, 128
"/opt/projects/swiftkube/vendor/github.com/emicklei/go-restful/v3/compressor_cache.go", "Go", 93, 0, 0, 0, 0, 0, 11, 104
"/opt/projects/swiftkube/vendor/github.com/emicklei/go-restful/v3/compressor_pools.go", "Go", 78, 0, 0, 0, 0, 0, 14, 92
"/opt/projects/swiftkube/vendor/github.com/emicklei/go-restful/v3/compressors.go", "Go", 42, 0, 0, 0, 0, 0, 13, 55
"/opt/projects/swiftkube/vendor/github.com/emicklei/go-restful/v3/constants.go", "Go", 26, 0, 0, 0, 0, 0, 5, 31
"/opt/projects/swiftkube/vendor/github.com/emicklei/go-restful/v3/container.go", "Go", 405, 0, 0, 0, 0, 0, 46, 451
"/opt/projects/swiftkube/vendor/github.com/emicklei/go-restful/v3/cors_filter.go", "Go", 172, 0, 0, 0, 0, 0, 22, 194
"/opt/projects/swiftkube/vendor/github.com/emicklei/go-restful/v3/curly.go", "Go", 159, 0, 0, 0, 0, 0, 15, 174
"/opt/projects/swiftkube/vendor/github.com/emicklei/go-restful/v3/curly_route.go", "Go", 47, 0, 0, 0, 0, 0, 8, 55
"/opt/projects/swiftkube/vendor/github.com/emicklei/go-restful/v3/custom_verb.go", "Go", 23, 0, 0, 0, 0, 0, 7, 30
"/opt/projects/swiftkube/vendor/github.com/emicklei/go-restful/v3/doc.go", "Go", 111, 0, 0, 0, 0, 0, 75, 186
"/opt/projects/swiftkube/vendor/github.com/emicklei/go-restful/v3/entity_accessors.go", "Go", 143, 0, 0, 0, 0, 0, 20, 163
"/opt/projects/swiftkube/vendor/github.com/emicklei/go-restful/v3/extensions.go", "Go", 18, 0, 0, 0, 0, 0, 4, 22
"/opt/projects/swiftkube/vendor/github.com/emicklei/go-restful/v3/filter.go", "Go", 32, 0, 0, 0, 0, 0, 6, 38
"/opt/projects/swiftkube/vendor/github.com/emicklei/go-restful/v3/filter_adapter.go", "Go", 17, 0, 0, 0, 0, 0, 5, 22
"/opt/projects/swiftkube/vendor/github.com/emicklei/go-restful/v3/json.go", "Go", 8, 0, 0, 0, 0, 0, 4, 12
"/opt/projects/swiftkube/vendor/github.com/emicklei/go-restful/v3/jsoniter.go", "Go", 9, 0, 0, 0, 0, 0, 4, 13
"/opt/projects/swiftkube/vendor/github.com/emicklei/go-restful/v3/jsr311.go", "Go", 301, 0, 0, 0, 0, 0, 26, 327
"/opt/projects/swiftkube/vendor/github.com/emicklei/go-restful/v3/log/log.go", "Go", 27, 0, 0, 0, 0, 0, 8, 35
"/opt/projects/swiftkube/vendor/github.com/emicklei/go-restful/v3/logger.go", "Go", 26, 0, 0, 0, 0, 0, 7, 33
"/opt/projects/swiftkube/vendor/github.com/emicklei/go-restful/v3/mime.go", "Go", 45, 0, 0, 0, 0, 0, 6, 51
"/opt/projects/swiftkube/vendor/github.com/emicklei/go-restful/v3/options_filter.go", "Go", 28, 0, 0, 0, 0, 0, 7, 35
"/opt/projects/swiftkube/vendor/github.com/emicklei/go-restful/v3/parameter.go", "Go", 198, 0, 0, 0, 0, 0, 45, 243
"/opt/projects/swiftkube/vendor/github.com/emicklei/go-restful/v3/path_expression.go", "Go", 69, 0, 0, 0, 0, 0, 6, 75
"/opt/projects/swiftkube/vendor/github.com/emicklei/go-restful/v3/path_processor.go", "Go", 65, 0, 0, 0, 0, 0, 10, 75
"/opt/projects/swiftkube/vendor/github.com/emicklei/go-restful/v3/request.go", "Go", 113, 0, 0, 0, 0, 0, 20, 133
"/opt/projects/swiftkube/vendor/github.com/emicklei/go-restful/v3/response.go", "Go", 226, 0, 0, 0, 0, 0, 31, 257
"/opt/projects/swiftkube/vendor/github.com/emicklei/go-restful/v3/route.go", "Go", 155, 0, 0, 0, 0, 0, 24, 179
"/opt/projects/swiftkube/vendor/github.com/emicklei/go-restful/v3/route_builder.go", "Go", 336, 0, 0, 0, 0, 0, 41, 377
"/opt/projects/swiftkube/vendor/github.com/emicklei/go-restful/v3/route_reader.go", "Go", 60, 0, 0, 0, 0, 0, 7, 67
"/opt/projects/swiftkube/vendor/github.com/emicklei/go-restful/v3/router.go", "Go", 16, 0, 0, 0, 0, 0, 5, 21
"/opt/projects/swiftkube/vendor/github.com/emicklei/go-restful/v3/service_error.go", "Go", 26, 0, 0, 0, 0, 0, 7, 33
"/opt/projects/swiftkube/vendor/github.com/emicklei/go-restful/v3/web_service.go", "Go", 258, 0, 0, 0, 0, 0, 48, 306
"/opt/projects/swiftkube/vendor/github.com/emicklei/go-restful/v3/web_service_container.go", "Go", 31, 0, 0, 0, 0, 0, 9, 40
"/opt/projects/swiftkube/vendor/github.com/euank/go-kmsg-parser/kmsgparser/kmsgparser.go", "Go", 167, 0, 0, 0, 0, 0, 34, 201
"/opt/projects/swiftkube/vendor/github.com/euank/go-kmsg-parser/kmsgparser/log.go", "Go", 45, 0, 0, 0, 0, 0, 11, 56
"/opt/projects/swiftkube/vendor/github.com/evanphx/json-patch/errors.go", "Go", 31, 0, 0, 0, 0, 0, 8, 39
"/opt/projects/swiftkube/vendor/github.com/evanphx/json-patch/merge.go", "Go", 329, 0, 0, 0, 0, 0, 61, 390
"/opt/projects/swiftkube/vendor/github.com/evanphx/json-patch/patch.go", "Go", 659, 0, 0, 0, 0, 0, 193, 852
"/opt/projects/swiftkube/vendor/github.com/exponent-io/jsonpath/decoder.go", "Go", 188, 0, 0, 0, 0, 0, 23, 211
"/opt/projects/swiftkube/vendor/github.com/exponent-io/jsonpath/path.go", "Go", 56, 0, 0, 0, 0, 0, 12, 68
"/opt/projects/swiftkube/vendor/github.com/exponent-io/jsonpath/pathaction.go", "Go", 55, 0, 0, 0, 0, 0, 7, 62
"/opt/projects/swiftkube/vendor/github.com/fatih/camelcase/camelcase.go", "Go", 88, 0, 0, 0, 0, 0, 3, 91
"/opt/projects/swiftkube/vendor/github.com/felixge/httpsnoop/capture_metrics.go", "Go", 75, 0, 0, 0, 0, 0, 12, 87
"/opt/projects/swiftkube/vendor/github.com/felixge/httpsnoop/docs.go", "Go", 9, 0, 0, 0, 0, 0, 2, 11
"/opt/projects/swiftkube/vendor/github.com/felixge/httpsnoop/wrap_generated_gteq_1.8.go", "Go", 412, 0, 0, 0, 0, 0, 25, 437
"/opt/projects/swiftkube/vendor/github.com/felixge/httpsnoop/wrap_generated_lt_1.8.go", "Go", 256, 0, 0, 0, 0, 0, 23, 279
"/opt/projects/swiftkube/vendor/github.com/fsnotify/fsnotify/backend_fen.go", "Go", 154, 0, 0, 0, 0, 0, 9, 163
"/opt/projects/swiftkube/vendor/github.com/fsnotify/fsnotify/backend_inotify.go", "Go", 415, 0, 0, 0, 0, 0, 45, 460
"/opt/projects/swiftkube/vendor/github.com/fsnotify/fsnotify/backend_kqueue.go", "Go", 627, 0, 0, 0, 0, 0, 81, 708
"/opt/projects/swiftkube/vendor/github.com/fsnotify/fsnotify/backend_other.go", "Go", 59, 0, 0, 0, 0, 0, 8, 67
"/opt/projects/swiftkube/vendor/github.com/fsnotify/fsnotify/backend_windows.go", "Go", 685, 0, 0, 0, 0, 0, 62, 747
"/opt/projects/swiftkube/vendor/github.com/fsnotify/fsnotify/fsnotify.go", "Go", 70, 0, 0, 0, 0, 0, 12, 82
"/opt/projects/swiftkube/vendor/github.com/fsnotify/fsnotify/system_bsd.go", "Go", 5, 0, 0, 0, 0, 0, 4, 9
"/opt/projects/swiftkube/vendor/github.com/fsnotify/fsnotify/system_darwin.go", "Go", 6, 0, 0, 0, 0, 0, 4, 10
"/opt/projects/swiftkube/vendor/github.com/fvbommel/sortorder/doc.go", "Go", 5, 0, 0, 0, 0, 0, 1, 6
"/opt/projects/swiftkube/vendor/github.com/fvbommel/sortorder/natsort.go", "Go", 72, 0, 0, 0, 0, 0, 5, 77
"/opt/projects/swiftkube/vendor/github.com/go-errors/errors/error.go", "Go", 180, 0, 0, 0, 0, 0, 30, 210
"/opt/projects/swiftkube/vendor/github.com/go-errors/errors/error_1_13.go", "Go", 24, 0, 0, 0, 0, 0, 8, 32
"/opt/projects/swiftkube/vendor/github.com/go-errors/errors/error_backward.go", "Go", 45, 0, 0, 0, 0, 0, 13, 58
"/opt/projects/swiftkube/vendor/github.com/go-errors/errors/parse_panic.go", "Go", 104, 0, 0, 0, 0, 0, 24, 128
"/opt/projects/swiftkube/vendor/github.com/go-errors/errors/stackframe.go", "Go", 104, 0, 0, 0, 0, 0, 19, 123
"/opt/projects/swiftkube/vendor/github.com/go-logr/logr/discard.go", "Go", 19, 0, 0, 0, 0, 0, 6, 25
"/opt/projects/swiftkube/vendor/github.com/go-logr/logr/funcr/funcr.go", "Go", 732, 0, 0, 0, 0, 0, 73, 805
"/opt/projects/swiftkube/vendor/github.com/go-logr/logr/logr.go", "Go", 510, 0, 0, 0, 0, 0, 41, 551
"/opt/projects/swiftkube/vendor/github.com/go-logr/stdr/stdr.go", "Go", 139, 0, 0, 0, 0, 0, 32, 171
"/opt/projects/swiftkube/vendor/github.com/go-openapi/jsonpointer/pointer.go", "Go", 314, 0, 0, 0, 0, 0, 77, 391
"/opt/projects/swiftkube/vendor/github.com/go-openapi/jsonreference/internal/normalize_url.go", "Go", 60, 0, 0, 0, 0, 0, 10, 70
"/opt/projects/swiftkube/vendor/github.com/go-openapi/jsonreference/reference.go", "Go", 129, 0, 0, 0, 0, 0, 30, 159
"/opt/projects/swiftkube/vendor/github.com/go-openapi/swag/convert.go", "Go", 178, 0, 0, 0, 0, 0, 31, 209
"/opt/projects/swiftkube/vendor/github.com/go-openapi/swag/convert_types.go", "Go", 639, 0, 0, 0, 0, 0, 92, 731
"/opt/projects/swiftkube/vendor/github.com/go-openapi/swag/doc.go", "Go", 26, 0, 0, 0, 0, 0, 6, 32
"/opt/projects/swiftkube/vendor/github.com/go-openapi/swag/file.go", "Go", 28, 0, 0, 0, 0, 0, 6, 34
"/opt/projects/swiftkube/vendor/github.com/go-openapi/swag/json.go", "Go", 270, 0, 0, 0, 0, 0, 43, 313
"/opt/projects/swiftkube/vendor/github.com/go-openapi/swag/loading.go", "Go", 104, 0, 0, 0, 0, 0, 18, 122
"/opt/projects/swiftkube/vendor/github.com/go-openapi/swag/name_lexem.go", "Go", 73, 0, 0, 0, 0, 0, 15, 88
"/opt/projects/swiftkube/vendor/github.com/go-openapi/swag/net.go", "Go", 34, 0, 0, 0, 0, 0, 5, 39
"/opt/projects/swiftkube/vendor/github.com/go-openapi/swag/path.go", "Go", 53, 0, 0, 0, 0, 0, 7, 60
"/opt/projects/swiftkube/vendor/github.com/go-openapi/swag/post_go18.go", "Go", 20, 0, 0, 0, 0, 0, 5, 25
"/opt/projects/swiftkube/vendor/github.com/go-openapi/swag/post_go19.go", "Go", 59, 0, 0, 0, 0, 0, 10, 69
"/opt/projects/swiftkube/vendor/github.com/go-openapi/swag/pre_go18.go", "Go", 20, 0, 0, 0, 0, 0, 5, 25
"/opt/projects/swiftkube/vendor/github.com/go-openapi/swag/pre_go19.go", "Go", 61, 0, 0, 0, 0, 0, 10, 71
"/opt/projects/swiftkube/vendor/github.com/go-openapi/swag/split.go", "Go", 208, 0, 0, 0, 0, 0, 55, 263
"/opt/projects/swiftkube/vendor/github.com/go-openapi/swag/util.go", "Go", 343, 0, 0, 0, 0, 0, 44, 387
"/opt/projects/swiftkube/vendor/github.com/go-openapi/swag/yaml.go", "Go", 409, 0, 0, 0, 0, 0, 42, 451
"/opt/projects/swiftkube/vendor/github.com/godbus/dbus/v5/auth.go", "Go", 242, 0, 0, 0, 0, 0, 14, 256
"/opt/projects/swiftkube/vendor/github.com/godbus/dbus/v5/auth_anonymous.go", "Go", 12, 0, 0, 0, 0, 0, 5, 17
"/opt/projects/swiftkube/vendor/github.com/godbus/dbus/v5/auth_external.go", "Go", 21, 0, 0, 0, 0, 0, 6, 27
"/opt/projects/swiftkube/vendor/github.com/godbus/dbus/v5/auth_sha1.go", "Go", 95, 0, 0, 0, 0, 0, 8, 103
"/opt/projects/swiftkube/vendor/github.com/godbus/dbus/v5/call.go", "Go", 55, 0, 0, 0, 0, 0, 15, 70
"/opt/projects/swiftkube/vendor/github.com/godbus/dbus/v5/conn.go", "Go", 879, 0, 0, 0, 0, 0, 105, 984
"/opt/projects/swiftkube/vendor/github.com/godbus/dbus/v5/conn_darwin.go", "Go", 29, 0, 0, 0, 0, 0, 9, 38
"/opt/projects/swiftkube/vendor/github.com/godbus/dbus/v5/conn_other.go", "Go", 77, 0, 0, 0, 0, 0, 17, 94
"/opt/projects/swiftkube/vendor/github.com/godbus/dbus/v5/conn_unix.go", "Go", 13, 0, 0, 0, 0, 0, 5, 18
"/opt/projects/swiftkube/vendor/github.com/godbus/dbus/v5/conn_windows.go", "Go", 11, 0, 0, 0, 0, 0, 5, 16
"/opt/projects/swiftkube/vendor/github.com/godbus/dbus/v5/dbus.go", "Go", 399, 0, 0, 0, 0, 0, 34, 433
"/opt/projects/swiftkube/vendor/github.com/godbus/dbus/v5/decoder.go", "Go", 282, 0, 0, 0, 0, 0, 11, 293
"/opt/projects/swiftkube/vendor/github.com/godbus/dbus/v5/default_handler.go", "Go", 298, 0, 0, 0, 0, 0, 45, 343
"/opt/projects/swiftkube/vendor/github.com/godbus/dbus/v5/doc.go", "Go", 55, 0, 0, 0, 0, 0, 15, 70
"/opt/projects/swiftkube/vendor/github.com/godbus/dbus/v5/encoder.go", "Go", 221, 0, 0, 0, 0, 0, 15, 236
"/opt/projects/swiftkube/vendor/github.com/godbus/dbus/v5/export.go", "Go", 413, 0, 0, 0, 0, 0, 52, 465
"/opt/projects/swiftkube/vendor/github.com/godbus/dbus/v5/homedir.go", "Go", 22, 0, 0, 0, 0, 0, 7, 29
"/opt/projects/swiftkube/vendor/github.com/godbus/dbus/v5/homedir_dynamic.go", "Go", 12, 0, 0, 0, 0, 0, 4, 16
"/opt/projects/swiftkube/vendor/github.com/godbus/dbus/v5/homedir_static.go", "Go", 35, 0, 0, 0, 0, 0, 11, 46
"/opt/projects/swiftkube/vendor/github.com/godbus/dbus/v5/match.go", "Go", 74, 0, 0, 0, 0, 0, 16, 90
"/opt/projects/swiftkube/vendor/github.com/godbus/dbus/v5/message.go", "Go", 350, 0, 0, 0, 0, 0, 35, 385
"/opt/projects/swiftkube/vendor/github.com/godbus/dbus/v5/object.go", "Go", 153, 0, 0, 0, 0, 0, 22, 175
"/opt/projects/swiftkube/vendor/github.com/godbus/dbus/v5/sequence.go", "Go", 19, 0, 0, 0, 0, 0, 6, 25
"/opt/projects/swiftkube/vendor/github.com/godbus/dbus/v5/sequential_handler.go", "Go", 111, 0, 0, 0, 0, 0, 15, 126
"/opt/projects/swiftkube/vendor/github.com/godbus/dbus/v5/server_interfaces.go", "Go", 97, 0, 0, 0, 0, 0, 11, 108
"/opt/projects/swiftkube/vendor/github.com/godbus/dbus/v5/sig.go", "Go", 270, 0, 0, 0, 0, 0, 24, 294
"/opt/projects/swiftkube/vendor/github.com/godbus/dbus/v5/transport_darwin.go", "Go", 5, 0, 0, 0, 0, 0, 2, 7
"/opt/projects/swiftkube/vendor/github.com/godbus/dbus/v5/transport_generic.go", "Go", 42, 0, 0, 0, 0, 0, 11, 53
"/opt/projects/swiftkube/vendor/github.com/godbus/dbus/v5/transport_nonce_tcp.go", "Go", 35, 0, 0, 0, 0, 0, 5, 40
"/opt/projects/swiftkube/vendor/github.com/godbus/dbus/v5/transport_tcp.go", "Go", 36, 0, 0, 0, 0, 0, 6, 42
"/opt/projects/swiftkube/vendor/github.com/godbus/dbus/v5/transport_unix.go", "Go", 200, 0, 0, 0, 0, 0, 15, 215
"/opt/projects/swiftkube/vendor/github.com/godbus/dbus/v5/transport_unixcred_dragonfly.go", "Go", 84, 0, 0, 0, 0, 0, 12, 96
"/opt/projects/swiftkube/vendor/github.com/godbus/dbus/v5/transport_unixcred_freebsd.go", "Go", 80, 0, 0, 0, 0, 0, 13, 93
"/opt/projects/swiftkube/vendor/github.com/godbus/dbus/v5/transport_unixcred_linux.go", "Go", 22, 0, 0, 0, 0, 0, 4, 26
"/opt/projects/swiftkube/vendor/github.com/godbus/dbus/v5/transport_unixcred_netbsd.go", "Go", 12, 0, 0, 0, 0, 0, 3, 15
"/opt/projects/swiftkube/vendor/github.com/godbus/dbus/v5/transport_unixcred_openbsd.go", "Go", 12, 0, 0, 0, 0, 0, 3, 15
"/opt/projects/swiftkube/vendor/github.com/godbus/dbus/v5/variant.go", "Go", 140, 0, 0, 0, 0, 0, 11, 151
"/opt/projects/swiftkube/vendor/github.com/godbus/dbus/v5/variant_lexer.go", "Go", 261, 0, 0, 0, 0, 0, 24, 285
"/opt/projects/swiftkube/vendor/github.com/godbus/dbus/v5/variant_parser.go", "Go", 752, 0, 0, 0, 0, 0, 66, 818
"/opt/projects/swiftkube/vendor/github.com/gofrs/uuid/codec.go", "Go", 220, 0, 0, 0, 0, 0, 15, 235
"/opt/projects/swiftkube/vendor/github.com/gofrs/uuid/fuzz.go", "Go", 45, 0, 0, 0, 0, 0, 4, 49
"/opt/projects/swiftkube/vendor/github.com/gofrs/uuid/generator.go", "Go", 393, 0, 0, 0, 0, 0, 64, 457
"/opt/projects/swiftkube/vendor/github.com/gofrs/uuid/sql.go", "Go", 101, 0, 0, 0, 0, 0, 16, 117
"/opt/projects/swiftkube/vendor/github.com/gofrs/uuid/uuid.go", "Go", 255, 0, 0, 0, 0, 0, 31, 286
"/opt/projects/swiftkube/vendor/github.com/gogo/protobuf/gogoproto/doc.go", "Go", 126, 0, 0, 0, 0, 0, 44, 170
"/opt/projects/swiftkube/vendor/github.com/gogo/protobuf/gogoproto/gogo.pb.go", "Go", 791, 0, 0, 0, 0, 0, 84, 875
"/opt/projects/swiftkube/vendor/github.com/gogo/protobuf/gogoproto/gogo.proto", "Protocol Buffers", 0, 0, 92, 0, 0, 27, 26, 145
"/opt/projects/swiftkube/vendor/github.com/gogo/protobuf/gogoproto/helper.go", "Go", 347, 0, 0, 0, 0, 0, 69, 416
"/opt/projects/swiftkube/vendor/github.com/gogo/protobuf/proto/clone.go", "Go", 242, 0, 0, 0, 0, 0, 17, 259
"/opt/projects/swiftkube/vendor/github.com/gogo/protobuf/proto/custom_gogo.go", "Go", 35, 0, 0, 0, 0, 0, 5, 40
"/opt/projects/swiftkube/vendor/github.com/gogo/protobuf/proto/decode.go", "Go", 384, 0, 0, 0, 0, 0, 44, 428
"/opt/projects/swiftkube/vendor/github.com/gogo/protobuf/proto/deprecated.go", "Go", 54, 0, 0, 0, 0, 0, 10, 64
"/opt/projects/swiftkube/vendor/github.com/gogo/protobuf/proto/discard.go", "Go", 321, 0, 0, 0, 0, 0, 30, 351
"/opt/projects/swiftkube/vendor/github.com/gogo/protobuf/proto/duration.go", "Go", 93, 0, 0, 0, 0, 0, 8, 101
"/opt/projects/swiftkube/vendor/github.com/gogo/protobuf/proto/duration_gogo.go", "Go", 43, 0, 0, 0, 0, 0, 7, 50
"/opt/projects/swiftkube/vendor/github.com/gogo/protobuf/proto/encode.go", "Go", 184, 0, 0, 0, 0, 0, 22, 206
"/opt/projects/swiftkube/vendor/github.com/gogo/protobuf/proto/encode_gogo.go", "Go", 31, 0, 0, 0, 0, 0, 3, 34
"/opt/projects/swiftkube/vendor/github.com/gogo/protobuf/proto/equal.go", "Go", 277, 0, 0, 0, 0, 0, 24, 301
"/opt/projects/swiftkube/vendor/github.com/gogo/protobuf/proto/extensions.go", "Go", 542, 0, 0, 0, 0, 0, 64, 606
"/opt/projects/swiftkube/vendor/github.com/gogo/protobuf/proto/extensions_gogo.go", "Go", 351, 0, 0, 0, 0, 0, 39, 390
"/opt/projects/swiftkube/vendor/github.com/gogo/protobuf/proto/lib.go", "Go", 862, 0, 0, 0, 0, 0, 112, 974
"/opt/projects/swiftkube/vendor/github.com/gogo/protobuf/proto/lib_gogo.go", "Go", 45, 0, 0, 0, 0, 0, 6, 51
"/opt/projects/swiftkube/vendor/github.com/gogo/protobuf/proto/message_set.go", "Go", 159, 0, 0, 0, 0, 0, 23, 182
"/opt/projects/swiftkube/vendor/github.com/gogo/protobuf/proto/pointer_reflect.go", "Go", 327, 0, 0, 0, 0, 0, 31, 358
"/opt/projects/swiftkube/vendor/github.com/gogo/protobuf/proto/pointer_reflect_gogo.go", "Go", 51, 0, 0, 0, 0, 0, 9, 60
"/opt/projects/swiftkube/vendor/github.com/gogo/protobuf/proto/pointer_unsafe.go", "Go", 277, 0, 0, 0, 0, 0, 32, 309
"/opt/projects/swiftkube/vendor/github.com/gogo/protobuf/proto/pointer_unsafe_gogo.go", "Go", 49, 0, 0, 0, 0, 0, 8, 57
"/opt/projects/swiftkube/vendor/github.com/gogo/protobuf/proto/properties.go", "Go", 552, 0, 0, 0, 0, 0, 59, 611
"/opt/projects/swiftkube/vendor/github.com/gogo/protobuf/proto/properties_gogo.go", "Go", 33, 0, 0, 0, 0, 0, 4, 37
"/opt/projects/swiftkube/vendor/github.com/gogo/protobuf/proto/skip_gogo.go", "Go", 116, 0, 0, 0, 0, 0, 4, 120
"/opt/projects/swiftkube/vendor/github.com/gogo/protobuf/proto/table_marshal.go", "Go", 2896, 0, 0, 0, 0, 0, 114, 3010
"/opt/projects/swiftkube/vendor/github.com/gogo/protobuf/proto/table_marshal_gogo.go", "Go", 368, 0, 0, 0, 0, 0, 21, 389
"/opt/projects/swiftkube/vendor/github.com/gogo/protobuf/proto/table_merge.go", "Go", 648, 0, 0, 0, 0, 0, 29, 677
"/opt/projects/swiftkube/vendor/github.com/gogo/protobuf/proto/table_unmarshal.go", "Go", 2123, 0, 0, 0, 0, 0, 127, 2250
"/opt/projects/swiftkube/vendor/github.com/gogo/protobuf/proto/table_unmarshal_gogo.go", "Go", 368, 0, 0, 0, 0, 0, 18, 386
"/opt/projects/swiftkube/vendor/github.com/gogo/protobuf/proto/text.go", "Go", 870, 0, 0, 0, 0, 0, 61, 931
"/opt/projects/swiftkube/vendor/github.com/gogo/protobuf/proto/text_gogo.go", "Go", 54, 0, 0, 0, 0, 0, 4, 58
"/opt/projects/swiftkube/vendor/github.com/gogo/protobuf/proto/text_parser.go", "Go", 960, 0, 0, 0, 0, 0, 59, 1019
"/opt/projects/swiftkube/vendor/github.com/gogo/protobuf/proto/timestamp.go", "Go", 106, 0, 0, 0, 0, 0, 8, 114
"/opt/projects/swiftkube/vendor/github.com/gogo/protobuf/proto/timestamp_gogo.go", "Go", 43, 0, 0, 0, 0, 0, 7, 50
"/opt/projects/swiftkube/vendor/github.com/gogo/protobuf/proto/wrappers.go", "Go", 1796, 0, 0, 0, 0, 0, 93, 1889
"/opt/projects/swiftkube/vendor/github.com/gogo/protobuf/proto/wrappers_gogo.go", "Go", 93, 0, 0, 0, 0, 0, 21, 114
"/opt/projects/swiftkube/vendor/github.com/gogo/protobuf/protoc-gen-gogo/descriptor/descriptor.go", "Go", 107, 0, 0, 0, 0, 0, 12, 119
"/opt/projects/swiftkube/vendor/github.com/gogo/protobuf/protoc-gen-gogo/descriptor/descriptor.pb.go", "Go", 2570, 0, 0, 0, 0, 0, 296, 2866
"/opt/projects/swiftkube/vendor/github.com/gogo/protobuf/protoc-gen-gogo/descriptor/descriptor_gostring.gen.go", "Go", 748, 0, 0, 0, 0, 0, 5, 753
"/opt/projects/swiftkube/vendor/github.com/gogo/protobuf/protoc-gen-gogo/descriptor/helper.go", "Go", 360, 0, 0, 0, 0, 0, 31, 391
"/opt/projects/swiftkube/vendor/github.com/gogo/protobuf/sortkeys/sortkeys.go", "Go", 79, 0, 0, 0, 0, 0, 23, 102
"/opt/projects/swiftkube/vendor/github.com/gogo/protobuf/types/any.go", "Go", 126, 0, 0, 0, 0, 0, 15, 141
"/opt/projects/swiftkube/vendor/github.com/gogo/protobuf/types/any.pb.go", "Go", 671, 0, 0, 0, 0, 0, 24, 695
"/opt/projects/swiftkube/vendor/github.com/gogo/protobuf/types/api.pb.go", "Go", 2073, 0, 0, 0, 0, 0, 62, 2135
"/opt/projects/swiftkube/vendor/github.com/gogo/protobuf/types/doc.go", "Go", 34, 0, 0, 0, 0, 0, 2, 36
"/opt/projects/swiftkube/vendor/github.com/gogo/protobuf/types/duration.go", "Go", 93, 0, 0, 0, 0, 0, 8, 101
"/opt/projects/swiftkube/vendor/github.com/gogo/protobuf/types/duration.pb.go", "Go", 496, 0, 0, 0, 0, 0, 22, 518
"/opt/projects/swiftkube/vendor/github.com/gogo/protobuf/types/duration_gogo.go", "Go", 91, 0, 0, 0, 0, 0, 10, 101
"/opt/projects/swiftkube/vendor/github.com/gogo/protobuf/types/empty.pb.go", "Go", 441, 0, 0, 0, 0, 0, 22, 463
"/opt/projects/swiftkube/vendor/github.com/gogo/protobuf/types/field_mask.pb.go", "Go", 716, 0, 0, 0, 0, 0, 23, 739
"/opt/projects/swiftkube/vendor/github.com/gogo/protobuf/types/protosize.go", "Go", 33, 0, 0, 0, 0, 0, 2, 35
"/opt/projects/swiftkube/vendor/github.com/gogo/protobuf/types/source_context.pb.go", "Go", 502, 0, 0, 0, 0, 0, 23, 525
"/opt/projects/swiftkube/vendor/github.com/gogo/protobuf/types/struct.pb.go", "Go", 2189, 0, 0, 0, 0, 0, 83, 2272
"/opt/projects/swiftkube/vendor/github.com/gogo/protobuf/types/timestamp.go", "Go", 121, 0, 0, 0, 0, 0, 10, 131
"/opt/projects/swiftkube/vendor/github.com/gogo/protobuf/types/timestamp.pb.go", "Go", 518, 0, 0, 0, 0, 0, 22, 540
"/opt/projects/swiftkube/vendor/github.com/gogo/protobuf/types/timestamp_gogo.go", "Go", 85, 0, 0, 0, 0, 0, 10, 95
"/opt/projects/swiftkube/vendor/github.com/gogo/protobuf/types/type.pb.go", "Go", 3245, 0, 0, 0, 0, 0, 111, 3356
"/opt/projects/swiftkube/vendor/github.com/gogo/protobuf/types/wrappers.pb.go", "Go", 2577, 0, 0, 0, 0, 0, 127, 2704
"/opt/projects/swiftkube/vendor/github.com/gogo/protobuf/types/wrappers_gogo.go", "Go", 262, 0, 0, 0, 0, 0, 39, 301
"/opt/projects/swiftkube/vendor/github.com/golang-jwt/jwt/v4/claims.go", "Go", 222, 0, 0, 0, 0, 0, 48, 270
"/opt/projects/swiftkube/vendor/github.com/golang-jwt/jwt/v4/doc.go", "Go", 4, 0, 0, 0, 0, 0, 1, 5
"/opt/projects/swiftkube/vendor/github.com/golang-jwt/jwt/v4/ecdsa.go", "Go", 118, 0, 0, 0, 0, 0, 25, 143
"/opt/projects/swiftkube/vendor/github.com/golang-jwt/jwt/v4/ecdsa_utils.go", "Go", 57, 0, 0, 0, 0, 0, 13, 70
"/opt/projects/swiftkube/vendor/github.com/golang-jwt/jwt/v4/ed25519.go", "Go", 68, 0, 0, 0, 0, 0, 18, 86
"/opt/projects/swiftkube/vendor/github.com/golang-jwt/jwt/v4/ed25519_utils.go", "Go", 52, 0, 0, 0, 0, 0, 13, 65
"/opt/projects/swiftkube/vendor/github.com/golang-jwt/jwt/v4/errors.go", "Go", 98, 0, 0, 0, 0, 0, 15, 113
"/opt/projects/swiftkube/vendor/github.com/golang-jwt/jwt/v4/hmac.go", "Go", 79, 0, 0, 0, 0, 0, 17, 96
"/opt/projects/swiftkube/vendor/github.com/golang-jwt/jwt/v4/map_claims.go", "Go", 123, 0, 0, 0, 0, 0, 29, 152
"/opt/projects/swiftkube/vendor/github.com/golang-jwt/jwt/v4/none.go", "Go", 42, 0, 0, 0, 0, 0, 11, 53
"/opt/projects/swiftkube/vendor/github.com/golang-jwt/jwt/v4/parser.go", "Go", 153, 0, 0, 0, 0, 0, 25, 178
"/opt/projects/swiftkube/vendor/github.com/golang-jwt/jwt/v4/parser_option.go", "Go", 25, 0, 0, 0, 0, 0, 5, 30
"/opt/projects/swiftkube/vendor/github.com/golang-jwt/jwt/v4/rsa.go", "Go", 83, 0, 0, 0, 0, 0, 19, 102
"/opt/projects/swiftkube/vendor/github.com/golang-jwt/jwt/v4/rsa_pss.go", "Go", 125, 0, 0, 0, 0, 0, 19, 144
"/opt/projects/swiftkube/vendor/github.com/golang-jwt/jwt/v4/rsa_utils.go", "Go", 86, 0, 0, 0, 0, 0, 20, 106
"/opt/projects/swiftkube/vendor/github.com/golang-jwt/jwt/v4/signing_method.go", "Go", 37, 0, 0, 0, 0, 0, 10, 47
"/opt/projects/swiftkube/vendor/github.com/golang-jwt/jwt/v4/token.go", "Go", 124, 0, 0, 0, 0, 0, 20, 144
"/opt/projects/swiftkube/vendor/github.com/golang-jwt/jwt/v4/types.go", "Go", 121, 0, 0, 0, 0, 0, 25, 146
"/opt/projects/swiftkube/vendor/github.com/golang/groupcache/lru/lru.go", "Go", 115, 0, 0, 0, 0, 0, 19, 134
"/opt/projects/swiftkube/vendor/github.com/golang/mock/gomock/call.go", "Go", 397, 0, 0, 0, 0, 0, 49, 446
"/opt/projects/swiftkube/vendor/github.com/golang/mock/gomock/callset.go", "Go", 100, 0, 0, 0, 0, 0, 14, 114
"/opt/projects/swiftkube/vendor/github.com/golang/mock/gomock/controller.go", "Go", 298, 0, 0, 0, 0, 0, 39, 337
"/opt/projects/swiftkube/vendor/github.com/golang/mock/gomock/matchers.go", "Go", 286, 0, 0, 0, 0, 0, 56, 342
"/opt/projects/swiftkube/vendor/github.com/golang/protobuf/jsonpb/decode.go", "Go", 481, 0, 0, 0, 0, 0, 50, 531
"/opt/projects/swiftkube/vendor/github.com/golang/protobuf/jsonpb/encode.go", "Go", 511, 0, 0, 0, 0, 0, 49, 560
"/opt/projects/swiftkube/vendor/github.com/golang/protobuf/jsonpb/json.go", "Go", 59, 0, 0, 0, 0, 0, 11, 70
"/opt/projects/swiftkube/vendor/github.com/golang/protobuf/proto/buffer.go", "Go", 285, 0, 0, 0, 0, 0, 40, 325
"/opt/projects/swiftkube/vendor/github.com/golang/protobuf/proto/defaults.go", "Go", 58, 0, 0, 0, 0, 0, 6, 64
"/opt/projects/swiftkube/vendor/github.com/golang/protobuf/proto/deprecated.go", "Go", 92, 0, 0, 0, 0, 0, 22, 114
"/opt/projects/swiftkube/vendor/github.com/golang/protobuf/proto/discard.go", "Go", 53, 0, 0, 0, 0, 0, 6, 59
"/opt/projects/swiftkube/vendor/github.com/golang/protobuf/proto/extensions.go", "Go", 314, 0, 0, 0, 0, 0, 43, 357
"/opt/projects/swiftkube/vendor/github.com/golang/protobuf/proto/properties.go", "Go", 280, 0, 0, 0, 0, 0, 27, 307
"/opt/projects/swiftkube/vendor/github.com/golang/protobuf/proto/proto.go", "Go", 148, 0, 0, 0, 0, 0, 20, 168
"/opt/projects/swiftkube/vendor/github.com/golang/protobuf/proto/registry.go", "Go", 277, 0, 0, 0, 0, 0, 41, 318
"/opt/projects/swiftkube/vendor/github.com/golang/protobuf/proto/text_decode.go", "Go", 743, 0, 0, 0, 0, 0, 59, 802
"/opt/projects/swiftkube/vendor/github.com/golang/protobuf/proto/text_encode.go", "Go", 514, 0, 0, 0, 0, 0, 47, 561
"/opt/projects/swiftkube/vendor/github.com/golang/protobuf/proto/wire.go", "Go", 70, 0, 0, 0, 0, 0, 9, 79
"/opt/projects/swiftkube/vendor/github.com/golang/protobuf/proto/wrappers.go", "Go", 24, 0, 0, 0, 0, 0, 11, 35
"/opt/projects/swiftkube/vendor/github.com/golang/protobuf/protoc-gen-go/descriptor/descriptor.pb.go", "Go", 158, 0, 0, 0, 0, 0, 43, 201
"/opt/projects/swiftkube/vendor/github.com/golang/protobuf/ptypes/any.go", "Go", 162, 0, 0, 0, 0, 0, 18, 180
"/opt/projects/swiftkube/vendor/github.com/golang/protobuf/ptypes/any/any.pb.go", "Go", 54, 0, 0, 0, 0, 0, 9, 63
"/opt/projects/swiftkube/vendor/github.com/golang/protobuf/ptypes/doc.go", "Go", 9, 0, 0, 0, 0, 0, 2, 11
"/opt/projects/swiftkube/vendor/github.com/golang/protobuf/ptypes/duration.go", "Go", 69, 0, 0, 0, 0, 0, 8, 77
"/opt/projects/swiftkube/vendor/github.com/golang/protobuf/ptypes/duration/duration.pb.go", "Go", 55, 0, 0, 0, 0, 0, 9, 64
"/opt/projects/swiftkube/vendor/github.com/golang/protobuf/ptypes/timestamp.go", "Go", 103, 0, 0, 0, 0, 0, 10, 113
"/opt/projects/swiftkube/vendor/github.com/golang/protobuf/ptypes/timestamp/timestamp.pb.go", "Go", 56, 0, 0, 0, 0, 0, 9, 65
"/opt/projects/swiftkube/vendor/github.com/golang/protobuf/ptypes/wrappers/wrappers.pb.go", "Go", 63, 0, 0, 0, 0, 0, 9, 72
"/opt/projects/swiftkube/vendor/github.com/google/btree/btree.go", "Go", 819, 0, 0, 0, 0, 0, 72, 891
"/opt/projects/swiftkube/vendor/github.com/google/cadvisor/cache/memory/memory.go", "Go", 123, 0, 0, 0, 0, 0, 20, 143
"/opt/projects/swiftkube/vendor/github.com/google/cadvisor/collector/collector_manager.go", "Go", 93, 0, 0, 0, 0, 0, 17, 110
"/opt/projects/swiftkube/vendor/github.com/google/cadvisor/collector/config.go", "Go", 80, 0, 0, 0, 0, 0, 22, 102
"/opt/projects/swiftkube/vendor/github.com/google/cadvisor/collector/fakes.go", "Go", 30, 0, 0, 0, 0, 0, 8, 38
"/opt/projects/swiftkube/vendor/github.com/google/cadvisor/collector/generic_collector.go", "Go", 153, 0, 0, 0, 0, 0, 31, 184
"/opt/projects/swiftkube/vendor/github.com/google/cadvisor/collector/prometheus_collector.go", "Go", 237, 0, 0, 0, 0, 0, 50, 287
"/opt/projects/swiftkube/vendor/github.com/google/cadvisor/collector/types.go", "Go", 43, 0, 0, 0, 0, 0, 11, 54
"/opt/projects/swiftkube/vendor/github.com/google/cadvisor/collector/util.go", "Go", 23, 0, 0, 0, 0, 0, 4, 27
"/opt/projects/swiftkube/vendor/github.com/google/cadvisor/container/common/container_hints.go", "Go", 52, 0, 0, 0, 0, 0, 10, 62
"/opt/projects/swiftkube/vendor/github.com/google/cadvisor/container/common/fsHandler.go", "Go", 136, 0, 0, 0, 0, 0, 20, 156
"/opt/projects/swiftkube/vendor/github.com/google/cadvisor/container/common/helpers.go", "Go", 384, 0, 0, 0, 0, 0, 56, 440
"/opt/projects/swiftkube/vendor/github.com/google/cadvisor/container/common/inotify_watcher.go", "Go", 112, 0, 0, 0, 0, 0, 24, 136
"/opt/projects/swiftkube/vendor/github.com/google/cadvisor/container/container.go", "Go", 60, 0, 0, 0, 0, 0, 19, 79
"/opt/projects/swiftkube/vendor/github.com/google/cadvisor/container/containerd/client.go", "Go", 141, 0, 0, 0, 0, 0, 17, 158
"/opt/projects/swiftkube/vendor/github.com/google/cadvisor/container/containerd/containers/containers.go", "Go", 103, 0, 0, 0, 0, 0, 23, 126
"/opt/projects/swiftkube/vendor/github.com/google/cadvisor/container/containerd/errdefs/errors.go", "Go", 91, 0, 0, 0, 0, 0, 16, 107
"/opt/projects/swiftkube/vendor/github.com/google/cadvisor/container/containerd/errdefs/grpc.go", "Go", 139, 0, 0, 0, 0, 0, 22, 161
"/opt/projects/swiftkube/vendor/github.com/google/cadvisor/container/containerd/factory.go", "Go", 133, 0, 0, 0, 0, 0, 25, 158
"/opt/projects/swiftkube/vendor/github.com/google/cadvisor/container/containerd/grpc.go", "Go", 43, 0, 0, 0, 0, 0, 7, 50
"/opt/projects/swiftkube/vendor/github.com/google/cadvisor/container/containerd/handler.go", "Go", 222, 0, 0, 0, 0, 0, 40, 262
"/opt/projects/swiftkube/vendor/github.com/google/cadvisor/container/containerd/identifiers/validate.go", "Go", 73, 0, 0, 0, 0, 0, 14, 87
"/opt/projects/swiftkube/vendor/github.com/google/cadvisor/container/containerd/install/install.go", "Go", 26, 0, 0, 0, 0, 0, 5, 31
"/opt/projects/swiftkube/vendor/github.com/google/cadvisor/container/containerd/namespaces/context.go", "Go", 79, 0, 0, 0, 0, 0, 13, 92
"/opt/projects/swiftkube/vendor/github.com/google/cadvisor/container/containerd/namespaces/grpc.go", "Go", 61, 0, 0, 0, 0, 0, 14, 75
"/opt/projects/swiftkube/vendor/github.com/google/cadvisor/container/containerd/namespaces/store.go", "Go", 48, 0, 0, 0, 0, 0, 10, 58
"/opt/projects/swiftkube/vendor/github.com/google/cadvisor/container/containerd/namespaces/ttrpc.go", "Go", 54, 0, 0, 0, 0, 0, 11, 65
"/opt/projects/swiftkube/vendor/github.com/google/cadvisor/container/containerd/pkg/dialer/dialer.go", "Go", 82, 0, 0, 0, 0, 0, 11, 93
"/opt/projects/swiftkube/vendor/github.com/google/cadvisor/container/containerd/pkg/dialer/dialer_unix.go", "Go", 57, 0, 0, 0, 0, 0, 10, 67
"/opt/projects/swiftkube/vendor/github.com/google/cadvisor/container/containerd/pkg/dialer/dialer_windows.go", "Go", 42, 0, 0, 0, 0, 0, 10, 52
"/opt/projects/swiftkube/vendor/github.com/google/cadvisor/container/containerd/plugin.go", "Go", 32, 0, 0, 0, 0, 0, 7, 39
"/opt/projects/swiftkube/vendor/github.com/google/cadvisor/container/crio/client.go", "Go", 147, 0, 0, 0, 0, 0, 16, 163
"/opt/projects/swiftkube/vendor/github.com/google/cadvisor/container/crio/factory.go", "Go", 137, 0, 0, 0, 0, 0, 30, 167
"/opt/projects/swiftkube/vendor/github.com/google/cadvisor/container/crio/handler.go", "Go", 303, 0, 0, 0, 0, 0, 64, 367
"/opt/projects/swiftkube/vendor/github.com/google/cadvisor/container/crio/install/install.go", "Go", 26, 0, 0, 0, 0, 0, 5, 31
"/opt/projects/swiftkube/vendor/github.com/google/cadvisor/container/crio/plugin.go", "Go", 43, 0, 0, 0, 0, 0, 9, 52
"/opt/projects/swiftkube/vendor/github.com/google/cadvisor/container/factory.go", "Go", 269, 0, 0, 0, 0, 0, 43, 312
"/opt/projects/swiftkube/vendor/github.com/google/cadvisor/container/libcontainer/handler.go", "Go", 816, 0, 0, 0, 0, 0, 120, 936
"/opt/projects/swiftkube/vendor/github.com/google/cadvisor/container/libcontainer/helpers.go", "Go", 150, 0, 0, 0, 0, 0, 21, 171
"/opt/projects/swiftkube/vendor/github.com/google/cadvisor/container/raw/factory.go", "Go", 96, 0, 0, 0, 0, 0, 19, 115
"/opt/projects/swiftkube/vendor/github.com/google/cadvisor/container/raw/handler.go", "Go", 260, 0, 0, 0, 0, 0, 45, 305
"/opt/projects/swiftkube/vendor/github.com/google/cadvisor/container/raw/watcher.go", "Go", 216, 0, 0, 0, 0, 0, 28, 244
"/opt/projects/swiftkube/vendor/github.com/google/cadvisor/container/systemd/factory.go", "Go", 49, 0, 0, 0, 0, 0, 11, 60
"/opt/projects/swiftkube/vendor/github.com/google/cadvisor/container/systemd/install/install.go", "Go", 26, 0, 0, 0, 0, 0, 5, 31
"/opt/projects/swiftkube/vendor/github.com/google/cadvisor/container/systemd/plugin.go", "Go", 32, 0, 0, 0, 0, 0, 7, 39
"/opt/projects/swiftkube/vendor/github.com/google/cadvisor/devicemapper/dmsetup_client.go", "Go", 53, 0, 0, 0, 0, 0, 12, 65
"/opt/projects/swiftkube/vendor/github.com/google/cadvisor/devicemapper/doc.go", "Go", 15, 0, 0, 0, 0, 0, 2, 17
"/opt/projects/swiftkube/vendor/github.com/google/cadvisor/devicemapper/thin_ls_client.go", "Go", 76, 0, 0, 0, 0, 0, 18, 94
"/opt/projects/swiftkube/vendor/github.com/google/cadvisor/devicemapper/thin_pool_watcher.go", "Go", 154, 0, 0, 0, 0, 0, 26, 180
"/opt/projects/swiftkube/vendor/github.com/google/cadvisor/devicemapper/util.go", "Go", 45, 0, 0, 0, 0, 0, 6, 51
"/opt/projects/swiftkube/vendor/github.com/google/cadvisor/events/handler.go", "Go", 305, 0, 0, 0, 0, 0, 35, 340
"/opt/projects/swiftkube/vendor/github.com/google/cadvisor/fs/fs.go", "Go", 706, 0, 0, 0, 0, 0, 106, 812
"/opt/projects/swiftkube/vendor/github.com/google/cadvisor/fs/types.go", "Go", 101, 0, 0, 0, 0, 0, 23, 124
"/opt/projects/swiftkube/vendor/github.com/google/cadvisor/info/v1/container.go", "Go", 907, 0, 0, 0, 0, 0, 165, 1072
"/opt/projects/swiftkube/vendor/github.com/google/cadvisor/info/v1/docker.go", "Go", 35, 0, 0, 0, 0, 0, 4, 39
"/opt/projects/swiftkube/vendor/github.com/google/cadvisor/info/v1/machine.go", "Go", 259, 0, 0, 0, 0, 0, 67, 326
"/opt/projects/swiftkube/vendor/github.com/google/cadvisor/info/v1/metric.go", "Go", 61, 0, 0, 0, 0, 0, 17, 78
"/opt/projects/swiftkube/vendor/github.com/google/cadvisor/info/v2/container.go", "Go", 311, 0, 0, 0, 0, 0, 47, 358
"/opt/projects/swiftkube/vendor/github.com/google/cadvisor/info/v2/conversion.go", "Go", 306, 0, 0, 0, 0, 0, 11, 317
"/opt/projects/swiftkube/vendor/github.com/google/cadvisor/info/v2/machine.go", "Go", 158, 0, 0, 0, 0, 0, 41, 199
"/opt/projects/swiftkube/vendor/github.com/google/cadvisor/machine/info.go", "Go", 150, 0, 0, 0, 0, 0, 29, 179
"/opt/projects/swiftkube/vendor/github.com/google/cadvisor/machine/machine.go", "Go", 267, 0, 0, 0, 0, 0, 39, 306
"/opt/projects/swiftkube/vendor/github.com/google/cadvisor/machine/operatingsystem_unix.go", "Go", 50, 0, 0, 0, 0, 0, 6, 56
"/opt/projects/swiftkube/vendor/github.com/google/cadvisor/machine/operatingsystem_windows.go", "Go", 45, 0, 0, 0, 0, 0, 10, 55
"/opt/projects/swiftkube/vendor/github.com/google/cadvisor/manager/container.go", "Go", 676, 0, 0, 0, 0, 0, 74, 750
"/opt/projects/swiftkube/vendor/github.com/google/cadvisor/manager/manager.go", "Go", 1214, 0, 0, 0, 0, 0, 176, 1390
"/opt/projects/swiftkube/vendor/github.com/google/cadvisor/metrics/metrics.go", "Go", 36, 0, 0, 0, 0, 0, 7, 43
"/opt/projects/swiftkube/vendor/github.com/google/cadvisor/metrics/prometheus.go", "Go", 1968, 0, 0, 0, 0, 0, 43, 2011
"/opt/projects/swiftkube/vendor/github.com/google/cadvisor/metrics/prometheus_fake.go", "Go", 754, 0, 0, 0, 0, 0, 13, 767
"/opt/projects/swiftkube/vendor/github.com/google/cadvisor/metrics/prometheus_machine.go", "Go", 347, 0, 0, 0, 0, 0, 38, 385
"/opt/projects/swiftkube/vendor/github.com/google/cadvisor/nvm/machine_libipmctl.go", "Go", 118, 0, 0, 0, 0, 0, 21, 139
"/opt/projects/swiftkube/vendor/github.com/google/cadvisor/nvm/machine_no_libipmctl.go", "Go", 30, 0, 0, 0, 0, 0, 7, 37
"/opt/projects/swiftkube/vendor/github.com/google/cadvisor/perf/collector_libpfm.go", "Go", 386, 0, 0, 0, 0, 0, 69, 455
"/opt/projects/swiftkube/vendor/github.com/google/cadvisor/perf/collector_no_libpfm.go", "Go", 28, 0, 0, 0, 0, 0, 7, 35
"/opt/projects/swiftkube/vendor/github.com/google/cadvisor/perf/config.go", "Go", 111, 0, 0, 0, 0, 0, 17, 128
"/opt/projects/swiftkube/vendor/github.com/google/cadvisor/perf/manager_libpfm.go", "Go", 61, 0, 0, 0, 0, 0, 15, 76
"/opt/projects/swiftkube/vendor/github.com/google/cadvisor/perf/manager_no_libpfm.go", "Go", 26, 0, 0, 0, 0, 0, 6, 32
"/opt/projects/swiftkube/vendor/github.com/google/cadvisor/perf/types_libpfm.go", "Go", 47, 0, 0, 0, 0, 0, 8, 55
"/opt/projects/swiftkube/vendor/github.com/google/cadvisor/perf/uncore_libpfm.go", "Go", 451, 0, 0, 0, 0, 0, 70, 521
"/opt/projects/swiftkube/vendor/github.com/google/cadvisor/resctrl/collector.go", "Go", 149, 0, 0, 0, 0, 0, 23, 172
"/opt/projects/swiftkube/vendor/github.com/google/cadvisor/resctrl/manager.go", "Go", 64, 0, 0, 0, 0, 0, 16, 80
"/opt/projects/swiftkube/vendor/github.com/google/cadvisor/resctrl/utils.go", "Go", 312, 0, 0, 0, 0, 0, 55, 367
"/opt/projects/swiftkube/vendor/github.com/google/cadvisor/stats/noop.go", "Go", 35, 0, 0, 0, 0, 0, 10, 45
"/opt/projects/swiftkube/vendor/github.com/google/cadvisor/stats/types.go", "Go", 31, 0, 0, 0, 0, 0, 5, 36
"/opt/projects/swiftkube/vendor/github.com/google/cadvisor/storage/common_flags.go", "Go", 25, 0, 0, 0, 0, 0, 4, 29
"/opt/projects/swiftkube/vendor/github.com/google/cadvisor/storage/storage.go", "Go", 49, 0, 0, 0, 0, 0, 11, 60
"/opt/projects/swiftkube/vendor/github.com/google/cadvisor/summary/buffer.go", "Go", 66, 0, 0, 0, 0, 0, 9, 75
"/opt/projects/swiftkube/vendor/github.com/google/cadvisor/summary/percentiles.go", "Go", 181, 0, 0, 0, 0, 0, 21, 202
"/opt/projects/swiftkube/vendor/github.com/google/cadvisor/summary/summary.go", "Go", 168, 0, 0, 0, 0, 0, 17, 185
"/opt/projects/swiftkube/vendor/github.com/google/cadvisor/third_party/containerd/api/services/containers/v1/containers.pb.go", "Go", 3451, 0, 0, 0, 0, 0, 134, 3585
"/opt/projects/swiftkube/vendor/github.com/google/cadvisor/third_party/containerd/api/services/containers/v1/containers.proto", "Protocol Buffers", 0, 0, 75, 0, 0, 75, 30, 180
"/opt/projects/swiftkube/vendor/github.com/google/cadvisor/third_party/containerd/api/services/containers/v1/doc.go", "Go", 13, 0, 0, 0, 0, 0, 5, 18
"/opt/projects/swiftkube/vendor/github.com/google/cadvisor/third_party/containerd/api/services/tasks/v1/doc.go", "Go", 13, 0, 0, 0, 0, 0, 5, 18
"/opt/projects/swiftkube/vendor/github.com/google/cadvisor/third_party/containerd/api/services/tasks/v1/tasks.pb.go", "Go", 7242, 0, 0, 0, 0, 0, 270, 7512
"/opt/projects/swiftkube/vendor/github.com/google/cadvisor/third_party/containerd/api/services/tasks/v1/tasks.proto", "Protocol Buffers", 0, 0, 157, 0, 0, 15, 57, 229
"/opt/projects/swiftkube/vendor/github.com/google/cadvisor/third_party/containerd/api/services/version/v1/doc.go", "Go", 14, 0, 0, 0, 0, 0, 5, 19
"/opt/projects/swiftkube/vendor/github.com/google/cadvisor/third_party/containerd/api/services/version/v1/version.pb.go", "Go", 447, 0, 0, 0, 0, 0, 30, 477
"/opt/projects/swiftkube/vendor/github.com/google/cadvisor/third_party/containerd/api/services/version/v1/version.proto", "Protocol Buffers", 0, 0, 24, 0, 0, 1, 10, 35
"/opt/projects/swiftkube/vendor/github.com/google/cadvisor/third_party/containerd/api/types/descriptor.pb.go", "Go", 581, 0, 0, 0, 0, 0, 18, 599
"/opt/projects/swiftkube/vendor/github.com/google/cadvisor/third_party/containerd/api/types/descriptor.proto", "Protocol Buffers", 0, 0, 22, 0, 0, 5, 9, 36
"/opt/projects/swiftkube/vendor/github.com/google/cadvisor/third_party/containerd/api/types/doc.go", "Go", 13, 0, 0, 0, 0, 0, 5, 18
"/opt/projects/swiftkube/vendor/github.com/google/cadvisor/third_party/containerd/api/types/metrics.pb.go", "Go", 433, 0, 0, 0, 0, 0, 18, 451
"/opt/projects/swiftkube/vendor/github.com/google/cadvisor/third_party/containerd/api/types/metrics.proto", "Protocol Buffers", 0, 0, 23, 0, 0, 0, 9, 32
"/opt/projects/swiftkube/vendor/github.com/google/cadvisor/third_party/containerd/api/types/mount.pb.go", "Go", 477, 0, 0, 0, 0, 0, 18, 495
"/opt/projects/swiftkube/vendor/github.com/google/cadvisor/third_party/containerd/api/types/mount.proto", "Protocol Buffers", 0, 0, 22, 0, 0, 12, 12, 46
"/opt/projects/swiftkube/vendor/github.com/google/cadvisor/third_party/containerd/api/types/platform.pb.go", "Go", 418, 0, 0, 0, 0, 0, 18, 436
"/opt/projects/swiftkube/vendor/github.com/google/cadvisor/third_party/containerd/api/types/platform.proto", "Protocol Buffers", 0, 0, 21, 0, 0, 2, 9, 32
"/opt/projects/swiftkube/vendor/github.com/google/cadvisor/third_party/containerd/api/types/task/doc.go", "Go", 14, 0, 0, 0, 0, 0, 5, 19
"/opt/projects/swiftkube/vendor/github.com/google/cadvisor/third_party/containerd/api/types/task/task.pb.go", "Go", 949, 0, 0, 0, 0, 0, 32, 981
"/opt/projects/swiftkube/vendor/github.com/google/cadvisor/third_party/containerd/api/types/task/task.proto", "Protocol Buffers", 0, 0, 43, 0, 0, 4, 11, 58
"/opt/projects/swiftkube/vendor/github.com/google/cadvisor/utils/cloudinfo/azure/azure.go", "Go", 48, 0, 0, 0, 0, 0, 11, 59
"/opt/projects/swiftkube/vendor/github.com/google/cadvisor/utils/cloudinfo/cloudinfo.go", "Go", 75, 0, 0, 0, 0, 0, 15, 90
"/opt/projects/swiftkube/vendor/github.com/google/cadvisor/utils/cloudinfo/gce/gce.go", "Go", 54, 0, 0, 0, 0, 0, 13, 67
"/opt/projects/swiftkube/vendor/github.com/google/cadvisor/utils/cpuload/cpuload.go", "Go", 38, 0, 0, 0, 0, 0, 10, 48
"/opt/projects/swiftkube/vendor/github.com/google/cadvisor/utils/cpuload/netlink/conn.go", "Go", 87, 0, 0, 0, 0, 0, 12, 99
"/opt/projects/swiftkube/vendor/github.com/google/cadvisor/utils/cpuload/netlink/netlink.go", "Go", 218, 0, 0, 0, 0, 0, 24, 242
"/opt/projects/swiftkube/vendor/github.com/google/cadvisor/utils/cpuload/netlink/reader.go", "Go", 68, 0, 0, 0, 0, 0, 13, 81
"/opt/projects/swiftkube/vendor/github.com/google/cadvisor/utils/oomparser/oomparser.go", "Go", 155, 0, 0, 0, 0, 0, 20, 175
"/opt/projects/swiftkube/vendor/github.com/google/cadvisor/utils/path.go", "Go", 21, 0, 0, 0, 0, 0, 4, 25
"/opt/projects/swiftkube/vendor/github.com/google/cadvisor/utils/sysfs/sysfs.go", "Go", 467, 0, 0, 0, 0, 0, 59, 526
"/opt/projects/swiftkube/vendor/github.com/google/cadvisor/utils/sysfs/sysfs_notx86.go", "Go", 17, 0, 0, 0, 0, 0, 4, 21
"/opt/projects/swiftkube/vendor/github.com/google/cadvisor/utils/sysfs/sysfs_x86.go", "Go", 17, 0, 0, 0, 0, 0, 4, 21
"/opt/projects/swiftkube/vendor/github.com/google/cadvisor/utils/sysinfo/sysinfo.go", "Go", 518, 0, 0, 0, 0, 0, 61, 579
"/opt/projects/swiftkube/vendor/github.com/google/cadvisor/utils/timed_store.go", "Go", 144, 0, 0, 0, 0, 0, 21, 165
"/opt/projects/swiftkube/vendor/github.com/google/cadvisor/utils/utils.go", "Go", 26, 0, 0, 0, 0, 0, 4, 30
"/opt/projects/swiftkube/vendor/github.com/google/cadvisor/version/version.go", "Go", 32, 0, 0, 0, 0, 0, 4, 36
"/opt/projects/swiftkube/vendor/github.com/google/cadvisor/watcher/watcher.go", "Go", 41, 0, 0, 0, 0, 0, 11, 52
"/opt/projects/swiftkube/vendor/github.com/google/cel-go/cel/cel.go", "Go", 18, 0, 0, 0, 0, 0, 2, 20
"/opt/projects/swiftkube/vendor/github.com/google/cel-go/cel/decls.go", "Go", 1159, 0, 0, 0, 0, 0, 88, 1247
"/opt/projects/swiftkube/vendor/github.com/google/cel-go/cel/env.go", "Go", 601, 0, 0, 0, 0, 0, 63, 664
"/opt/projects/swiftkube/vendor/github.com/google/cel-go/cel/io.go", "Go", 264, 0, 0, 0, 0, 0, 17, 281
"/opt/projects/swiftkube/vendor/github.com/google/cel-go/cel/library.go", "Go", 548, 0, 0, 0, 0, 0, 54, 602
"/opt/projects/swiftkube/vendor/github.com/google/cel-go/cel/macro.go", "Go", 120, 0, 0, 0, 0, 0, 26, 146
"/opt/projects/swiftkube/vendor/github.com/google/cel-go/cel/options.go", "Go", 527, 0, 0, 0, 0, 0, 53, 580
"/opt/projects/swiftkube/vendor/github.com/google/cel-go/cel/program.go", "Go", 513, 0, 0, 0, 0, 0, 57, 570
"/opt/projects/swiftkube/vendor/github.com/google/cel-go/checker/checker.go", "Go", 631, 0, 0, 0, 0, 0, 76, 707
"/opt/projects/swiftkube/vendor/github.com/google/cel-go/checker/cost.go", "Go", 618, 0, 0, 0, 0, 0, 67, 685
"/opt/projects/swiftkube/vendor/github.com/google/cel-go/checker/decls/decls.go", "Go", 212, 0, 0, 0, 0, 0, 26, 238
"/opt/projects/swiftkube/vendor/github.com/google/cel-go/checker/decls/scopes.go", "Go", 130, 0, 0, 0, 0, 0, 16, 146
"/opt/projects/swiftkube/vendor/github.com/google/cel-go/checker/env.go", "Go", 399, 0, 0, 0, 0, 0, 38, 437
"/opt/projects/swiftkube/vendor/github.com/google/cel-go/checker/errors.go", "Go", 78, 0, 0, 0, 0, 0, 19, 97
"/opt/projects/swiftkube/vendor/github.com/google/cel-go/checker/mapping.go", "Go", 41, 0, 0, 0, 0, 0, 9, 50
"/opt/projects/swiftkube/vendor/github.com/google/cel-go/checker/options.go", "Go", 46, 0, 0, 0, 0, 0, 8, 54
"/opt/projects/swiftkube/vendor/github.com/google/cel-go/checker/printer.go", "Go", 62, 0, 0, 0, 0, 0, 10, 72
"/opt/projects/swiftkube/vendor/github.com/google/cel-go/checker/standard.go", "Go", 429, 0, 0, 0, 0, 0, 66, 495
"/opt/projects/swiftkube/vendor/github.com/google/cel-go/checker/types.go", "Go", 495, 0, 0, 0, 0, 0, 35, 530
"/opt/projects/swiftkube/vendor/github.com/google/cel-go/common/containers/container.go", "Go", 297, 0, 0, 0, 0, 0, 20, 317
"/opt/projects/swiftkube/vendor/github.com/google/cel-go/common/cost.go", "Go", 32, 0, 0, 0, 0, 0, 9, 41
"/opt/projects/swiftkube/vendor/github.com/google/cel-go/common/debug/debug.go", "Go", 281, 0, 0, 0, 0, 0, 31, 312
"/opt/projects/swiftkube/vendor/github.com/google/cel-go/common/doc.go", "Go", 16, 0, 0, 0, 0, 0, 2, 18
"/opt/projects/swiftkube/vendor/github.com/google/cel-go/common/error.go", "Go", 65, 0, 0, 0, 0, 0, 9, 74
"/opt/projects/swiftkube/vendor/github.com/google/cel-go/common/errors.go", "Go", 88, 0, 0, 0, 0, 0, 10, 98
"/opt/projects/swiftkube/vendor/github.com/google/cel-go/common/location.go", "Go", 44, 0, 0, 0, 0, 0, 8, 52
"/opt/projects/swiftkube/vendor/github.com/google/cel-go/common/operators/operators.go", "Go", 146, 0, 0, 0, 0, 0, 12, 158
"/opt/projects/swiftkube/vendor/github.com/google/cel-go/common/overloads/overloads.go", "Go", 301, 0, 0, 0, 0, 0, 27, 328
"/opt/projects/swiftkube/vendor/github.com/google/cel-go/common/runes/buffer.go", "Go", 169, 0, 0, 0, 0, 0, 26, 195
"/opt/projects/swiftkube/vendor/github.com/google/cel-go/common/source.go", "Go", 160, 0, 0, 0, 0, 0, 27, 187
"/opt/projects/swiftkube/vendor/github.com/google/cel-go/common/types/any_value.go", "Go", 20, 0, 0, 0, 0, 0, 5, 25
"/opt/projects/swiftkube/vendor/github.com/google/cel-go/common/types/bool.go", "Go", 130, 0, 0, 0, 0, 0, 18, 148
"/opt/projects/swiftkube/vendor/github.com/google/cel-go/common/types/bytes.go", "Go", 121, 0, 0, 0, 0, 0, 17, 138
"/opt/projects/swiftkube/vendor/github.com/google/cel-go/common/types/compare.go", "Go", 85, 0, 0, 0, 0, 0, 13, 98
"/opt/projects/swiftkube/vendor/github.com/google/cel-go/common/types/doc.go", "Go", 16, 0, 0, 0, 0, 0, 2, 18
"/opt/projects/swiftkube/vendor/github.com/google/cel-go/common/types/double.go", "Go", 201, 0, 0, 0, 0, 0, 21, 222
"/opt/projects/swiftkube/vendor/github.com/google/cel-go/common/types/duration.go", "Go", 184, 0, 0, 0, 0, 0, 21, 205
"/opt/projects/swiftkube/vendor/github.com/google/cel-go/common/types/err.go", "Go", 119, 0, 0, 0, 0, 0, 23, 142
"/opt/projects/swiftkube/vendor/github.com/google/cel-go/common/types/int.go", "Go", 278, 0, 0, 0, 0, 0, 25, 303
"/opt/projects/swiftkube/vendor/github.com/google/cel-go/common/types/iterator.go", "Go", 45, 0, 0, 0, 0, 0, 11, 56
"/opt/projects/swiftkube/vendor/github.com/google/cel-go/common/types/json_value.go", "Go", 25, 0, 0, 0, 0, 0, 5, 30
"/opt/projects/swiftkube/vendor/github.com/google/cel-go/common/types/list.go", "Go", 484, 0, 0, 0, 0, 0, 50, 534
"/opt/projects/swiftkube/vendor/github.com/google/cel-go/common/types/map.go", "Go", 790, 0, 0, 0, 0, 0, 74, 864
"/opt/projects/swiftkube/vendor/github.com/google/cel-go/common/types/null.go", "Go", 99, 0, 0, 0, 0, 0, 15, 114
"/opt/projects/swiftkube/vendor/github.com/google/cel-go/common/types/object.go", "Go", 150, 0, 0, 0, 0, 0, 16, 166
"/opt/projects/swiftkube/vendor/github.com/google/cel-go/common/types/optional.go", "Go", 93, 0, 0, 0, 0, 0, 16, 109
"/opt/projects/swiftkube/vendor/github.com/google/cel-go/common/types/overflow.go", "Go", 345, 0, 0, 0, 0, 0, 45, 390
"/opt/projects/swiftkube/vendor/github.com/google/cel-go/common/types/pb/checked.go", "Go", 87, 0, 0, 0, 0, 0, 7, 94
"/opt/projects/swiftkube/vendor/github.com/google/cel-go/common/types/pb/enum.go", "Go", 38, 0, 0, 0, 0, 0, 7, 45
"/opt/projects/swiftkube/vendor/github.com/google/cel-go/common/types/pb/equal.go", "Go", 190, 0, 0, 0, 0, 0, 17, 207
"/opt/projects/swiftkube/vendor/github.com/google/cel-go/common/types/pb/file.go", "Go", 183, 0, 0, 0, 0, 0, 20, 203
"/opt/projects/swiftkube/vendor/github.com/google/cel-go/common/types/pb/pb.go", "Go", 239, 0, 0, 0, 0, 0, 20, 259
"/opt/projects/swiftkube/vendor/github.com/google/cel-go/common/types/pb/type.go", "Go", 537, 0, 0, 0, 0, 0, 44, 581
"/opt/projects/swiftkube/vendor/github.com/google/cel-go/common/types/provider.go", "Go", 521, 0, 0, 0, 0, 0, 29, 550
"/opt/projects/swiftkube/vendor/github.com/google/cel-go/common/types/ref/provider.go", "Go", 82, 0, 0, 0, 0, 0, 20, 102
"/opt/projects/swiftkube/vendor/github.com/google/cel-go/common/types/ref/reference.go", "Go", 54, 0, 0, 0, 0, 0, 10, 64
"/opt/projects/swiftkube/vendor/github.com/google/cel-go/common/types/string.go", "Go", 201, 0, 0, 0, 0, 0, 23, 224
"/opt/projects/swiftkube/vendor/github.com/google/cel-go/common/types/timestamp.go", "Go", 294, 0, 0, 0, 0, 0, 28, 322
"/opt/projects/swiftkube/vendor/github.com/google/cel-go/common/types/traits/comparer.go", "Go", 30, 0, 0, 0, 0, 0, 4, 34
"/opt/projects/swiftkube/vendor/github.com/google/cel-go/common/types/traits/container.go", "Go", 20, 0, 0, 0, 0, 0, 4, 24
"/opt/projects/swiftkube/vendor/github.com/google/cel-go/common/types/traits/field_tester.go", "Go", 27, 0, 0, 0, 0, 0, 4, 31
"/opt/projects/swiftkube/vendor/github.com/google/cel-go/common/types/traits/indexer.go", "Go", 22, 0, 0, 0, 0, 0, 4, 26
"/opt/projects/swiftkube/vendor/github.com/google/cel-go/common/types/traits/iterator.go", "Go", 30, 0, 0, 0, 0, 0, 7, 37
"/opt/projects/swiftkube/vendor/github.com/google/cel-go/common/types/traits/lister.go", "Go", 29, 0, 0, 0, 0, 0, 5, 34
"/opt/projects/swiftkube/vendor/github.com/google/cel-go/common/types/traits/mapper.go", "Go", 29, 0, 0, 0, 0, 0, 5, 34
"/opt/projects/swiftkube/vendor/github.com/google/cel-go/common/types/traits/matcher.go", "Go", 20, 0, 0, 0, 0, 0, 4, 24
"/opt/projects/swiftkube/vendor/github.com/google/cel-go/common/types/traits/math.go", "Go", 54, 0, 0, 0, 0, 0, 9, 63
"/opt/projects/swiftkube/vendor/github.com/google/cel-go/common/types/traits/receiver.go", "Go", 21, 0, 0, 0, 0, 0, 4, 25
"/opt/projects/swiftkube/vendor/github.com/google/cel-go/common/types/traits/sizer.go", "Go", 22, 0, 0, 0, 0, 0, 4, 26
"/opt/projects/swiftkube/vendor/github.com/google/cel-go/common/types/traits/traits.go", "Go", 48, 0, 0, 0, 0, 0, 17, 65
"/opt/projects/swiftkube/vendor/github.com/google/cel-go/common/types/traits/zeroer.go", "Go", 19, 0, 0, 0, 0, 0, 3, 22
"/opt/projects/swiftkube/vendor/github.com/google/cel-go/common/types/type.go", "Go", 87, 0, 0, 0, 0, 0, 16, 103
"/opt/projects/swiftkube/vendor/github.com/google/cel-go/common/types/uint.go", "Go", 232, 0, 0, 0, 0, 0, 23, 255
"/opt/projects/swiftkube/vendor/github.com/google/cel-go/common/types/unknown.go", "Go", 55, 0, 0, 0, 0, 0, 12, 67
"/opt/projects/swiftkube/vendor/github.com/google/cel-go/common/types/util.go", "Go", 43, 0, 0, 0, 0, 0, 6, 49
"/opt/projects/swiftkube/vendor/github.com/google/cel-go/ext/bindings.go", "Go", 90, 0, 0, 0, 0, 0, 11, 101
"/opt/projects/swiftkube/vendor/github.com/google/cel-go/ext/encoders.go", "Go", 81, 0, 0, 0, 0, 0, 12, 93
"/opt/projects/swiftkube/vendor/github.com/google/cel-go/ext/guards.go", "Go", 55, 0, 0, 0, 0, 0, 9, 64
"/opt/projects/swiftkube/vendor/github.com/google/cel-go/ext/math.go", "Go", 367, 0, 0, 0, 0, 0, 22, 389
"/opt/projects/swiftkube/vendor/github.com/google/cel-go/ext/native.go", "Go", 530, 0, 0, 0, 0, 0, 45, 575
"/opt/projects/swiftkube/vendor/github.com/google/cel-go/ext/protos.go", "Go", 132, 0, 0, 0, 0, 0, 14, 146
"/opt/projects/swiftkube/vendor/github.com/google/cel-go/ext/sets.go", "Go", 128, 0, 0, 0, 0, 0, 11, 139
"/opt/projects/swiftkube/vendor/github.com/google/cel-go/ext/strings.go", "Go", 1037, 0, 0, 0, 0, 0, 57, 1094
"/opt/projects/swiftkube/vendor/github.com/google/cel-go/interpreter/activation.go", "Go", 176, 0, 0, 0, 0, 0, 26, 202
"/opt/projects/swiftkube/vendor/github.com/google/cel-go/interpreter/attribute_patterns.go", "Go", 345, 0, 0, 0, 0, 0, 33, 378
"/opt/projects/swiftkube/vendor/github.com/google/cel-go/interpreter/attributes.go", "Go", 1214, 0, 0, 0, 0, 0, 126, 1340
"/opt/projects/swiftkube/vendor/github.com/google/cel-go/interpreter/decorators.go", "Go", 260, 0, 0, 0, 0, 0, 15, 275
"/opt/projects/swiftkube/vendor/github.com/google/cel-go/interpreter/dispatcher.go", "Go", 87, 0, 0, 0, 0, 0, 14, 101
"/opt/projects/swiftkube/vendor/github.com/google/cel-go/interpreter/evalstate.go", "Go", 63, 0, 0, 0, 0, 0, 13, 76
"/opt/projects/swiftkube/vendor/github.com/google/cel-go/interpreter/formatting.go", "Go", 350, 0, 0, 0, 0, 0, 34, 384
"/opt/projects/swiftkube/vendor/github.com/google/cel-go/interpreter/functions/functions.go", "Go", 51, 0, 0, 0, 0, 0, 12, 63
"/opt/projects/swiftkube/vendor/github.com/google/cel-go/interpreter/functions/standard.go", "Go", 236, 0, 0, 0, 0, 0, 35, 271
"/opt/projects/swiftkube/vendor/github.com/google/cel-go/interpreter/interpretable.go", "Go", 1050, 0, 0, 0, 0, 0, 146, 1196
"/opt/projects/swiftkube/vendor/github.com/google/cel-go/interpreter/interpreter.go", "Go", 190, 0, 0, 0, 0, 0, 26, 216
"/opt/projects/swiftkube/vendor/github.com/google/cel-go/interpreter/optimizations.go", "Go", 42, 0, 0, 0, 0, 0, 5, 47
"/opt/projects/swiftkube/vendor/github.com/google/cel-go/interpreter/planner.go", "Go", 741, 0, 0, 0, 0, 0, 54, 795
"/opt/projects/swiftkube/vendor/github.com/google/cel-go/interpreter/prune.go", "Go", 549, 0, 0, 0, 0, 0, 30, 579
"/opt/projects/swiftkube/vendor/github.com/google/cel-go/interpreter/runtimecost.go", "Go", 258, 0, 0, 0, 0, 0, 26, 284
"/opt/projects/swiftkube/vendor/github.com/google/cel-go/parser/errors.go", "Go", 25, 0, 0, 0, 0, 0, 6, 31
"/opt/projects/swiftkube/vendor/github.com/google/cel-go/parser/gen/cel_base_listener.go", "Go", 146, 0, 0, 0, 0, 0, 74, 220
"/opt/projects/swiftkube/vendor/github.com/google/cel-go/parser/gen/cel_base_visitor.go", "Go", 105, 0, 0, 0, 0, 0, 36, 141
"/opt/projects/swiftkube/vendor/github.com/google/cel-go/parser/gen/cel_lexer.go", "Go", 334, 0, 0, 0, 0, 0, 12, 346
"/opt/projects/swiftkube/vendor/github.com/google/cel-go/parser/gen/cel_listener.go", "Go", 139, 0, 0, 0, 0, 0, 69, 208
"/opt/projects/swiftkube/vendor/github.com/google/cel-go/parser/gen/cel_parser.go", "Go", 4274, 0, 0, 0, 0, 0, 1259, 5533
"/opt/projects/swiftkube/vendor/github.com/google/cel-go/parser/gen/cel_visitor.go", "Go", 73, 0, 0, 0, 0, 0, 36, 109
"/opt/projects/swiftkube/vendor/github.com/google/cel-go/parser/gen/doc.go", "Go", 15, 0, 0, 0, 0, 0, 2, 17
"/opt/projects/swiftkube/vendor/github.com/google/cel-go/parser/helper.go", "Go", 508, 0, 0, 0, 0, 0, 66, 574
"/opt/projects/swiftkube/vendor/github.com/google/cel-go/parser/input.go", "Go", 110, 0, 0, 0, 0, 0, 20, 130
"/opt/projects/swiftkube/vendor/github.com/google/cel-go/parser/macro.go", "Go", 357, 0, 0, 0, 0, 0, 69, 426
"/opt/projects/swiftkube/vendor/github.com/google/cel-go/parser/options.go", "Go", 115, 0, 0, 0, 0, 0, 13, 128
"/opt/projects/swiftkube/vendor/github.com/google/cel-go/parser/parser.go", "Go", 941, 0, 0, 0, 0, 0, 96, 1037
"/opt/projects/swiftkube/vendor/github.com/google/cel-go/parser/unescape.go", "Go", 220, 0, 0, 0, 0, 0, 18, 238
"/opt/projects/swiftkube/vendor/github.com/google/cel-go/parser/unparser.go", "Go", 588, 0, 0, 0, 0, 0, 50, 638
"/opt/projects/swiftkube/vendor/github.com/google/gnostic-models/compiler/context.go", "Go", 43, 0, 0, 0, 0, 0, 7, 50
"/opt/projects/swiftkube/vendor/github.com/google/gnostic-models/compiler/error.go", "Go", 61, 0, 0, 0, 0, 0, 10, 71
"/opt/projects/swiftkube/vendor/github.com/google/gnostic-models/compiler/extensions.go", "Go", 79, 0, 0, 0, 0, 0, 8, 87
"/opt/projects/swiftkube/vendor/github.com/google/gnostic-models/compiler/helpers.go", "Go", 362, 0, 0, 0, 0, 0, 36, 398
"/opt/projects/swiftkube/vendor/github.com/google/gnostic-models/compiler/main.go", "Go", 15, 0, 0, 0, 0, 0, 2, 17
"/opt/projects/swiftkube/vendor/github.com/google/gnostic-models/compiler/reader.go", "Go", 281, 0, 0, 0, 0, 0, 27, 308
"/opt/projects/swiftkube/vendor/github.com/google/gnostic-models/extensions/extension.pb.go", "Go", 411, 0, 0, 0, 0, 0, 51, 462
"/opt/projects/swiftkube/vendor/github.com/google/gnostic-models/extensions/extension.proto", "Protocol Buffers", 0, 0, 28, 0, 0, 50, 20, 98
"/opt/projects/swiftkube/vendor/github.com/google/gnostic-models/extensions/extensions.go", "Go", 59, 0, 0, 0, 0, 0, 6, 65
"/opt/projects/swiftkube/vendor/github.com/google/gnostic-models/jsonschema/base.go", "Go", 93, 0, 0, 0, 0, 0, 5, 98
"/opt/projects/swiftkube/vendor/github.com/google/gnostic-models/jsonschema/display.go", "Go", 222, 0, 0, 0, 0, 0, 8, 230
"/opt/projects/swiftkube/vendor/github.com/google/gnostic-models/jsonschema/models.go", "Go", 194, 0, 0, 0, 0, 0, 35, 229
"/opt/projects/swiftkube/vendor/github.com/google/gnostic-models/jsonschema/operations.go", "Go", 369, 0, 0, 0, 0, 0, 26, 395
"/opt/projects/swiftkube/vendor/github.com/google/gnostic-models/jsonschema/reader.go", "Go", 407, 0, 0, 0, 0, 0, 36, 443
"/opt/projects/swiftkube/vendor/github.com/google/gnostic-models/jsonschema/writer.go", "Go", 340, 0, 0, 0, 0, 0, 30, 370
"/opt/projects/swiftkube/vendor/github.com/google/gnostic-models/openapiv2/OpenAPIv2.go", "Go", 8633, 0, 0, 0, 0, 0, 188, 8821
"/opt/projects/swiftkube/vendor/github.com/google/gnostic-models/openapiv2/OpenAPIv2.pb.go", "Go", 6517, 0, 0, 0, 0, 0, 826, 7343
"/opt/projects/swiftkube/vendor/github.com/google/gnostic-models/openapiv2/OpenAPIv2.proto", "Protocol Buffers", 0, 0, 482, 0, 0, 114, 71, 667
"/opt/projects/swiftkube/vendor/github.com/google/gnostic-models/openapiv2/document.go", "Go", 37, 0, 0, 0, 0, 0, 6, 43
"/opt/projects/swiftkube/vendor/github.com/google/gnostic-models/openapiv3/OpenAPIv3.go", "Go", 8392, 0, 0, 0, 0, 0, 242, 8634
"/opt/projects/swiftkube/vendor/github.com/google/gnostic-models/openapiv3/OpenAPIv3.pb.go", "Go", 7125, 0, 0, 0, 0, 0, 929, 8054
"/opt/projects/swiftkube/vendor/github.com/google/gnostic-models/openapiv3/OpenAPIv3.proto", "Protocol Buffers", 0, 0, 479, 0, 0, 105, 89, 673
"/opt/projects/swiftkube/vendor/github.com/google/gnostic-models/openapiv3/document.go", "Go", 37, 0, 0, 0, 0, 0, 6, 43
"/opt/projects/swiftkube/vendor/github.com/google/go-cmp/cmp/cmpopts/equate.go", "Go", 135, 0, 0, 0, 0, 0, 22, 157
"/opt/projects/swiftkube/vendor/github.com/google/go-cmp/cmp/cmpopts/ignore.go", "Go", 190, 0, 0, 0, 0, 0, 17, 207
"/opt/projects/swiftkube/vendor/github.com/google/go-cmp/cmp/cmpopts/sort.go", "Go", 138, 0, 0, 0, 0, 0, 10, 148
"/opt/projects/swiftkube/vendor/github.com/google/go-cmp/cmp/cmpopts/struct_filter.go", "Go", 174, 0, 0, 0, 0, 0, 16, 190
"/opt/projects/swiftkube/vendor/github.com/google/go-cmp/cmp/cmpopts/xform.go", "Go", 31, 0, 0, 0, 0, 0, 6, 37
"/opt/projects/swiftkube/vendor/github.com/google/go-cmp/cmp/compare.go", "Go", 615, 0, 0, 0, 0, 0, 55, 670
"/opt/projects/swiftkube/vendor/github.com/google/go-cmp/cmp/export_panic.go", "Go", 11, 0, 0, 0, 0, 0, 6, 17
"/opt/projects/swiftkube/vendor/github.com/google/go-cmp/cmp/export_unsafe.go", "Go", 31, 0, 0, 0, 0, 0, 6, 37
"/opt/projects/swiftkube/vendor/github.com/google/go-cmp/cmp/internal/diff/debug_disable.go", "Go", 13, 0, 0, 0, 0, 0, 6, 19
"/opt/projects/swiftkube/vendor/github.com/google/go-cmp/cmp/internal/diff/debug_enable.go", "Go", 110, 0, 0, 0, 0, 0, 14, 124
"/opt/projects/swiftkube/vendor/github.com/google/go-cmp/cmp/internal/diff/diff.go", "Go", 370, 0, 0, 0, 0, 0, 33, 403
"/opt/projects/swiftkube/vendor/github.com/google/go-cmp/cmp/internal/flags/flags.go", "Go", 7, 0, 0, 0, 0, 0, 3, 10
"/opt/projects/swiftkube/vendor/github.com/google/go-cmp/cmp/internal/function/func.go", "Go", 85, 0, 0, 0, 0, 0, 15, 100
"/opt/projects/swiftkube/vendor/github.com/google/go-cmp/cmp/internal/value/name.go", "Go", 156, 0, 0, 0, 0, 0, 9, 165
"/opt/projects/swiftkube/vendor/github.com/google/go-cmp/cmp/internal/value/pointer_purego.go", "Go", 27, 0, 0, 0, 0, 0, 8, 35
"/opt/projects/swiftkube/vendor/github.com/google/go-cmp/cmp/internal/value/pointer_unsafe.go", "Go", 30, 0, 0, 0, 0, 0, 8, 38
"/opt/projects/swiftkube/vendor/github.com/google/go-cmp/cmp/internal/value/sort.go", "Go", 100, 0, 0, 0, 0, 0, 7, 107
"/opt/projects/swiftkube/vendor/github.com/google/go-cmp/cmp/options.go", "Go", 492, 0, 0, 0, 0, 0, 63, 555
"/opt/projects/swiftkube/vendor/github.com/google/go-cmp/cmp/path.go", "Go", 337, 0, 0, 0, 0, 0, 44, 381
"/opt/projects/swiftkube/vendor/github.com/google/go-cmp/cmp/report.go", "Go", 49, 0, 0, 0, 0, 0, 6, 55
"/opt/projects/swiftkube/vendor/github.com/google/go-cmp/cmp/report_compare.go", "Go", 400, 0, 0, 0, 0, 0, 34, 434
"/opt/projects/swiftkube/vendor/github.com/google/go-cmp/cmp/report_references.go", "Go", 242, 0, 0, 0, 0, 0, 23, 265
"/opt/projects/swiftkube/vendor/github.com/google/go-cmp/cmp/report_reflect.go", "Go", 381, 0, 0, 0, 0, 0, 34, 415
"/opt/projects/swiftkube/vendor/github.com/google/go-cmp/cmp/report_slices.go", "Go", 583, 0, 0, 0, 0, 0, 32, 615
"/opt/projects/swiftkube/vendor/github.com/google/go-cmp/cmp/report_text.go", "Go", 393, 0, 0, 0, 0, 0, 40, 433
"/opt/projects/swiftkube/vendor/github.com/google/go-cmp/cmp/report_value.go", "Go", 108, 0, 0, 0, 0, 0, 14, 122
"/opt/projects/swiftkube/vendor/github.com/google/gofuzz/bytesource/bytesource.go", "Go", 69, 0, 0, 0, 0, 0, 13, 82
"/opt/projects/swiftkube/vendor/github.com/google/gofuzz/doc.go", "Go", 14, 0, 0, 0, 0, 0, 5, 19
"/opt/projects/swiftkube/vendor/github.com/google/gofuzz/fuzz.go", "Go", 547, 0, 0, 0, 0, 0, 59, 606
"/opt/projects/swiftkube/vendor/github.com/google/shlex/shlex.go", "Go", 379, 0, 0, 0, 0, 0, 38, 417
"/opt/projects/swiftkube/vendor/github.com/google/uuid/dce.go", "Go", 70, 0, 0, 0, 0, 0, 11, 81
"/opt/projects/swiftkube/vendor/github.com/google/uuid/doc.go", "Go", 11, 0, 0, 0, 0, 0, 2, 13
"/opt/projects/swiftkube/vendor/github.com/google/uuid/hash.go", "Go", 47, 0, 0, 0, 0, 0, 7, 54
"/opt/projects/swiftkube/vendor/github.com/google/uuid/marshal.go", "Go", 32, 0, 0, 0, 0, 0, 7, 39
"/opt/projects/swiftkube/vendor/github.com/google/uuid/node.go", "Go", 80, 0, 0, 0, 0, 0, 11, 91
"/opt/projects/swiftkube/vendor/github.com/google/uuid/node_js.go", "Go", 9, 0, 0, 0, 0, 0, 4, 13
"/opt/projects/swiftkube/vendor/github.com/google/uuid/node_net.go", "Go", 28, 0, 0, 0, 0, 0, 6, 34
"/opt/projects/swiftkube/vendor/github.com/google/uuid/null.go", "Go", 101, 0, 0, 0, 0, 0, 18, 119
"/opt/projects/swiftkube/vendor/github.com/google/uuid/sql.go", "Go", 48, 0, 0, 0, 0, 0, 12, 60
"/opt/projects/swiftkube/vendor/github.com/google/uuid/time.go", "Go", 106, 0, 0, 0, 0, 0, 18, 124
"/opt/projects/swiftkube/vendor/github.com/google/uuid/util.go", "Go", 38, 0, 0, 0, 0, 0, 6, 44
"/opt/projects/swiftkube/vendor/github.com/google/uuid/uuid.go", "Go", 265, 0, 0, 0, 0, 0, 30, 295
"/opt/projects/swiftkube/vendor/github.com/google/uuid/version1.go", "Go", 37, 0, 0, 0, 0, 0, 8, 45
"/opt/projects/swiftkube/vendor/github.com/google/uuid/version4.go", "Go", 68, 0, 0, 0, 0, 0, 9, 77
"/opt/projects/swiftkube/vendor/github.com/googleapis/enterprise-certificate-proxy/client/client.go", "Go", 161, 0, 0, 0, 0, 0, 25, 186
"/opt/projects/swiftkube/vendor/github.com/googleapis/enterprise-certificate-proxy/client/util/util.go", "Go", 80, 0, 0, 0, 0, 0, 12, 92
"/opt/projects/swiftkube/vendor/github.com/googleapis/gax-go/v2/apierror/apierror.go", "Go", 312, 0, 0, 0, 0, 0, 36, 348
"/opt/projects/swiftkube/vendor/github.com/googleapis/gax-go/v2/apierror/internal/proto/custom_error.pb.go", "Go", 226, 0, 0, 0, 0, 0, 31, 257
"/opt/projects/swiftkube/vendor/github.com/googleapis/gax-go/v2/apierror/internal/proto/custom_error.proto", "Protocol Buffers", 0, 0, 14, 0, 0, 23, 14, 51
"/opt/projects/swiftkube/vendor/github.com/googleapis/gax-go/v2/apierror/internal/proto/error.pb.go", "Go", 250, 0, 0, 0, 0, 0, 31, 281
"/opt/projects/swiftkube/vendor/github.com/googleapis/gax-go/v2/apierror/internal/proto/error.proto", "Protocol Buffers", 0, 0, 14, 0, 0, 27, 6, 47
"/opt/projects/swiftkube/vendor/github.com/googleapis/gax-go/v2/call_option.go", "Go", 209, 0, 0, 0, 0, 0, 36, 245
"/opt/projects/swiftkube/vendor/github.com/googleapis/gax-go/v2/content_type.go", "Go", 97, 0, 0, 0, 0, 0, 16, 113
"/opt/projects/swiftkube/vendor/github.com/googleapis/gax-go/v2/gax.go", "Go", 38, 0, 0, 0, 0, 0, 4, 42
"/opt/projects/swiftkube/vendor/github.com/googleapis/gax-go/v2/header.go", "Go", 50, 0, 0, 0, 0, 0, 4, 54
"/opt/projects/swiftkube/vendor/github.com/googleapis/gax-go/v2/internal/version.go", "Go", 31, 0, 0, 0, 0, 0, 3, 34
"/opt/projects/swiftkube/vendor/github.com/googleapis/gax-go/v2/invoke.go", "Go", 96, 0, 0, 0, 0, 0, 9, 105
"/opt/projects/swiftkube/vendor/github.com/googleapis/gax-go/v2/proto_json_stream.go", "Go", 113, 0, 0, 0, 0, 0, 14, 127
"/opt/projects/swiftkube/vendor/github.com/gregjones/httpcache/httpcache.go", "Go", 496, 0, 0, 0, 0, 0, 56, 552
"/opt/projects/swiftkube/vendor/github.com/grpc-ecosystem/go-grpc-prometheus/client.go", "Go", 31, 0, 0, 0, 0, 0, 9, 40
"/opt/projects/swiftkube/vendor/github.com/grpc-ecosystem/go-grpc-prometheus/client_metrics.go", "Go", 153, 0, 0, 0, 0, 0, 18, 171
"/opt/projects/swiftkube/vendor/github.com/grpc-ecosystem/go-grpc-prometheus/client_reporter.go", "Go", 38, 0, 0, 0, 0, 0, 9, 47
"/opt/projects/swiftkube/vendor/github.com/grpc-ecosystem/go-grpc-prometheus/metric_options.go", "Go", 33, 0, 0, 0, 0, 0, 9, 42
"/opt/projects/swiftkube/vendor/github.com/grpc-ecosystem/go-grpc-prometheus/server.go", "Go", 39, 0, 0, 0, 0, 0, 10, 49
"/opt/projects/swiftkube/vendor/github.com/grpc-ecosystem/go-grpc-prometheus/server_metrics.go", "Go", 171, 0, 0, 0, 0, 0, 15, 186
"/opt/projects/swiftkube/vendor/github.com/grpc-ecosystem/go-grpc-prometheus/server_reporter.go", "Go", 38, 0, 0, 0, 0, 0, 9, 47
"/opt/projects/swiftkube/vendor/github.com/grpc-ecosystem/go-grpc-prometheus/util.go", "Go", 42, 0, 0, 0, 0, 0, 9, 51
"/opt/projects/swiftkube/vendor/github.com/grpc-ecosystem/grpc-gateway/v2/internal/httprule/compile.go", "Go", 107, 0, 0, 0, 0, 0, 15, 122
"/opt/projects/swiftkube/vendor/github.com/grpc-ecosystem/grpc-gateway/v2/internal/httprule/fuzz.go", "Go", 9, 0, 0, 0, 0, 0, 3, 12
"/opt/projects/swiftkube/vendor/github.com/grpc-ecosystem/grpc-gateway/v2/internal/httprule/parse.go", "Go", 339, 0, 0, 0, 0, 0, 30, 369
"/opt/projects/swiftkube/vendor/github.com/grpc-ecosystem/grpc-gateway/v2/internal/httprule/types.go", "Go", 48, 0, 0, 0, 0, 0, 13, 61
"/opt/projects/swiftkube/vendor/github.com/grpc-ecosystem/grpc-gateway/v2/runtime/context.go", "Go", 303, 0, 0, 0, 0, 0, 43, 346
"/opt/projects/swiftkube/vendor/github.com/grpc-ecosystem/grpc-gateway/v2/runtime/convert.go", "Go", 287, 0, 0, 0, 0, 0, 36, 323
"/opt/projects/swiftkube/vendor/github.com/grpc-ecosystem/grpc-gateway/v2/runtime/doc.go", "Go", 5, 0, 0, 0, 0, 0, 1, 6
"/opt/projects/swiftkube/vendor/github.com/grpc-ecosystem/grpc-gateway/v2/runtime/errors.go", "Go", 154, 0, 0, 0, 0, 0, 27, 181
"/opt/projects/swiftkube/vendor/github.com/grpc-ecosystem/grpc-gateway/v2/runtime/fieldmask.go", "Go", 141, 0, 0, 0, 0, 0, 25, 166
"/opt/projects/swiftkube/vendor/github.com/grpc-ecosystem/grpc-gateway/v2/runtime/handler.go", "Go", 195, 0, 0, 0, 0, 0, 29, 224
"/opt/projects/swiftkube/vendor/github.com/grpc-ecosystem/grpc-gateway/v2/runtime/marshal_httpbodyproto.go", "Go", 28, 0, 0, 0, 0, 0, 5, 33
"/opt/projects/swiftkube/vendor/github.com/grpc-ecosystem/grpc-gateway/v2/runtime/marshal_json.go", "Go", 37, 0, 0, 0, 0, 0, 9, 46
"/opt/projects/swiftkube/vendor/github.com/grpc-ecosystem/grpc-gateway/v2/runtime/marshal_jsonpb.go", "Go", 311, 0, 0, 0, 0, 0, 34, 345
"/opt/projects/swiftkube/vendor/github.com/grpc-ecosystem/grpc-gateway/v2/runtime/marshal_proto.go", "Go", 53, 0, 0, 0, 0, 0, 11, 64
"/opt/projects/swiftkube/vendor/github.com/grpc-ecosystem/grpc-gateway/v2/runtime/marshaler.go", "Go", 41, 0, 0, 0, 0, 0, 10, 51
"/opt/projects/swiftkube/vendor/github.com/grpc-ecosystem/grpc-gateway/v2/runtime/marshaler_registry.go", "Go", 94, 0, 0, 0, 0, 0, 16, 110
"/opt/projects/swiftkube/vendor/github.com/grpc-ecosystem/grpc-gateway/v2/runtime/mux.go", "Go", 313, 0, 0, 0, 0, 0, 44, 357
"/opt/projects/swiftkube/vendor/github.com/grpc-ecosystem/grpc-gateway/v2/runtime/pattern.go", "Go", 353, 0, 0, 0, 0, 0, 31, 384
"/opt/projects/swiftkube/vendor/github.com/grpc-ecosystem/grpc-gateway/v2/runtime/proto2_convert.go", "Go", 71, 0, 0, 0, 0, 0, 10, 81
"/opt/projects/swiftkube/vendor/github.com/grpc-ecosystem/grpc-gateway/v2/runtime/query.go", "Go", 298, 0, 0, 0, 0, 0, 32, 330
"/opt/projects/swiftkube/vendor/github.com/grpc-ecosystem/grpc-gateway/v2/utilities/doc.go", "Go", 2, 0, 0, 0, 0, 0, 1, 3
"/opt/projects/swiftkube/vendor/github.com/grpc-ecosystem/grpc-gateway/v2/utilities/pattern.go", "Go", 20, 0, 0, 0, 0, 0, 3, 23
"/opt/projects/swiftkube/vendor/github.com/grpc-ecosystem/grpc-gateway/v2/utilities/readerfactory.go", "Go", 17, 0, 0, 0, 0, 0, 4, 21
"/opt/projects/swiftkube/vendor/github.com/grpc-ecosystem/grpc-gateway/v2/utilities/trie.go", "Go", 157, 0, 0, 0, 0, 0, 18, 175
"/opt/projects/swiftkube/vendor/github.com/imdario/mergo/doc.go", "Go", 33, 0, 0, 0, 0, 0, 12, 45
"/opt/projects/swiftkube/vendor/github.com/imdario/mergo/map.go", "Go", 162, 0, 0, 0, 0, 0, 13, 175
"/opt/projects/swiftkube/vendor/github.com/imdario/mergo/merge.go", "Go", 230, 0, 0, 0, 0, 0, 23, 253
"/opt/projects/swiftkube/vendor/github.com/imdario/mergo/mergo.go", "Go", 89, 0, 0, 0, 0, 0, 9, 98
"/opt/projects/swiftkube/vendor/github.com/inconshreveable/mousetrap/trap_others.go", "Go", 14, 0, 0, 0, 0, 0, 3, 17
"/opt/projects/swiftkube/vendor/github.com/inconshreveable/mousetrap/trap_windows.go", "Go", 39, 0, 0, 0, 0, 0, 4, 43
"/opt/projects/swiftkube/vendor/github.com/jonboulle/clockwork/clockwork.go", "Go", 171, 0, 0, 0, 0, 0, 25, 196
"/opt/projects/swiftkube/vendor/github.com/jonboulle/clockwork/ticker.go", "Go", 64, 0, 0, 0, 0, 0, 9, 73
"/opt/projects/swiftkube/vendor/github.com/josharian/intern/intern.go", "Go", 40, 0, 0, 0, 0, 0, 5, 45
"/opt/projects/swiftkube/vendor/github.com/json-iterator/go/adapter.go", "Go", 129, 0, 0, 0, 0, 0, 22, 151
"/opt/projects/swiftkube/vendor/github.com/json-iterator/go/any.go", "Go", 292, 0, 0, 0, 0, 0, 34, 326
"/opt/projects/swiftkube/vendor/github.com/json-iterator/go/any_array.go", "Go", 239, 0, 0, 0, 0, 0, 40, 279
"/opt/projects/swiftkube/vendor/github.com/json-iterator/go/any_bool.go", "Go", 103, 0, 0, 0, 0, 0, 35, 138
"/opt/projects/swiftkube/vendor/github.com/json-iterator/go/any_float.go", "Go", 65, 0, 0, 0, 0, 0, 19, 84
"/opt/projects/swiftkube/vendor/github.com/json-iterator/go/any_int32.go", "Go", 56, 0, 0, 0, 0, 0, 19, 75
"/opt/projects/swiftkube/vendor/github.com/json-iterator/go/any_int64.go", "Go", 56, 0, 0, 0, 0, 0, 19, 75
"/opt/projects/swiftkube/vendor/github.com/json-iterator/go/any_invalid.go", "Go", 62, 0, 0, 0, 0, 0, 21, 83
"/opt/projects/swiftkube/vendor/github.com/json-iterator/go/any_nil.go", "Go", 52, 0, 0, 0, 0, 0, 18, 70
"/opt/projects/swiftkube/vendor/github.com/json-iterator/go/any_number.go", "Go", 106, 0, 0, 0, 0, 0, 18, 124
"/opt/projects/swiftkube/vendor/github.com/json-iterator/go/any_object.go", "Go", 311, 0, 0, 0, 0, 0, 64, 375
"/opt/projects/swiftkube/vendor/github.com/json-iterator/go/any_str.go", "Go", 137, 0, 0, 0, 0, 0, 30, 167
"/opt/projects/swiftkube/vendor/github.com/json-iterator/go/any_uint32.go", "Go", 56, 0, 0, 0, 0, 0, 19, 75
"/opt/projects/swiftkube/vendor/github.com/json-iterator/go/any_uint64.go", "Go", 56, 0, 0, 0, 0, 0, 19, 75
"/opt/projects/swiftkube/vendor/github.com/json-iterator/go/config.go", "Go", 332, 0, 0, 0, 0, 0, 44, 376
"/opt/projects/swiftkube/vendor/github.com/json-iterator/go/iter.go", "Go", 323, 0, 0, 0, 0, 0, 27, 350
"/opt/projects/swiftkube/vendor/github.com/json-iterator/go/iter_array.go", "Go", 62, 0, 0, 0, 0, 0, 3, 65
"/opt/projects/swiftkube/vendor/github.com/json-iterator/go/iter_float.go", "Go", 327, 0, 0, 0, 0, 0, 16, 343
"/opt/projects/swiftkube/vendor/github.com/json-iterator/go/iter_int.go", "Go", 329, 0, 0, 0, 0, 0, 18, 347
"/opt/projects/swiftkube/vendor/github.com/json-iterator/go/iter_object.go", "Go", 259, 0, 0, 0, 0, 0, 9, 268
"/opt/projects/swiftkube/vendor/github.com/json-iterator/go/iter_skip.go", "Go", 119, 0, 0, 0, 0, 0, 12, 131
"/opt/projects/swiftkube/vendor/github.com/json-iterator/go/iter_skip_sloppy.go", "Go", 152, 0, 0, 0, 0, 0, 12, 164
"/opt/projects/swiftkube/vendor/github.com/json-iterator/go/iter_skip_strict.go", "Go", 91, 0, 0, 0, 0, 0, 9, 100
"/opt/projects/swiftkube/vendor/github.com/json-iterator/go/iter_str.go", "Go", 203, 0, 0, 0, 0, 0, 13, 216
"/opt/projects/swiftkube/vendor/github.com/json-iterator/go/jsoniter.go", "Go", 18, 0, 0, 0, 0, 0, 1, 19
"/opt/projects/swiftkube/vendor/github.com/json-iterator/go/pool.go", "Go", 35, 0, 0, 0, 0, 0, 8, 43
"/opt/projects/swiftkube/vendor/github.com/json-iterator/go/reflect.go", "Go", 307, 0, 0, 0, 0, 0, 31, 338
"/opt/projects/swiftkube/vendor/github.com/json-iterator/go/reflect_array.go", "Go", 92, 0, 0, 0, 0, 0, 13, 105
"/opt/projects/swiftkube/vendor/github.com/json-iterator/go/reflect_dynamic.go", "Go", 62, 0, 0, 0, 0, 0, 9, 71
"/opt/projects/swiftkube/vendor/github.com/json-iterator/go/reflect_extension.go", "Go", 427, 0, 0, 0, 0, 0, 57, 484
"/opt/projects/swiftkube/vendor/github.com/json-iterator/go/reflect_json_number.go", "Go", 95, 0, 0, 0, 0, 0, 18, 113
"/opt/projects/swiftkube/vendor/github.com/json-iterator/go/reflect_json_raw_message.go", "Go", 64, 0, 0, 0, 0, 0, 13, 77
"/opt/projects/swiftkube/vendor/github.com/json-iterator/go/reflect_map.go", "Go", 318, 0, 0, 0, 0, 0, 29, 347
"/opt/projects/swiftkube/vendor/github.com/json-iterator/go/reflect_marshaler.go", "Go", 204, 0, 0, 0, 0, 0, 22, 226
"/opt/projects/swiftkube/vendor/github.com/json-iterator/go/reflect_native.go", "Go", 396, 0, 0, 0, 0, 0, 58, 454
"/opt/projects/swiftkube/vendor/github.com/json-iterator/go/reflect_optional.go", "Go", 110, 0, 0, 0, 0, 0, 20, 130
"/opt/projects/swiftkube/vendor/github.com/json-iterator/go/reflect_slice.go", "Go", 90, 0, 0, 0, 0, 0, 10, 100
"/opt/projects/swiftkube/vendor/github.com/json-iterator/go/reflect_struct_decoder.go", "Go", 1058, 0, 0, 0, 0, 0, 40, 1098
"/opt/projects/swiftkube/vendor/github.com/json-iterator/go/reflect_struct_encoder.go", "Go", 189, 0, 0, 0, 0, 0, 23, 212
"/opt/projects/swiftkube/vendor/github.com/json-iterator/go/stream.go", "Go", 180, 0, 0, 0, 0, 0, 31, 211
"/opt/projects/swiftkube/vendor/github.com/json-iterator/go/stream_float.go", "Go", 104, 0, 0, 0, 0, 0, 8, 112
"/opt/projects/swiftkube/vendor/github.com/json-iterator/go/stream_int.go", "Go", 176, 0, 0, 0, 0, 0, 15, 191
"/opt/projects/swiftkube/vendor/github.com/json-iterator/go/stream_str.go", "Go", 364, 0, 0, 0, 0, 0, 9, 373
"/opt/projects/swiftkube/vendor/github.com/karrick/godirwalk/debug_development.go", "Go", 11, 0, 0, 0, 0, 0, 4, 15
"/opt/projects/swiftkube/vendor/github.com/karrick/godirwalk/debug_release.go", "Go", 4, 0, 0, 0, 0, 0, 3, 7
"/opt/projects/swiftkube/vendor/github.com/karrick/godirwalk/dirent.go", "Go", 89, 0, 0, 0, 0, 0, 16, 105
"/opt/projects/swiftkube/vendor/github.com/karrick/godirwalk/doc.go", "Go", 30, 0, 0, 0, 0, 0, 13, 43
"/opt/projects/swiftkube/vendor/github.com/karrick/godirwalk/inoWithFileno.go", "Go", 6, 0, 0, 0, 0, 0, 4, 10
"/opt/projects/swiftkube/vendor/github.com/karrick/godirwalk/inoWithIno.go", "Go", 6, 0, 0, 0, 0, 0, 4, 10
"/opt/projects/swiftkube/vendor/github.com/karrick/godirwalk/modeType.go", "Go", 20, 0, 0, 0, 0, 0, 3, 23
"/opt/projects/swiftkube/vendor/github.com/karrick/godirwalk/modeTypeWithType.go", "Go", 34, 0, 0, 0, 0, 0, 4, 38
"/opt/projects/swiftkube/vendor/github.com/karrick/godirwalk/modeTypeWithoutType.go", "Go", 15, 0, 0, 0, 0, 0, 4, 19
"/opt/projects/swiftkube/vendor/github.com/karrick/godirwalk/nameWithNamlen.go", "Go", 24, 0, 0, 0, 0, 0, 6, 30
"/opt/projects/swiftkube/vendor/github.com/karrick/godirwalk/nameWithoutNamlen.go", "Go", 35, 0, 0, 0, 0, 0, 8, 43
"/opt/projects/swiftkube/vendor/github.com/karrick/godirwalk/readdir.go", "Go", 51, 0, 0, 0, 0, 0, 3, 54
"/opt/projects/swiftkube/vendor/github.com/karrick/godirwalk/readdir_unix.go", "Go", 109, 0, 0, 0, 0, 0, 23, 132
"/opt/projects/swiftkube/vendor/github.com/karrick/godirwalk/readdir_windows.go", "Go", 52, 0, 0, 0, 0, 0, 15, 67
"/opt/projects/swiftkube/vendor/github.com/karrick/godirwalk/reclenFromNamlen.go", "Go", 6, 0, 0, 0, 0, 0, 4, 10
"/opt/projects/swiftkube/vendor/github.com/karrick/godirwalk/reclenFromReclen.go", "Go", 6, 0, 0, 0, 0, 0, 4, 10
"/opt/projects/swiftkube/vendor/github.com/karrick/godirwalk/scandir_unix.go", "Go", 160, 0, 0, 0, 0, 0, 22, 182
"/opt/projects/swiftkube/vendor/github.com/karrick/godirwalk/scandir_windows.go", "Go", 131, 0, 0, 0, 0, 0, 19, 150
"/opt/projects/swiftkube/vendor/github.com/karrick/godirwalk/scanner.go", "Go", 36, 0, 0, 0, 0, 0, 9, 45
"/opt/projects/swiftkube/vendor/github.com/karrick/godirwalk/walk.go", "Go", 347, 0, 0, 0, 0, 0, 33, 380
"/opt/projects/swiftkube/vendor/github.com/libopenstorage/openstorage/api/api.go", "Go", 315, 0, 0, 0, 0, 0, 51, 366
"/opt/projects/swiftkube/vendor/github.com/libopenstorage/openstorage/api/api.pb.go", "Go", 1804, 0, 0, 0, 0, 0, 239, 2043
"/opt/projects/swiftkube/vendor/github.com/libopenstorage/openstorage/api/api.proto", "Protocol Buffers", 0, 0, 283, 0, 0, 145, 44, 472
"/opt/projects/swiftkube/vendor/github.com/libopenstorage/openstorage/api/client/client.go", "Go", 160, 0, 0, 0, 0, 0, 19, 179
"/opt/projects/swiftkube/vendor/github.com/libopenstorage/openstorage/api/client/request.go", "Go", 293, 0, 0, 0, 0, 0, 39, 332
"/opt/projects/swiftkube/vendor/github.com/libopenstorage/openstorage/api/client/volume/client.go", "Go", 359, 0, 0, 0, 0, 0, 45, 404
"/opt/projects/swiftkube/vendor/github.com/libopenstorage/openstorage/api/client/volume/volume.go", "Go", 61, 0, 0, 0, 0, 0, 7, 68
"/opt/projects/swiftkube/vendor/github.com/libopenstorage/openstorage/api/spec/spec_handler.go", "Go", 325, 0, 0, 0, 0, 0, 29, 354
"/opt/projects/swiftkube/vendor/github.com/libopenstorage/openstorage/api/status.go", "Go", 46, 0, 0, 0, 0, 0, 8, 54
"/opt/projects/swiftkube/vendor/github.com/libopenstorage/openstorage/pkg/parser/labels.go", "Go", 68, 0, 0, 0, 0, 0, 7, 75
"/opt/projects/swiftkube/vendor/github.com/libopenstorage/openstorage/pkg/units/units.go", "Go", 126, 0, 0, 0, 0, 0, 14, 140
"/opt/projects/swiftkube/vendor/github.com/libopenstorage/openstorage/volume/volume.go", "Go", 197, 0, 0, 0, 0, 0, 21, 218
"/opt/projects/swiftkube/vendor/github.com/libopenstorage/openstorage/volume/volume_driver_registry.go", "Go", 63, 0, 0, 0, 0, 0, 9, 72
"/opt/projects/swiftkube/vendor/github.com/libopenstorage/openstorage/volume/volume_not_supported.go", "Go", 58, 0, 0, 0, 0, 0, 17, 75
"/opt/projects/swiftkube/vendor/github.com/liggitt/tabwriter/tabwriter.go", "Go", 573, 0, 0, 0, 0, 0, 65, 638
"/opt/projects/swiftkube/vendor/github.com/lithammer/dedent/dedent.go", "Go", 43, 0, 0, 0, 0, 0, 7, 50
"/opt/projects/swiftkube/vendor/github.com/mailru/easyjson/buffer/pool.go", "Go", 233, 0, 0, 0, 0, 0, 46, 279
"/opt/projects/swiftkube/vendor/github.com/mailru/easyjson/jlexer/bytestostr.go", "Go", 20, 0, 0, 0, 0, 0, 5, 25
"/opt/projects/swiftkube/vendor/github.com/mailru/easyjson/jlexer/bytestostr_nounsafe.go", "Go", 10, 0, 0, 0, 0, 0, 4, 14
"/opt/projects/swiftkube/vendor/github.com/mailru/easyjson/jlexer/error.go", "Go", 12, 0, 0, 0, 0, 0, 4, 16
"/opt/projects/swiftkube/vendor/github.com/mailru/easyjson/jlexer/lexer.go", "Go", 1095, 0, 0, 0, 0, 0, 150, 1245
"/opt/projects/swiftkube/vendor/github.com/mailru/easyjson/jwriter/writer.go", "Go", 334, 0, 0, 0, 0, 0, 72, 406
"/opt/projects/swiftkube/vendor/github.com/matttproud/golang_protobuf_extensions/pbutil/decode.go", "Go", 68, 0, 0, 0, 0, 0, 8, 76
"/opt/projects/swiftkube/vendor/github.com/matttproud/golang_protobuf_extensions/pbutil/doc.go", "Go", 15, 0, 0, 0, 0, 0, 2, 17
"/opt/projects/swiftkube/vendor/github.com/matttproud/golang_protobuf_extensions/pbutil/encode.go", "Go", 39, 0, 0, 0, 0, 0, 8, 47
"/opt/projects/swiftkube/vendor/github.com/mistifyio/go-zfs/error.go", "Go", 15, 0, 0, 0, 0, 0, 4, 19
"/opt/projects/swiftkube/vendor/github.com/mistifyio/go-zfs/utils.go", "Go", 311, 0, 0, 0, 0, 0, 50, 361
"/opt/projects/swiftkube/vendor/github.com/mistifyio/go-zfs/utils_notsolaris.go", "Go", 12, 0, 0, 0, 0, 0, 6, 18
"/opt/projects/swiftkube/vendor/github.com/mistifyio/go-zfs/utils_solaris.go", "Go", 12, 0, 0, 0, 0, 0, 6, 18
"/opt/projects/swiftkube/vendor/github.com/mistifyio/go-zfs/zfs.go", "Go", 400, 0, 0, 0, 0, 0, 53, 453
"/opt/projects/swiftkube/vendor/github.com/mistifyio/go-zfs/zpool.go", "Go", 97, 0, 0, 0, 0, 0, 16, 113
"/opt/projects/swiftkube/vendor/github.com/mitchellh/go-wordwrap/wordwrap.go", "Go", 74, 0, 0, 0, 0, 0, 10, 84
"/opt/projects/swiftkube/vendor/github.com/moby/ipvs/constants_linux.go", "Go", 150, 0, 0, 0, 0, 0, 27, 177
"/opt/projects/swiftkube/vendor/github.com/moby/ipvs/doc.go", "Go", 1, 0, 0, 0, 0, 0, 1, 2
"/opt/projects/swiftkube/vendor/github.com/moby/ipvs/ipvs_linux.go", "Go", 173, 0, 0, 0, 0, 0, 31, 204
"/opt/projects/swiftkube/vendor/github.com/moby/ipvs/netlink_linux.go", "Go", 574, 0, 0, 0, 0, 0, 102, 676
"/opt/projects/swiftkube/vendor/github.com/moby/spdystream/connection.go", "Go", 843, 0, 0, 0, 0, 0, 130, 973
"/opt/projects/swiftkube/vendor/github.com/moby/spdystream/handlers.go", "Go", 44, 0, 0, 0, 0, 0, 9, 53
"/opt/projects/swiftkube/vendor/github.com/moby/spdystream/priority.go", "Go", 95, 0, 0, 0, 0, 0, 20, 115
"/opt/projects/swiftkube/vendor/github.com/moby/spdystream/spdy/dictionary.go", "Go", 197, 0, 0, 0, 0, 0, 7, 204
"/opt/projects/swiftkube/vendor/github.com/moby/spdystream/spdy/read.go", "Go", 340, 0, 0, 0, 0, 0, 25, 365
"/opt/projects/swiftkube/vendor/github.com/moby/spdystream/spdy/types.go", "Go", 245, 0, 0, 0, 0, 0, 47, 292
"/opt/projects/swiftkube/vendor/github.com/moby/spdystream/spdy/write.go", "Go", 300, 0, 0, 0, 0, 0, 35, 335
"/opt/projects/swiftkube/vendor/github.com/moby/spdystream/stream.go", "Go", 295, 0, 0, 0, 0, 0, 49, 344
"/opt/projects/swiftkube/vendor/github.com/moby/spdystream/utils.go", "Go", 25, 0, 0, 0, 0, 0, 8, 33
"/opt/projects/swiftkube/vendor/github.com/moby/sys/mountinfo/doc.go", "Go", 44, 0, 0, 0, 0, 0, 1, 45
"/opt/projects/swiftkube/vendor/github.com/moby/sys/mountinfo/mounted_linux.go", "Go", 89, 0, 0, 0, 0, 0, 13, 102
"/opt/projects/swiftkube/vendor/github.com/moby/sys/mountinfo/mounted_unix.go", "Go", 45, 0, 0, 0, 0, 0, 9, 54
"/opt/projects/swiftkube/vendor/github.com/moby/sys/mountinfo/mountinfo.go", "Go", 54, 0, 0, 0, 0, 0, 14, 68
"/opt/projects/swiftkube/vendor/github.com/moby/sys/mountinfo/mountinfo_bsd.go", "Go", 47, 0, 0, 0, 0, 0, 10, 57
"/opt/projects/swiftkube/vendor/github.com/moby/sys/mountinfo/mountinfo_filters.go", "Go", 57, 0, 0, 0, 0, 0, 7, 64
"/opt/projects/swiftkube/vendor/github.com/moby/sys/mountinfo/mountinfo_freebsdlike.go", "Go", 11, 0, 0, 0, 0, 0, 4, 15
"/opt/projects/swiftkube/vendor/github.com/moby/sys/mountinfo/mountinfo_linux.go", "Go", 190, 0, 0, 0, 0, 0, 25, 215
"/opt/projects/swiftkube/vendor/github.com/moby/sys/mountinfo/mountinfo_openbsd.go", "Go", 9, 0, 0, 0, 0, 0, 3, 12
"/opt/projects/swiftkube/vendor/github.com/moby/sys/mountinfo/mountinfo_unsupported.go", "Go", 14, 0, 0, 0, 0, 0, 6, 20
"/opt/projects/swiftkube/vendor/github.com/moby/sys/mountinfo/mountinfo_windows.go", "Go", 8, 0, 0, 0, 0, 0, 3, 11
"/opt/projects/swiftkube/vendor/github.com/moby/term/ascii.go", "Go", 63, 0, 0, 0, 0, 0, 4, 67
"/opt/projects/swiftkube/vendor/github.com/moby/term/proxy.go", "Go", 76, 0, 0, 0, 0, 0, 13, 89
"/opt/projects/swiftkube/vendor/github.com/moby/term/tc.go", "Go", 16, 0, 0, 0, 0, 0, 5, 21
"/opt/projects/swiftkube/vendor/github.com/moby/term/term.go", "Go", 85, 0, 0, 0, 0, 0, 16, 101
"/opt/projects/swiftkube/vendor/github.com/moby/term/term_windows.go", "Go", 190, 0, 0, 0, 0, 0, 38, 228
"/opt/projects/swiftkube/vendor/github.com/moby/term/termios.go", "Go", 29, 0, 0, 0, 0, 0, 8, 37
"/opt/projects/swiftkube/vendor/github.com/moby/term/termios_bsd.go", "Go", 10, 0, 0, 0, 0, 0, 4, 14
"/opt/projects/swiftkube/vendor/github.com/moby/term/termios_nonbsd.go", "Go", 10, 0, 0, 0, 0, 0, 4, 14
"/opt/projects/swiftkube/vendor/github.com/moby/term/windows/ansi_reader.go", "Go", 216, 0, 0, 0, 0, 0, 37, 253
"/opt/projects/swiftkube/vendor/github.com/moby/term/windows/ansi_writer.go", "Go", 47, 0, 0, 0, 0, 0, 11, 58
"/opt/projects/swiftkube/vendor/github.com/moby/term/windows/console.go", "Go", 32, 0, 0, 0, 0, 0, 9, 41
"/opt/projects/swiftkube/vendor/github.com/moby/term/windows/doc.go", "Go", 4, 0, 0, 0, 0, 0, 2, 6
"/opt/projects/swiftkube/vendor/github.com/moby/term/winsize.go", "Go", 17, 0, 0, 0, 0, 0, 5, 22
"/opt/projects/swiftkube/vendor/github.com/modern-go/concurrent/executor.go", "Go", 12, 0, 0, 0, 0, 0, 3, 15
"/opt/projects/swiftkube/vendor/github.com/modern-go/concurrent/go_above_19.go", "Go", 11, 0, 0, 0, 0, 0, 5, 16
"/opt/projects/swiftkube/vendor/github.com/modern-go/concurrent/go_below_19.go", "Go", 27, 0, 0, 0, 0, 0, 7, 34
"/opt/projects/swiftkube/vendor/github.com/modern-go/concurrent/log.go", "Go", 10, 0, 0, 0, 0, 0, 3, 13
"/opt/projects/swiftkube/vendor/github.com/modern-go/concurrent/unbounded_executor.go", "Go", 109, 0, 0, 0, 0, 0, 11, 120
"/opt/projects/swiftkube/vendor/github.com/modern-go/reflect2/go_above_118.go", "Go", 19, 0, 0, 0, 0, 0, 4, 23
"/opt/projects/swiftkube/vendor/github.com/modern-go/reflect2/go_above_19.go", "Go", 12, 0, 0, 0, 0, 0, 6, 18
"/opt/projects/swiftkube/vendor/github.com/modern-go/reflect2/go_below_118.go", "Go", 17, 0, 0, 0, 0, 0, 4, 21
"/opt/projects/swiftkube/vendor/github.com/modern-go/reflect2/reflect2.go", "Go", 269, 0, 0, 0, 0, 0, 32, 301
"/opt/projects/swiftkube/vendor/github.com/modern-go/reflect2/reflect2_kind.go", "Go", 27, 0, 0, 0, 0, 0, 4, 31
"/opt/projects/swiftkube/vendor/github.com/modern-go/reflect2/safe_field.go", "Go", 45, 0, 0, 0, 0, 0, 14, 59
"/opt/projects/swiftkube/vendor/github.com/modern-go/reflect2/safe_map.go", "Go", 85, 0, 0, 0, 0, 0, 17, 102
"/opt/projects/swiftkube/vendor/github.com/modern-go/reflect2/safe_slice.go", "Go", 74, 0, 0, 0, 0, 0, 19, 93
"/opt/projects/swiftkube/vendor/github.com/modern-go/reflect2/safe_struct.go", "Go", 24, 0, 0, 0, 0, 0, 6, 30
"/opt/projects/swiftkube/vendor/github.com/modern-go/reflect2/safe_type.go", "Go", 60, 0, 0, 0, 0, 0, 19, 79
"/opt/projects/swiftkube/vendor/github.com/modern-go/reflect2/type_map.go", "Go", 59, 0, 0, 0, 0, 0, 12, 71
"/opt/projects/swiftkube/vendor/github.com/modern-go/reflect2/unsafe_array.go", "Go", 55, 0, 0, 0, 0, 0, 11, 66
"/opt/projects/swiftkube/vendor/github.com/modern-go/reflect2/unsafe_eface.go", "Go", 49, 0, 0, 0, 0, 0, 11, 60
"/opt/projects/swiftkube/vendor/github.com/modern-go/reflect2/unsafe_field.go", "Go", 60, 0, 0, 0, 0, 0, 15, 75
"/opt/projects/swiftkube/vendor/github.com/modern-go/reflect2/unsafe_iface.go", "Go", 54, 0, 0, 0, 0, 0, 11, 65
"/opt/projects/swiftkube/vendor/github.com/modern-go/reflect2/unsafe_link.go", "Go", 64, 0, 0, 0, 0, 0, 13, 77
"/opt/projects/swiftkube/vendor/github.com/modern-go/reflect2/unsafe_map.go", "Go", 109, 0, 0, 0, 0, 0, 22, 131
"/opt/projects/swiftkube/vendor/github.com/modern-go/reflect2/unsafe_ptr.go", "Go", 38, 0, 0, 0, 0, 0, 9, 47
"/opt/projects/swiftkube/vendor/github.com/modern-go/reflect2/unsafe_slice.go", "Go", 152, 0, 0, 0, 0, 0, 26, 178
"/opt/projects/swiftkube/vendor/github.com/modern-go/reflect2/unsafe_struct.go", "Go", 49, 0, 0, 0, 0, 0, 11, 60
"/opt/projects/swiftkube/vendor/github.com/modern-go/reflect2/unsafe_type.go", "Go", 70, 0, 0, 0, 0, 0, 16, 86
"/opt/projects/swiftkube/vendor/github.com/mohae/deepcopy/deepcopy.go", "Go", 97, 0, 0, 0, 0, 0, 16, 113
"/opt/projects/swiftkube/vendor/github.com/monochromegane/go-gitignore/depth_holder.go", "Go", 68, 0, 0, 0, 0, 0, 12, 80
"/opt/projects/swiftkube/vendor/github.com/monochromegane/go-gitignore/full_scan_patterns.go", "Go", 26, 0, 0, 0, 0, 0, 6, 32
"/opt/projects/swiftkube/vendor/github.com/monochromegane/go-gitignore/gitignore.go", "Go", 68, 0, 0, 0, 0, 0, 13, 81
"/opt/projects/swiftkube/vendor/github.com/monochromegane/go-gitignore/index_scan_patterns.go", "Go", 29, 0, 0, 0, 0, 0, 7, 36
"/opt/projects/swiftkube/vendor/github.com/monochromegane/go-gitignore/initial_holder.go", "Go", 51, 0, 0, 0, 0, 0, 12, 63
"/opt/projects/swiftkube/vendor/github.com/monochromegane/go-gitignore/match.go", "Go", 18, 0, 0, 0, 0, 0, 7, 25
"/opt/projects/swiftkube/vendor/github.com/monochromegane/go-gitignore/pattern.go", "Go", 57, 0, 0, 0, 0, 0, 13, 70
"/opt/projects/swiftkube/vendor/github.com/monochromegane/go-gitignore/patterns.go", "Go", 18, 0, 0, 0, 0, 0, 5, 23
"/opt/projects/swiftkube/vendor/github.com/monochromegane/go-gitignore/util.go", "Go", 39, 0, 0, 0, 0, 0, 7, 46
"/opt/projects/swiftkube/vendor/github.com/mrunalp/fileutils/fileutils.go", "Go", 142, 0, 0, 0, 0, 0, 27, 169
"/opt/projects/swiftkube/vendor/github.com/mrunalp/fileutils/idtools.go", "Go", 49, 0, 0, 0, 0, 0, 6, 55
"/opt/projects/swiftkube/vendor/github.com/munnerz/goautoneg/autoneg.go", "Go", 162, 0, 0, 0, 0, 0, 28, 190
"/opt/projects/swiftkube/vendor/github.com/mxk/go-flowrate/flowrate/flowrate.go", "Go", 243, 0, 0, 0, 0, 0, 25, 268
"/opt/projects/swiftkube/vendor/github.com/mxk/go-flowrate/flowrate/io.go", "Go", 115, 0, 0, 0, 0, 0, 19, 134
"/opt/projects/swiftkube/vendor/github.com/mxk/go-flowrate/flowrate/util.go", "Go", 55, 0, 0, 0, 0, 0, 13, 68
"/opt/projects/swiftkube/vendor/github.com/opencontainers/go-digest/algorithm.go", "Go", 165, 0, 0, 0, 0, 0, 29, 194
"/opt/projects/swiftkube/vendor/github.com/opencontainers/go-digest/digest.go", "Go", 132, 0, 0, 0, 0, 0, 26, 158
"/opt/projects/swiftkube/vendor/github.com/opencontainers/go-digest/digester.go", "Go", 34, 0, 0, 0, 0, 0, 7, 41
"/opt/projects/swiftkube/vendor/github.com/opencontainers/go-digest/doc.go", "Go", 61, 0, 0, 0, 0, 0, 2, 63
"/opt/projects/swiftkube/vendor/github.com/opencontainers/go-digest/verifiers.go", "Go", 39, 0, 0, 0, 0, 0, 8, 47
"/opt/projects/swiftkube/vendor/github.com/opencontainers/runc/libcontainer/apparmor/apparmor.go", "Go", 12, 0, 0, 0, 0, 0, 5, 17
"/opt/projects/swiftkube/vendor/github.com/opencontainers/runc/libcontainer/apparmor/apparmor_linux.go", "Go", 57, 0, 0, 0, 0, 0, 12, 69
"/opt/projects/swiftkube/vendor/github.com/opencontainers/runc/libcontainer/apparmor/apparmor_unsupported.go", "Go", 12, 0, 0, 0, 0, 0, 4, 16
"/opt/projects/swiftkube/vendor/github.com/opencontainers/runc/libcontainer/capabilities/capabilities.go", "Go", 109, 0, 0, 0, 0, 0, 15, 124
"/opt/projects/swiftkube/vendor/github.com/opencontainers/runc/libcontainer/capabilities/capabilities_unsupported.go", "Go", 3, 0, 0, 0, 0, 0, 2, 5
"/opt/projects/swiftkube/vendor/github.com/opencontainers/runc/libcontainer/cgroups/cgroups.go", "Go", 45, 0, 0, 0, 0, 0, 15, 60
"/opt/projects/swiftkube/vendor/github.com/opencontainers/runc/libcontainer/cgroups/devices/devices_emulator.go", "Go", 349, 0, 0, 0, 0, 0, 38, 387
"/opt/projects/swiftkube/vendor/github.com/opencontainers/runc/libcontainer/cgroups/ebpf/devicefilter/devicefilter.go", "Go", 192, 0, 0, 0, 0, 0, 17, 209
"/opt/projects/swiftkube/vendor/github.com/opencontainers/runc/libcontainer/cgroups/ebpf/ebpf_linux.go", "Go", 237, 0, 0, 0, 0, 0, 17, 254
"/opt/projects/swiftkube/vendor/github.com/opencontainers/runc/libcontainer/cgroups/file.go", "Go", 169, 0, 0, 0, 0, 0, 22, 191
"/opt/projects/swiftkube/vendor/github.com/opencontainers/runc/libcontainer/cgroups/fs/blkio.go", "Go", 287, 0, 0, 0, 0, 0, 25, 312
"/opt/projects/swiftkube/vendor/github.com/opencontainers/runc/libcontainer/cgroups/fs/cpu.go", "Go", 117, 0, 0, 0, 0, 0, 13, 130
"/opt/projects/swiftkube/vendor/github.com/opencontainers/runc/libcontainer/cgroups/fs/cpuacct.go", "Go", 140, 0, 0, 0, 0, 0, 27, 167
"/opt/projects/swiftkube/vendor/github.com/opencontainers/runc/libcontainer/cgroups/fs/cpuset.go", "Go", 213, 0, 0, 0, 0, 0, 33, 246
"/opt/projects/swiftkube/vendor/github.com/opencontainers/runc/libcontainer/cgroups/fs/devices.go", "Go", 96, 0, 0, 0, 0, 0, 14, 110
"/opt/projects/swiftkube/vendor/github.com/opencontainers/runc/libcontainer/cgroups/fs/error.go", "Go", 11, 0, 0, 0, 0, 0, 5, 16
"/opt/projects/swiftkube/vendor/github.com/opencontainers/runc/libcontainer/cgroups/fs/freezer.go", "Go", 146, 0, 0, 0, 0, 0, 13, 159
"/opt/projects/swiftkube/vendor/github.com/opencontainers/runc/libcontainer/cgroups/fs/fs.go", "Go", 230, 0, 0, 0, 0, 0, 36, 266
"/opt/projects/swiftkube/vendor/github.com/opencontainers/runc/libcontainer/cgroups/fs/hugetlb.go", "Go", 50, 0, 0, 0, 0, 0, 13, 63
"/opt/projects/swiftkube/vendor/github.com/opencontainers/runc/libcontainer/cgroups/fs/memory.go", "Go", 304, 0, 0, 0, 0, 0, 45, 349
"/opt/projects/swiftkube/vendor/github.com/opencontainers/runc/libcontainer/cgroups/fs/name.go", "Go", 25, 0, 0, 0, 0, 0, 7, 32
"/opt/projects/swiftkube/vendor/github.com/opencontainers/runc/libcontainer/cgroups/fs/net_cls.go", "Go", 24, 0, 0, 0, 0, 0, 9, 33
"/opt/projects/swiftkube/vendor/github.com/opencontainers/runc/libcontainer/cgroups/fs/net_prio.go", "Go", 23, 0, 0, 0, 0, 0, 8, 31
"/opt/projects/swiftkube/vendor/github.com/opencontainers/runc/libcontainer/cgroups/fs/paths.go", "Go", 154, 0, 0, 0, 0, 0, 33, 187
"/opt/projects/swiftkube/vendor/github.com/opencontainers/runc/libcontainer/cgroups/fs/perf_event.go", "Go", 18, 0, 0, 0, 0, 0, 7, 25
"/opt/projects/swiftkube/vendor/github.com/opencontainers/runc/libcontainer/cgroups/fs/pids.go", "Go", 50, 0, 0, 0, 0, 0, 13, 63
"/opt/projects/swiftkube/vendor/github.com/opencontainers/runc/libcontainer/cgroups/fs/rdma.go", "Go", 19, 0, 0, 0, 0, 0, 7, 26
"/opt/projects/swiftkube/vendor/github.com/opencontainers/runc/libcontainer/cgroups/fs2/cpu.go", "Go", 73, 0, 0, 0, 0, 0, 15, 88
"/opt/projects/swiftkube/vendor/github.com/opencontainers/runc/libcontainer/cgroups/fs2/cpuset.go", "Go", 24, 0, 0, 0, 0, 0, 5, 29
"/opt/projects/swiftkube/vendor/github.com/opencontainers/runc/libcontainer/cgroups/fs2/create.go", "Go", 138, 0, 0, 0, 0, 0, 15, 153
"/opt/projects/swiftkube/vendor/github.com/opencontainers/runc/libcontainer/cgroups/fs2/defaultpath.go", "Go", 84, 0, 0, 0, 0, 0, 16, 100
"/opt/projects/swiftkube/vendor/github.com/opencontainers/runc/libcontainer/cgroups/fs2/devices.go", "Go", 68, 0, 0, 0, 0, 0, 8, 76
"/opt/projects/swiftkube/vendor/github.com/opencontainers/runc/libcontainer/cgroups/fs2/freezer.go", "Go", 115, 0, 0, 0, 0, 0, 13, 128
"/opt/projects/swiftkube/vendor/github.com/opencontainers/runc/libcontainer/cgroups/fs2/fs2.go", "Go", 231, 0, 0, 0, 0, 0, 29, 260
"/opt/projects/swiftkube/vendor/github.com/opencontainers/runc/libcontainer/cgroups/fs2/hugetlb.go", "Go", 39, 0, 0, 0, 0, 0, 10, 49
"/opt/projects/swiftkube/vendor/github.com/opencontainers/runc/libcontainer/cgroups/fs2/io.go", "Go", 178, 0, 0, 0, 0, 0, 16, 194
"/opt/projects/swiftkube/vendor/github.com/opencontainers/runc/libcontainer/cgroups/fs2/memory.go", "Go", 189, 0, 0, 0, 0, 0, 28, 217
"/opt/projects/swiftkube/vendor/github.com/opencontainers/runc/libcontainer/cgroups/fs2/pids.go", "Go", 62, 0, 0, 0, 0, 0, 11, 73
"/opt/projects/swiftkube/vendor/github.com/opencontainers/runc/libcontainer/cgroups/fscommon/rdma.go", "Go", 106, 0, 0, 0, 0, 0, 16, 122
"/opt/projects/swiftkube/vendor/github.com/opencontainers/runc/libcontainer/cgroups/fscommon/utils.go", "Go", 124, 0, 0, 0, 0, 0, 22, 146
"/opt/projects/swiftkube/vendor/github.com/opencontainers/runc/libcontainer/cgroups/getallpids.go", "Go", 25, 0, 0, 0, 0, 0, 3, 28
"/opt/projects/swiftkube/vendor/github.com/opencontainers/runc/libcontainer/cgroups/manager/new.go", "Go", 69, 0, 0, 0, 0, 0, 10, 79
"/opt/projects/swiftkube/vendor/github.com/opencontainers/runc/libcontainer/cgroups/stats.go", "Go", 155, 0, 0, 0, 0, 0, 19, 174
"/opt/projects/swiftkube/vendor/github.com/opencontainers/runc/libcontainer/cgroups/systemd/common.go", "Go", 506, 0, 0, 0, 0, 0, 55, 561
"/opt/projects/swiftkube/vendor/github.com/opencontainers/runc/libcontainer/cgroups/systemd/cpuset.go", "Go", 55, 0, 0, 0, 0, 0, 6, 61
"/opt/projects/swiftkube/vendor/github.com/opencontainers/runc/libcontainer/cgroups/systemd/dbus.go", "Go", 91, 0, 0, 0, 0, 0, 12, 103
"/opt/projects/swiftkube/vendor/github.com/opencontainers/runc/libcontainer/cgroups/systemd/user.go", "Go", 99, 0, 0, 0, 0, 0, 8, 107
"/opt/projects/swiftkube/vendor/github.com/opencontainers/runc/libcontainer/cgroups/systemd/v1.go", "Go", 405, 0, 0, 0, 0, 0, 67, 472
"/opt/projects/swiftkube/vendor/github.com/opencontainers/runc/libcontainer/cgroups/systemd/v2.go", "Go", 402, 0, 0, 0, 0, 0, 71, 473
"/opt/projects/swiftkube/vendor/github.com/opencontainers/runc/libcontainer/cgroups/utils.go", "Go", 424, 0, 0, 0, 0, 0, 46, 470
"/opt/projects/swiftkube/vendor/github.com/opencontainers/runc/libcontainer/cgroups/v1_utils.go", "Go", 238, 0, 0, 0, 0, 0, 53, 291
"/opt/projects/swiftkube/vendor/github.com/opencontainers/runc/libcontainer/configs/blkio_device.go", "Go", 56, 0, 0, 0, 0, 0, 11, 67
"/opt/projects/swiftkube/vendor/github.com/opencontainers/runc/libcontainer/configs/cgroup_linux.go", "Go", 115, 0, 0, 0, 0, 0, 44, 159
"/opt/projects/swiftkube/vendor/github.com/opencontainers/runc/libcontainer/configs/cgroup_unsupported.go", "Go", 7, 0, 0, 0, 0, 0, 3, 10
"/opt/projects/swiftkube/vendor/github.com/opencontainers/runc/libcontainer/configs/config.go", "Go", 341, 0, 0, 0, 0, 0, 74, 415
"/opt/projects/swiftkube/vendor/github.com/opencontainers/runc/libcontainer/configs/config_linux.go", "Go", 61, 0, 0, 0, 0, 0, 8, 69
"/opt/projects/swiftkube/vendor/github.com/opencontainers/runc/libcontainer/configs/configs_fuzzer.go", "Go", 8, 0, 0, 0, 0, 0, 3, 11
"/opt/projects/swiftkube/vendor/github.com/opencontainers/runc/libcontainer/configs/hugepage_limit.go", "Go", 7, 0, 0, 0, 0, 0, 3, 10
"/opt/projects/swiftkube/vendor/github.com/opencontainers/runc/libcontainer/configs/intelrdt.go", "Go", 13, 0, 0, 0, 0, 0, 4, 17
"/opt/projects/swiftkube/vendor/github.com/opencontainers/runc/libcontainer/configs/interface_priority_map.go", "Go", 11, 0, 0, 0, 0, 0, 4, 15
"/opt/projects/swiftkube/vendor/github.com/opencontainers/runc/libcontainer/configs/mount.go", "Go", 34, 0, 0, 0, 0, 0, 15, 49
"/opt/projects/swiftkube/vendor/github.com/opencontainers/runc/libcontainer/configs/namespaces.go", "Go", 3, 0, 0, 0, 0, 0, 3, 6
"/opt/projects/swiftkube/vendor/github.com/opencontainers/runc/libcontainer/configs/namespaces_linux.go", "Go", 113, 0, 0, 0, 0, 0, 14, 127
"/opt/projects/swiftkube/vendor/github.com/opencontainers/runc/libcontainer/configs/namespaces_syscall.go", "Go", 28, 0, 0, 0, 0, 0, 6, 34
"/opt/projects/swiftkube/vendor/github.com/opencontainers/runc/libcontainer/configs/namespaces_syscall_unsupported.go", "Go", 11, 0, 0, 0, 0, 0, 4, 15
"/opt/projects/swiftkube/vendor/github.com/opencontainers/runc/libcontainer/configs/namespaces_unsupported.go", "Go", 6, 0, 0, 0, 0, 0, 3, 9
"/opt/projects/swiftkube/vendor/github.com/opencontainers/runc/libcontainer/configs/network.go", "Go", 59, 0, 0, 0, 0, 0, 17, 76
"/opt/projects/swiftkube/vendor/github.com/opencontainers/runc/libcontainer/configs/rdma.go", "Go", 8, 0, 0, 0, 0, 0, 2, 10
"/opt/projects/swiftkube/vendor/github.com/opencontainers/runc/libcontainer/configs/validate/rootless.go", "Go", 81, 0, 0, 0, 0, 0, 13, 94
"/opt/projects/swiftkube/vendor/github.com/opencontainers/runc/libcontainer/configs/validate/validator.go", "Go", 263, 0, 0, 0, 0, 0, 36, 299
"/opt/projects/swiftkube/vendor/github.com/opencontainers/runc/libcontainer/console_linux.go", "Go", 37, 0, 0, 0, 0, 0, 5, 42
"/opt/projects/swiftkube/vendor/github.com/opencontainers/runc/libcontainer/container.go", "Go", 107, 0, 0, 0, 0, 0, 24, 131
"/opt/projects/swiftkube/vendor/github.com/opencontainers/runc/libcontainer/container_linux.go", "Go", 2050, 0, 0, 0, 0, 0, 222, 2272
"/opt/projects/swiftkube/vendor/github.com/opencontainers/runc/libcontainer/criu_opts_linux.go", "Go", 30, 0, 0, 0, 0, 0, 5, 35
"/opt/projects/swiftkube/vendor/github.com/opencontainers/runc/libcontainer/devices/device.go", "Go", 146, 0, 0, 0, 0, 0, 29, 175
"/opt/projects/swiftkube/vendor/github.com/opencontainers/runc/libcontainer/devices/device_unix.go", "Go", 109, 0, 0, 0, 0, 0, 12, 121
"/opt/projects/swiftkube/vendor/github.com/opencontainers/runc/libcontainer/eaccess_go119.go", "Go", 13, 0, 0, 0, 0, 0, 5, 18
"/opt/projects/swiftkube/vendor/github.com/opencontainers/runc/libcontainer/eaccess_stub.go", "Go", 8, 0, 0, 0, 0, 0, 3, 11
"/opt/projects/swiftkube/vendor/github.com/opencontainers/runc/libcontainer/error.go", "Go", 11, 0, 0, 0, 0, 0, 3, 14
"/opt/projects/swiftkube/vendor/github.com/opencontainers/runc/libcontainer/factory.go", "Go", 25, 0, 0, 0, 0, 0, 6, 31
"/opt/projects/swiftkube/vendor/github.com/opencontainers/runc/libcontainer/factory_linux.go", "Go", 379, 0, 0, 0, 0, 0, 45, 424
"/opt/projects/swiftkube/vendor/github.com/opencontainers/runc/libcontainer/init_linux.go", "Go", 534, 0, 0, 0, 0, 0, 60, 594
"/opt/projects/swiftkube/vendor/github.com/opencontainers/runc/libcontainer/intelrdt/cmt.go", "Go", 18, 0, 0, 0, 0, 0, 6, 24
"/opt/projects/swiftkube/vendor/github.com/opencontainers/runc/libcontainer/intelrdt/intelrdt.go", "Go", 673, 0, 0, 0, 0, 0, 89, 762
"/opt/projects/swiftkube/vendor/github.com/opencontainers/runc/libcontainer/intelrdt/mbm.go", "Go", 26, 0, 0, 0, 0, 0, 6, 32
"/opt/projects/swiftkube/vendor/github.com/opencontainers/runc/libcontainer/intelrdt/monitoring.go", "Go", 69, 0, 0, 0, 0, 0, 15, 84
"/opt/projects/swiftkube/vendor/github.com/opencontainers/runc/libcontainer/intelrdt/stats.go", "Go", 43, 0, 0, 0, 0, 0, 15, 58
"/opt/projects/swiftkube/vendor/github.com/opencontainers/runc/libcontainer/keys/keyctl.go", "Go", 36, 0, 0, 0, 0, 0, 10, 46
"/opt/projects/swiftkube/vendor/github.com/opencontainers/runc/libcontainer/logs/logs.go", "Go", 47, 0, 0, 0, 0, 0, 10, 57
"/opt/projects/swiftkube/vendor/github.com/opencontainers/runc/libcontainer/message_linux.go", "Go", 85, 0, 0, 0, 0, 0, 13, 98
"/opt/projects/swiftkube/vendor/github.com/opencontainers/runc/libcontainer/mount_linux.go", "Go", 73, 0, 0, 0, 0, 0, 11, 84
"/opt/projects/swiftkube/vendor/github.com/opencontainers/runc/libcontainer/network_linux.go", "Go", 87, 0, 0, 0, 0, 0, 14, 101
"/opt/projects/swiftkube/vendor/github.com/opencontainers/runc/libcontainer/notify_linux.go", "Go", 72, 0, 0, 0, 0, 0, 13, 85
"/opt/projects/swiftkube/vendor/github.com/opencontainers/runc/libcontainer/notify_v2_linux.go", "Go", 75, 0, 0, 0, 0, 0, 6, 81
"/opt/projects/swiftkube/vendor/github.com/opencontainers/runc/libcontainer/process.go", "Go", 98, 0, 0, 0, 0, 0, 29, 127
"/opt/projects/swiftkube/vendor/github.com/opencontainers/runc/libcontainer/process_linux.go", "Go", 733, 0, 0, 0, 0, 0, 89, 822
"/opt/projects/swiftkube/vendor/github.com/opencontainers/runc/libcontainer/restored_process.go", "Go", 105, 0, 0, 0, 0, 0, 24, 129
"/opt/projects/swiftkube/vendor/github.com/opencontainers/runc/libcontainer/rootfs_linux.go", "Go", 1065, 0, 0, 0, 0, 0, 102, 1167
"/opt/projects/swiftkube/vendor/github.com/opencontainers/runc/libcontainer/seccomp/config.go", "Go", 101, 0, 0, 0, 0, 0, 12, 113
"/opt/projects/swiftkube/vendor/github.com/opencontainers/runc/libcontainer/seccomp/patchbpf/enosys_linux.go", "Go", 638, 0, 0, 0, 0, 0, 69, 707
"/opt/projects/swiftkube/vendor/github.com/opencontainers/runc/libcontainer/seccomp/patchbpf/enosys_unsupported.go", "Go", 3, 0, 0, 0, 0, 0, 2, 5
"/opt/projects/swiftkube/vendor/github.com/opencontainers/runc/libcontainer/seccomp/seccomp_linux.go", "Go", 230, 0, 0, 0, 0, 0, 39, 269
"/opt/projects/swiftkube/vendor/github.com/opencontainers/runc/libcontainer/seccomp/seccomp_unsupported.go", "Go", 21, 0, 0, 0, 0, 0, 8, 29
"/opt/projects/swiftkube/vendor/github.com/opencontainers/runc/libcontainer/setns_init_linux.go", "Go", 96, 0, 0, 0, 0, 0, 10, 106
"/opt/projects/swiftkube/vendor/github.com/opencontainers/runc/libcontainer/standard_init_linux.go", "Go", 236, 0, 0, 0, 0, 0, 27, 263
"/opt/projects/swiftkube/vendor/github.com/opencontainers/runc/libcontainer/state_linux.go", "Go", 208, 0, 0, 0, 0, 0, 36, 244
"/opt/projects/swiftkube/vendor/github.com/opencontainers/runc/libcontainer/stats_linux.go", "Go", 11, 0, 0, 0, 0, 0, 3, 14
"/opt/projects/swiftkube/vendor/github.com/opencontainers/runc/libcontainer/sync.go", "Go", 109, 0, 0, 0, 0, 0, 18, 127
"/opt/projects/swiftkube/vendor/github.com/opencontainers/runc/libcontainer/system/linux.go", "Go", 84, 0, 0, 0, 0, 0, 21, 105
"/opt/projects/swiftkube/vendor/github.com/opencontainers/runc/libcontainer/system/proc.go", "Go", 110, 0, 0, 0, 0, 0, 18, 128
"/opt/projects/swiftkube/vendor/github.com/opencontainers/runc/libcontainer/system/syscall_linux_32.go", "Go", 23, 0, 0, 0, 0, 0, 5, 28
"/opt/projects/swiftkube/vendor/github.com/opencontainers/runc/libcontainer/system/syscall_linux_64.go", "Go", 23, 0, 0, 0, 0, 0, 5, 28
"/opt/projects/swiftkube/vendor/github.com/opencontainers/runc/libcontainer/user/lookup_unix.go", "Go", 130, 0, 0, 0, 0, 0, 28, 158
"/opt/projects/swiftkube/vendor/github.com/opencontainers/runc/libcontainer/user/user.go", "Go", 523, 0, 0, 0, 0, 0, 83, 606
"/opt/projects/swiftkube/vendor/github.com/opencontainers/runc/libcontainer/user/user_fuzzer.go", "Go", 31, 0, 0, 0, 0, 0, 13, 44
"/opt/projects/swiftkube/vendor/github.com/opencontainers/runc/libcontainer/userns/userns.go", "Go", 4, 0, 0, 0, 0, 0, 2, 6
"/opt/projects/swiftkube/vendor/github.com/opencontainers/runc/libcontainer/userns/userns_fuzzer.go", "Go", 12, 0, 0, 0, 0, 0, 5, 17
"/opt/projects/swiftkube/vendor/github.com/opencontainers/runc/libcontainer/userns/userns_linux.go", "Go", 32, 0, 0, 0, 0, 0, 6, 38
"/opt/projects/swiftkube/vendor/github.com/opencontainers/runc/libcontainer/userns/userns_unsupported.go", "Go", 14, 0, 0, 0, 0, 0, 5, 19
"/opt/projects/swiftkube/vendor/github.com/opencontainers/runc/libcontainer/utils/cmsg.go", "Go", 82, 0, 0, 0, 0, 0, 15, 97
"/opt/projects/swiftkube/vendor/github.com/opencontainers/runc/libcontainer/utils/utils.go", "Go", 149, 0, 0, 0, 0, 0, 19, 168
"/opt/projects/swiftkube/vendor/github.com/opencontainers/runc/libcontainer/utils/utils_unix.go", "Go", 61, 0, 0, 0, 0, 0, 9, 70
"/opt/projects/swiftkube/vendor/github.com/opencontainers/runc/types/events.go", "Go", 130, 0, 0, 0, 0, 0, 26, 156
"/opt/projects/swiftkube/vendor/github.com/opencontainers/runtime-spec/specs-go/config.go", "Go", 704, 0, 0, 0, 0, 0, 72, 776
"/opt/projects/swiftkube/vendor/github.com/opencontainers/runtime-spec/specs-go/state.go", "Go", 48, 0, 0, 0, 0, 0, 9, 57
"/opt/projects/swiftkube/vendor/github.com/opencontainers/runtime-spec/specs-go/version.go", "Go", 14, 0, 0, 0, 0, 0, 5, 19
"/opt/projects/swiftkube/vendor/github.com/opencontainers/selinux/go-selinux/doc.go", "Go", 10, 0, 0, 0, 0, 0, 5, 15
"/opt/projects/swiftkube/vendor/github.com/opencontainers/selinux/go-selinux/label/label.go", "Go", 80, 0, 0, 0, 0, 0, 18, 98
"/opt/projects/swiftkube/vendor/github.com/opencontainers/selinux/go-selinux/label/label_linux.go", "Go", 177, 0, 0, 0, 0, 0, 20, 197
"/opt/projects/swiftkube/vendor/github.com/opencontainers/selinux/go-selinux/label/label_stub.go", "Go", 39, 0, 0, 0, 0, 0, 11, 50
"/opt/projects/swiftkube/vendor/github.com/opencontainers/selinux/go-selinux/rchcon.go", "Go", 18, 0, 0, 0, 0, 0, 5, 23
"/opt/projects/swiftkube/vendor/github.com/opencontainers/selinux/go-selinux/rchcon_go115.go", "Go", 17, 0, 0, 0, 0, 0, 5, 22
"/opt/projects/swiftkube/vendor/github.com/opencontainers/selinux/go-selinux/selinux.go", "Go", 254, 0, 0, 0, 0, 0, 51, 305
"/opt/projects/swiftkube/vendor/github.com/opencontainers/selinux/go-selinux/selinux_linux.go", "Go", 1084, 0, 0, 0, 0, 0, 179, 1263
"/opt/projects/swiftkube/vendor/github.com/opencontainers/selinux/go-selinux/selinux_stub.go", "Go", 122, 0, 0, 0, 0, 0, 43, 165
"/opt/projects/swiftkube/vendor/github.com/opencontainers/selinux/go-selinux/xattrs_linux.go", "Go", 62, 0, 0, 0, 0, 0, 10, 72
"/opt/projects/swiftkube/vendor/github.com/opencontainers/selinux/pkg/pwalk/pwalk.go", "Go", 103, 0, 0, 0, 0, 0, 13, 116
"/opt/projects/swiftkube/vendor/github.com/opencontainers/selinux/pkg/pwalkdir/pwalkdir.go", "Go", 104, 0, 0, 0, 0, 0, 13, 117
"/opt/projects/swiftkube/vendor/github.com/peterbourgon/diskv/compression.go", "Go", 54, 0, 0, 0, 0, 0, 11, 65
"/opt/projects/swiftkube/vendor/github.com/peterbourgon/diskv/diskv.go", "Go", 531, 0, 0, 0, 0, 0, 94, 625
"/opt/projects/swiftkube/vendor/github.com/peterbourgon/diskv/index.go", "Go", 97, 0, 0, 0, 0, 0, 19, 116
"/opt/projects/swiftkube/vendor/github.com/pkg/errors/errors.go", "Go", 267, 0, 0, 0, 0, 0, 22, 289
"/opt/projects/swiftkube/vendor/github.com/pkg/errors/go113.go", "Go", 33, 0, 0, 0, 0, 0, 6, 39
"/opt/projects/swiftkube/vendor/github.com/pkg/errors/stack.go", "Go", 161, 0, 0, 0, 0, 0, 17, 178
"/opt/projects/swiftkube/vendor/github.com/prometheus/client_golang/prometheus/build_info_collector.go", "Go", 35, 0, 0, 0, 0, 0, 4, 39
"/opt/projects/swiftkube/vendor/github.com/prometheus/client_golang/prometheus/collector.go", "Go", 120, 0, 0, 0, 0, 0, 9, 129
"/opt/projects/swiftkube/vendor/github.com/prometheus/client_golang/prometheus/collectors/collectors.go", "Go", 37, 0, 0, 0, 0, 0, 4, 41
"/opt/projects/swiftkube/vendor/github.com/prometheus/client_golang/prometheus/collectors/dbstats_collector.go", "Go", 109, 0, 0, 0, 0, 0, 11, 120
"/opt/projects/swiftkube/vendor/github.com/prometheus/client_golang/prometheus/collectors/expvar_collector.go", "Go", 54, 0, 0, 0, 0, 0, 4, 58
"/opt/projects/swiftkube/vendor/github.com/prometheus/client_golang/prometheus/collectors/go_collector_go116.go", "Go", 45, 0, 0, 0, 0, 0, 5, 50
"/opt/projects/swiftkube/vendor/github.com/prometheus/client_golang/prometheus/collectors/go_collector_latest.go", "Go", 146, 0, 0, 0, 0, 0, 17, 163
"/opt/projects/swiftkube/vendor/github.com/prometheus/client_golang/prometheus/collectors/process_collector.go", "Go", 52, 0, 0, 0, 0, 0, 5, 57
"/opt/projects/swiftkube/vendor/github.com/prometheus/client_golang/prometheus/counter.go", "Go", 313, 0, 0, 0, 0, 0, 36, 349
"/opt/projects/swiftkube/vendor/github.com/prometheus/client_golang/prometheus/desc.go", "Go", 188, 0, 0, 0, 0, 0, 12, 200
"/opt/projects/swiftkube/vendor/github.com/prometheus/client_golang/prometheus/doc.go", "Go", 209, 0, 0, 0, 0, 0, 2, 211
"/opt/projects/swiftkube/vendor/github.com/prometheus/client_golang/prometheus/expvar_collector.go", "Go", 80, 0, 0, 0, 0, 0, 7, 87
"/opt/projects/swiftkube/vendor/github.com/prometheus/client_golang/prometheus/fnv.go", "Go", 36, 0, 0, 0, 0, 0, 7, 43
"/opt/projects/swiftkube/vendor/github.com/prometheus/client_golang/prometheus/gauge.go", "Go", 279, 0, 0, 0, 0, 0, 33, 312
"/opt/projects/swiftkube/vendor/github.com/prometheus/client_golang/prometheus/get_pid.go", "Go", 22, 0, 0, 0, 0, 0, 5, 27
"/opt/projects/swiftkube/vendor/github.com/prometheus/client_golang/prometheus/get_pid_gopherjs.go", "Go", 20, 0, 0, 0, 0, 0, 4, 24
"/opt/projects/swiftkube/vendor/github.com/prometheus/client_golang/prometheus/go_collector.go", "Go", 269, 0, 0, 0, 0, 0, 13, 282
"/opt/projects/swiftkube/vendor/github.com/prometheus/client_golang/prometheus/go_collector_go116.go", "Go", 111, 0, 0, 0, 0, 0, 12, 123
"/opt/projects/swiftkube/vendor/github.com/prometheus/client_golang/prometheus/go_collector_latest.go", "Go", 510, 0, 0, 0, 0, 0, 58, 568
"/opt/projects/swiftkube/vendor/github.com/prometheus/client_golang/prometheus/histogram.go", "Go", 1394, 0, 0, 0, 0, 0, 106, 1500
"/opt/projects/swiftkube/vendor/github.com/prometheus/client_golang/prometheus/internal/almost_equal.go", "Go", 56, 0, 0, 0, 0, 0, 5, 61
"/opt/projects/swiftkube/vendor/github.com/prometheus/client_golang/prometheus/internal/difflib.go", "Go", 616, 0, 0, 0, 0, 0, 39, 655
"/opt/projects/swiftkube/vendor/github.com/prometheus/client_golang/prometheus/internal/go_collector_options.go", "Go", 28, 0, 0, 0, 0, 0, 5, 33
"/opt/projects/swiftkube/vendor/github.com/prometheus/client_golang/prometheus/internal/go_runtime_metrics.go", "Go", 129, 0, 0, 0, 0, 0, 14, 143
"/opt/projects/swiftkube/vendor/github.com/prometheus/client_golang/prometheus/internal/metric.go", "Go", 88, 0, 0, 0, 0, 0, 14, 102
"/opt/projects/swiftkube/vendor/github.com/prometheus/client_golang/prometheus/labels.go", "Go", 137, 0, 0, 0, 0, 0, 24, 161
"/opt/projects/swiftkube/vendor/github.com/prometheus/client_golang/prometheus/metric.go", "Go", 228, 0, 0, 0, 0, 0, 27, 255
"/opt/projects/swiftkube/vendor/github.com/prometheus/client_golang/prometheus/num_threads.go", "Go", 21, 0, 0, 0, 0, 0, 5, 26
"/opt/projects/swiftkube/vendor/github.com/prometheus/client_golang/prometheus/num_threads_gopherjs.go", "Go", 19, 0, 0, 0, 0, 0, 4, 23
"/opt/projects/swiftkube/vendor/github.com/prometheus/client_golang/prometheus/observer.go", "Go", 57, 0, 0, 0, 0, 0, 8, 65
"/opt/projects/swiftkube/vendor/github.com/prometheus/client_golang/prometheus/process_collector.go", "Go", 150, 0, 0, 0, 0, 0, 15, 165
"/opt/projects/swiftkube/vendor/github.com/prometheus/client_golang/prometheus/process_collector_js.go", "Go", 22, 0, 0, 0, 0, 0, 5, 27
"/opt/projects/swiftkube/vendor/github.com/prometheus/client_golang/prometheus/process_collector_other.go", "Go", 57, 0, 0, 0, 0, 0, 10, 67
"/opt/projects/swiftkube/vendor/github.com/prometheus/client_golang/prometheus/process_collector_windows.go", "Go", 101, 0, 0, 0, 0, 0, 16, 117
"/opt/projects/swiftkube/vendor/github.com/prometheus/client_golang/prometheus/promhttp/delegator.go", "Go", 352, 0, 0, 0, 0, 0, 23, 375
"/opt/projects/swiftkube/vendor/github.com/prometheus/client_golang/prometheus/promhttp/http.go", "Go", 380, 0, 0, 0, 0, 0, 29, 409
"/opt/projects/swiftkube/vendor/github.com/prometheus/client_golang/prometheus/promhttp/instrument_client.go", "Go", 233, 0, 0, 0, 0, 0, 17, 250
"/opt/projects/swiftkube/vendor/github.com/prometheus/client_golang/prometheus/promhttp/instrument_server.go", "Go", 523, 0, 0, 0, 0, 0, 57, 580
"/opt/projects/swiftkube/vendor/github.com/prometheus/client_golang/prometheus/promhttp/option.go", "Go", 69, 0, 0, 0, 0, 0, 16, 85
"/opt/projects/swiftkube/vendor/github.com/prometheus/client_golang/prometheus/registry.go", "Go", 1002, 0, 0, 0, 0, 0, 74, 1076
"/opt/projects/swiftkube/vendor/github.com/prometheus/client_golang/prometheus/summary.go", "Go", 670, 0, 0, 0, 0, 0, 97, 767
"/opt/projects/swiftkube/vendor/github.com/prometheus/client_golang/prometheus/testutil/lint.go", "Go", 41, 0, 0, 0, 0, 0, 6, 47
"/opt/projects/swiftkube/vendor/github.com/prometheus/client_golang/prometheus/testutil/promlint/promlint.go", "Go", 329, 0, 0, 0, 0, 0, 57, 386
"/opt/projects/swiftkube/vendor/github.com/prometheus/client_golang/prometheus/testutil/testutil.go", "Go", 306, 0, 0, 0, 0, 0, 38, 344
"/opt/projects/swiftkube/vendor/github.com/prometheus/client_golang/prometheus/timer.go", "Go", 75, 0, 0, 0, 0, 0, 7, 82
"/opt/projects/swiftkube/vendor/github.com/prometheus/client_golang/prometheus/untyped.go", "Go", 38, 0, 0, 0, 0, 0, 5, 43
"/opt/projects/swiftkube/vendor/github.com/prometheus/client_golang/prometheus/value.go", "Go", 211, 0, 0, 0, 0, 0, 25, 236
"/opt/projects/swiftkube/vendor/github.com/prometheus/client_golang/prometheus/vec.go", "Go", 630, 0, 0, 0, 0, 0, 74, 704
"/opt/projects/swiftkube/vendor/github.com/prometheus/client_golang/prometheus/vnext.go", "Go", 20, 0, 0, 0, 0, 0, 4, 24
"/opt/projects/swiftkube/vendor/github.com/prometheus/client_golang/prometheus/wrap.go", "Go", 196, 0, 0, 0, 0, 0, 19, 215
"/opt/projects/swiftkube/vendor/github.com/prometheus/client_model/go/metrics.pb.go", "Go", 1183, 0, 0, 0, 0, 0, 150, 1333
"/opt/projects/swiftkube/vendor/github.com/prometheus/common/expfmt/decode.go", "Go", 361, 0, 0, 0, 0, 0, 68, 429
"/opt/projects/swiftkube/vendor/github.com/prometheus/common/expfmt/encode.go", "Go", 153, 0, 0, 0, 0, 0, 13, 166
"/opt/projects/swiftkube/vendor/github.com/prometheus/common/expfmt/expfmt.go", "Go", 38, 0, 0, 0, 0, 0, 6, 44
"/opt/projects/swiftkube/vendor/github.com/prometheus/common/expfmt/fuzz.go", "Go", 31, 0, 0, 0, 0, 0, 7, 38
"/opt/projects/swiftkube/vendor/github.com/prometheus/common/expfmt/openmetrics_create.go", "Go", 512, 0, 0, 0, 0, 0, 16, 528
"/opt/projects/swiftkube/vendor/github.com/prometheus/common/expfmt/text_create.go", "Go", 446, 0, 0, 0, 0, 0, 19, 465
"/opt/projects/swiftkube/vendor/github.com/prometheus/common/expfmt/text_parse.go", "Go", 737, 0, 0, 0, 0, 0, 43, 780
"/opt/projects/swiftkube/vendor/github.com/prometheus/common/internal/bitbucket.org/ww/goautoneg/autoneg.go", "Go", 136, 0, 0, 0, 0, 0, 25, 161
"/opt/projects/swiftkube/vendor/github.com/prometheus/common/model/alert.go", "Go", 117, 0, 0, 0, 0, 0, 20, 137
"/opt/projects/swiftkube/vendor/github.com/prometheus/common/model/fingerprinting.go", "Go", 85, 0, 0, 0, 0, 0, 21, 106
"/opt/projects/swiftkube/vendor/github.com/prometheus/common/model/fnv.go", "Go", 36, 0, 0, 0, 0, 0, 7, 43
"/opt/projects/swiftkube/vendor/github.com/prometheus/common/model/labels.go", "Go", 179, 0, 0, 0, 0, 0, 40, 219
"/opt/projects/swiftkube/vendor/github.com/prometheus/common/model/labelset.go", "Go", 152, 0, 0, 0, 0, 0, 18, 170
"/opt/projects/swiftkube/vendor/github.com/prometheus/common/model/metric.go", "Go", 90, 0, 0, 0, 0, 0, 13, 103
"/opt/projects/swiftkube/vendor/github.com/prometheus/common/model/model.go", "Go", 15, 0, 0, 0, 0, 0, 2, 17
"/opt/projects/swiftkube/vendor/github.com/prometheus/common/model/signature.go", "Go", 126, 0, 0, 0, 0, 0, 19, 145
"/opt/projects/swiftkube/vendor/github.com/prometheus/common/model/silence.go", "Go", 95, 0, 0, 0, 0, 0, 12, 107
"/opt/projects/swiftkube/vendor/github.com/prometheus/common/model/time.go", "Go", 294, 0, 0, 0, 0, 0, 47, 341
"/opt/projects/swiftkube/vendor/github.com/prometheus/common/model/value.go", "Go", 319, 0, 0, 0, 0, 0, 48, 367
"/opt/projects/swiftkube/vendor/github.com/prometheus/common/model/value_float.go", "Go", 87, 0, 0, 0, 0, 0, 14, 101
"/opt/projects/swiftkube/vendor/github.com/prometheus/common/model/value_histogram.go", "Go", 156, 0, 0, 0, 0, 0, 23, 179
"/opt/projects/swiftkube/vendor/github.com/prometheus/common/model/value_type.go", "Go", 74, 0, 0, 0, 0, 0, 10, 84
"/opt/projects/swiftkube/vendor/github.com/prometheus/procfs/arp.go", "Go", 101, 0, 0, 0, 0, 0, 16, 117
"/opt/projects/swiftkube/vendor/github.com/prometheus/procfs/buddyinfo.go", "Go", 72, 0, 0, 0, 0, 0, 14, 86
"/opt/projects/swiftkube/vendor/github.com/prometheus/procfs/cmdline.go", "Go", 25, 0, 0, 0, 0, 0, 6, 31
"/opt/projects/swiftkube/vendor/github.com/prometheus/procfs/cpuinfo.go", "Go", 486, 0, 0, 0, 0, 0, 33, 519
"/opt/projects/swiftkube/vendor/github.com/prometheus/procfs/cpuinfo_armx.go", "Go", 17, 0, 0, 0, 0, 0, 4, 21
"/opt/projects/swiftkube/vendor/github.com/prometheus/procfs/cpuinfo_loong64.go", "Go", 16, 0, 0, 0, 0, 0, 4, 20
"/opt/projects/swiftkube/vendor/github.com/prometheus/procfs/cpuinfo_mipsx.go", "Go", 17, 0, 0, 0, 0, 0, 4, 21
"/opt/projects/swiftkube/vendor/github.com/prometheus/procfs/cpuinfo_others.go", "Go", 16, 0, 0, 0, 0, 0, 4, 20
"/opt/projects/swiftkube/vendor/github.com/prometheus/procfs/cpuinfo_ppcx.go", "Go", 17, 0, 0, 0, 0, 0, 4, 21
"/opt/projects/swiftkube/vendor/github.com/prometheus/procfs/cpuinfo_riscvx.go", "Go", 17, 0, 0, 0, 0, 0, 4, 21
"/opt/projects/swiftkube/vendor/github.com/prometheus/procfs/cpuinfo_s390x.go", "Go", 16, 0, 0, 0, 0, 0, 4, 20
"/opt/projects/swiftkube/vendor/github.com/prometheus/procfs/cpuinfo_x86.go", "Go", 17, 0, 0, 0, 0, 0, 4, 21
"/opt/projects/swiftkube/vendor/github.com/prometheus/procfs/crypto.go", "Go", 136, 0, 0, 0, 0, 0, 18, 154
"/opt/projects/swiftkube/vendor/github.com/prometheus/procfs/doc.go", "Go", 43, 0, 0, 0, 0, 0, 2, 45
"/opt/projects/swiftkube/vendor/github.com/prometheus/procfs/fs.go", "Go", 42, 0, 0, 0, 0, 0, 9, 51
"/opt/projects/swiftkube/vendor/github.com/prometheus/procfs/fs_statfs_notype.go", "Go", 20, 0, 0, 0, 0, 0, 4, 24
"/opt/projects/swiftkube/vendor/github.com/prometheus/procfs/fs_statfs_type.go", "Go", 28, 0, 0, 0, 0, 0, 6, 34
"/opt/projects/swiftkube/vendor/github.com/prometheus/procfs/fscache.go", "Go", 410, 0, 0, 0, 0, 0, 13, 423
"/opt/projects/swiftkube/vendor/github.com/prometheus/procfs/internal/fs/fs.go", "Go", 46, 0, 0, 0, 0, 0, 10, 56
"/opt/projects/swiftkube/vendor/github.com/prometheus/procfs/internal/util/parse.go", "Go", 95, 0, 0, 0, 0, 0, 18, 113
"/opt/projects/swiftkube/vendor/github.com/prometheus/procfs/internal/util/readfile.go", "Go", 32, 0, 0, 0, 0, 0, 6, 38
"/opt/projects/swiftkube/vendor/github.com/prometheus/procfs/internal/util/sysreadfile.go", "Go", 44, 0, 0, 0, 0, 0, 7, 51
"/opt/projects/swiftkube/vendor/github.com/prometheus/procfs/internal/util/sysreadfile_compat.go", "Go", 23, 0, 0, 0, 0, 0, 5, 28
"/opt/projects/swiftkube/vendor/github.com/prometheus/procfs/internal/util/valueparser.go", "Go", 76, 0, 0, 0, 0, 0, 16, 92
"/opt/projects/swiftkube/vendor/github.com/prometheus/procfs/ipvs.go", "Go", 219, 0, 0, 0, 0, 0, 22, 241
"/opt/projects/swiftkube/vendor/github.com/prometheus/procfs/kernel_random.go", "Go", 55, 0, 0, 0, 0, 0, 9, 64
"/opt/projects/swiftkube/vendor/github.com/prometheus/procfs/loadavg.go", "Go", 54, 0, 0, 0, 0, 0, 9, 63
"/opt/projects/swiftkube/vendor/github.com/prometheus/procfs/mdstat.go", "Go", 233, 0, 0, 0, 0, 0, 34, 267
"/opt/projects/swiftkube/vendor/github.com/prometheus/procfs/meminfo.go", "Go", 266, 0, 0, 0, 0, 0, 12, 278
"/opt/projects/swiftkube/vendor/github.com/prometheus/procfs/mountinfo.go", "Go", 164, 0, 0, 0, 0, 0, 17, 181
"/opt/projects/swiftkube/vendor/github.com/prometheus/procfs/mountstats.go", "Go", 573, 0, 0, 0, 0, 0, 71, 644
"/opt/projects/swiftkube/vendor/github.com/prometheus/procfs/net_conntrackstat.go", "Go", 102, 0, 0, 0, 0, 0, 16, 118
"/opt/projects/swiftkube/vendor/github.com/prometheus/procfs/net_dev.go", "Go", 185, 0, 0, 0, 0, 0, 21, 206
"/opt/projects/swiftkube/vendor/github.com/prometheus/procfs/net_ip_socket.go", "Go", 203, 0, 0, 0, 0, 0, 24, 227
"/opt/projects/swiftkube/vendor/github.com/prometheus/procfs/net_protocols.go", "Go", 163, 0, 0, 0, 0, 0, 18, 181
"/opt/projects/swiftkube/vendor/github.com/prometheus/procfs/net_sockstat.go", "Go", 142, 0, 0, 0, 0, 0, 22, 164
"/opt/projects/swiftkube/vendor/github.com/prometheus/procfs/net_softnet.go", "Go", 130, 0, 0, 0, 0, 0, 26, 156
"/opt/projects/swiftkube/vendor/github.com/prometheus/procfs/net_tcp.go", "Go", 55, 0, 0, 0, 0, 0, 10, 65
"/opt/projects/swiftkube/vendor/github.com/prometheus/procfs/net_udp.go", "Go", 55, 0, 0, 0, 0, 0, 10, 65
"/opt/projects/swiftkube/vendor/github.com/prometheus/procfs/net_unix.go", "Go", 212, 0, 0, 0, 0, 0, 46, 258
"/opt/projects/swiftkube/vendor/github.com/prometheus/procfs/net_wireless.go", "Go", 145, 0, 0, 0, 0, 0, 38, 183
"/opt/projects/swiftkube/vendor/github.com/prometheus/procfs/net_xfrm.go", "Go", 176, 0, 0, 0, 0, 0, 14, 190
"/opt/projects/swiftkube/vendor/github.com/prometheus/procfs/netstat.go", "Go", 70, 0, 0, 0, 0, 0, 13, 83
"/opt/projects/swiftkube/vendor/github.com/prometheus/procfs/proc.go", "Go", 276, 0, 0, 0, 0, 0, 56, 332
"/opt/projects/swiftkube/vendor/github.com/prometheus/procfs/proc_cgroup.go", "Go", 88, 0, 0, 0, 0, 0, 11, 99
"/opt/projects/swiftkube/vendor/github.com/prometheus/procfs/proc_cgroups.go", "Go", 88, 0, 0, 0, 0, 0, 11, 99
"/opt/projects/swiftkube/vendor/github.com/prometheus/procfs/proc_environ.go", "Go", 30, 0, 0, 0, 0, 0, 8, 38
"/opt/projects/swiftkube/vendor/github.com/prometheus/procfs/proc_fdinfo.go", "Go", 116, 0, 0, 0, 0, 0, 17, 133
"/opt/projects/swiftkube/vendor/github.com/prometheus/procfs/proc_interrupts.go", "Go", 85, 0, 0, 0, 0, 0, 14, 99
"/opt/projects/swiftkube/vendor/github.com/prometheus/procfs/proc_io.go", "Go", 50, 0, 0, 0, 0, 0, 10, 60
"/opt/projects/swiftkube/vendor/github.com/prometheus/procfs/proc_limits.go", "Go", 147, 0, 0, 0, 0, 0, 14, 161
"/opt/projects/swiftkube/vendor/github.com/prometheus/procfs/proc_maps.go", "Go", 178, 0, 0, 0, 0, 0, 34, 212
"/opt/projects/swiftkube/vendor/github.com/prometheus/procfs/proc_netstat.go", "Go", 433, 0, 0, 0, 0, 0, 11, 444
"/opt/projects/swiftkube/vendor/github.com/prometheus/procfs/proc_ns.go", "Go", 57, 0, 0, 0, 0, 0, 12, 69
"/opt/projects/swiftkube/vendor/github.com/prometheus/procfs/proc_psi.go", "Go", 90, 0, 0, 0, 0, 0, 13, 103
"/opt/projects/swiftkube/vendor/github.com/prometheus/procfs/proc_smaps.go", "Go", 142, 0, 0, 0, 0, 0, 25, 167
"/opt/projects/swiftkube/vendor/github.com/prometheus/procfs/proc_snmp.go", "Go", 339, 0, 0, 0, 0, 0, 15, 354
"/opt/projects/swiftkube/vendor/github.com/prometheus/procfs/proc_snmp6.go", "Go", 366, 0, 0, 0, 0, 0, 16, 382
"/opt/projects/swiftkube/vendor/github.com/prometheus/procfs/proc_stat.go", "Go", 204, 0, 0, 0, 0, 0, 19, 223
"/opt/projects/swiftkube/vendor/github.com/prometheus/procfs/proc_status.go", "Go", 176, 0, 0, 0, 0, 0, 27, 203
"/opt/projects/swiftkube/vendor/github.com/prometheus/procfs/proc_sys.go", "Go", 43, 0, 0, 0, 0, 0, 9, 52
"/opt/projects/swiftkube/vendor/github.com/prometheus/procfs/schedstat.go", "Go", 101, 0, 0, 0, 0, 0, 21, 122
"/opt/projects/swiftkube/vendor/github.com/prometheus/procfs/slab.go", "Go", 140, 0, 0, 0, 0, 0, 12, 152
"/opt/projects/swiftkube/vendor/github.com/prometheus/procfs/softirqs.go", "Go", 147, 0, 0, 0, 0, 0, 14, 161
"/opt/projects/swiftkube/vendor/github.com/prometheus/procfs/stat.go", "Go", 230, 0, 0, 0, 0, 0, 25, 255
"/opt/projects/swiftkube/vendor/github.com/prometheus/procfs/swaps.go", "Go", 77, 0, 0, 0, 0, 0, 13, 90
"/opt/projects/swiftkube/vendor/github.com/prometheus/procfs/thread.go", "Go", 68, 0, 0, 0, 0, 0, 13, 81
"/opt/projects/swiftkube/vendor/github.com/prometheus/procfs/vm.go", "Go", 201, 0, 0, 0, 0, 0, 12, 213
"/opt/projects/swiftkube/vendor/github.com/prometheus/procfs/zoneinfo.go", "Go", 183, 0, 0, 0, 0, 0, 14, 197
"/opt/projects/swiftkube/vendor/github.com/rubiojr/go-vhd/vhd/util.go", "Go", 45, 0, 0, 0, 0, 0, 10, 55
"/opt/projects/swiftkube/vendor/github.com/rubiojr/go-vhd/vhd/vhd.go", "Go", 407, 0, 0, 0, 0, 0, 83, 490
"/opt/projects/swiftkube/vendor/github.com/russross/blackfriday/v2/block.go", "Go", 1415, 0, 0, 0, 0, 0, 198, 1613
"/opt/projects/swiftkube/vendor/github.com/russross/blackfriday/v2/doc.go", "Go", 45, 0, 0, 0, 0, 0, 2, 47
"/opt/projects/swiftkube/vendor/github.com/russross/blackfriday/v2/entities.go", "Go", 2235, 0, 0, 0, 0, 0, 2, 2237
"/opt/projects/swiftkube/vendor/github.com/russross/blackfriday/v2/esc.go", "Go", 61, 0, 0, 0, 0, 0, 10, 71
"/opt/projects/swiftkube/vendor/github.com/russross/blackfriday/v2/html.go", "Go", 879, 0, 0, 0, 0, 0, 74, 953
"/opt/projects/swiftkube/vendor/github.com/russross/blackfriday/v2/inline.go", "Go", 1049, 0, 0, 0, 0, 0, 180, 1229
"/opt/projects/swiftkube/vendor/github.com/russross/blackfriday/v2/markdown.go", "Go", 853, 0, 0, 0, 0, 0, 98, 951
"/opt/projects/swiftkube/vendor/github.com/russross/blackfriday/v2/node.go", "Go", 328, 0, 0, 0, 0, 0, 33, 361
"/opt/projects/swiftkube/vendor/github.com/russross/blackfriday/v2/smartypants.go", "Go", 398, 0, 0, 0, 0, 0, 60, 458
"/opt/projects/swiftkube/vendor/github.com/seccomp/libseccomp-golang/seccomp.go", "Go", 1023, 0, 0, 0, 0, 0, 166, 1189
"/opt/projects/swiftkube/vendor/github.com/seccomp/libseccomp-golang/seccomp_internal.go", "Go", 751, 0, 0, 0, 0, 0, 134, 885
"/opt/projects/swiftkube/vendor/github.com/sirupsen/logrus/alt_exit.go", "Go", 67, 0, 0, 0, 0, 0, 10, 77
"/opt/projects/swiftkube/vendor/github.com/sirupsen/logrus/buffer_pool.go", "Go", 35, 0, 0, 0, 0, 0, 9, 44
"/opt/projects/swiftkube/vendor/github.com/sirupsen/logrus/doc.go", "Go", 19, 0, 0, 0, 0, 0, 8, 27
"/opt/projects/swiftkube/vendor/github.com/sirupsen/logrus/entry.go", "Go", 359, 0, 0, 0, 0, 0, 84, 443
"/opt/projects/swiftkube/vendor/github.com/sirupsen/logrus/exported.go", "Go", 219, 0, 0, 0, 0, 0, 52, 271
"/opt/projects/swiftkube/vendor/github.com/sirupsen/logrus/formatter.go", "Go", 70, 0, 0, 0, 0, 0, 9, 79
"/opt/projects/swiftkube/vendor/github.com/sirupsen/logrus/hooks.go", "Go", 29, 0, 0, 0, 0, 0, 6, 35
"/opt/projects/swiftkube/vendor/github.com/sirupsen/logrus/json_formatter.go", "Go", 108, 0, 0, 0, 0, 0, 21, 129
"/opt/projects/swiftkube/vendor/github.com/sirupsen/logrus/logger.go", "Go", 347, 0, 0, 0, 0, 0, 71, 418
"/opt/projects/swiftkube/vendor/github.com/sirupsen/logrus/logrus.go", "Go", 163, 0, 0, 0, 0, 0, 24, 187
"/opt/projects/swiftkube/vendor/github.com/sirupsen/logrus/terminal_check_appengine.go", "Go", 8, 0, 0, 0, 0, 0, 4, 12
"/opt/projects/swiftkube/vendor/github.com/sirupsen/logrus/terminal_check_bsd.go", "Go", 9, 0, 0, 0, 0, 0, 5, 14
"/opt/projects/swiftkube/vendor/github.com/sirupsen/logrus/terminal_check_js.go", "Go", 5, 0, 0, 0, 0, 0, 3, 8
"/opt/projects/swiftkube/vendor/github.com/sirupsen/logrus/terminal_check_no_terminal.go", "Go", 8, 0, 0, 0, 0, 0, 4, 12
"/opt/projects/swiftkube/vendor/github.com/sirupsen/logrus/terminal_check_notappengine.go", "Go", 14, 0, 0, 0, 0, 0, 4, 18
"/opt/projects/swiftkube/vendor/github.com/sirupsen/logrus/terminal_check_solaris.go", "Go", 9, 0, 0, 0, 0, 0, 3, 12
"/opt/projects/swiftkube/vendor/github.com/sirupsen/logrus/terminal_check_unix.go", "Go", 9, 0, 0, 0, 0, 0, 5, 14
"/opt/projects/swiftkube/vendor/github.com/sirupsen/logrus/terminal_check_windows.go", "Go", 23, 0, 0, 0, 0, 0, 5, 28
"/opt/projects/swiftkube/vendor/github.com/sirupsen/logrus/text_formatter.go", "Go", 292, 0, 0, 0, 0, 0, 48, 340
"/opt/projects/swiftkube/vendor/github.com/sirupsen/logrus/writer.go", "Go", 59, 0, 0, 0, 0, 0, 12, 71
"/opt/projects/swiftkube/vendor/github.com/spf13/cobra/active_help.go", "Go", 57, 0, 0, 0, 0, 0, 7, 64
"/opt/projects/swiftkube/vendor/github.com/spf13/cobra/args.go", "Go", 117, 0, 0, 0, 0, 0, 15, 132
"/opt/projects/swiftkube/vendor/github.com/spf13/cobra/bash_completions.go", "Go", 631, 0, 0, 0, 0, 0, 82, 713
"/opt/projects/swiftkube/vendor/github.com/spf13/cobra/bash_completionsV2.go", "Go", 346, 0, 0, 0, 0, 0, 51, 397
"/opt/projects/swiftkube/vendor/github.com/spf13/cobra/cobra.go", "Go", 204, 0, 0, 0, 0, 0, 36, 240
"/opt/projects/swiftkube/vendor/github.com/spf13/cobra/command.go", "Go", 1580, 0, 0, 0, 0, 0, 255, 1835
"/opt/projects/swiftkube/vendor/github.com/spf13/cobra/command_notwin.go", "Go", 17, 0, 0, 0, 0, 0, 4, 21
"/opt/projects/swiftkube/vendor/github.com/spf13/cobra/command_win.go", "Go", 35, 0, 0, 0, 0, 0, 7, 42
"/opt/projects/swiftkube/vendor/github.com/spf13/cobra/completions.go", "Go", 755, 0, 0, 0, 0, 0, 124, 879
"/opt/projects/swiftkube/vendor/github.com/spf13/cobra/fish_completions.go", "Go", 240, 0, 0, 0, 0, 0, 53, 293
"/opt/projects/swiftkube/vendor/github.com/spf13/cobra/flag_groups.go", "Go", 198, 0, 0, 0, 0, 0, 27, 225
"/opt/projects/swiftkube/vendor/github.com/spf13/cobra/powershell_completions.go", "Go", 267, 0, 0, 0, 0, 0, 59, 326
"/opt/projects/swiftkube/vendor/github.com/spf13/cobra/shell_completions.go", "Go", 85, 0, 0, 0, 0, 0, 14, 99
"/opt/projects/swiftkube/vendor/github.com/spf13/cobra/zsh_completions.go", "Go", 266, 0, 0, 0, 0, 0, 43, 309
"/opt/projects/swiftkube/vendor/github.com/spf13/pflag/bool.go", "Go", 76, 0, 0, 0, 0, 0, 19, 95
"/opt/projects/swiftkube/vendor/github.com/spf13/pflag/bool_slice.go", "Go", 155, 0, 0, 0, 0, 0, 31, 186
"/opt/projects/swiftkube/vendor/github.com/spf13/pflag/bytes.go", "Go", 163, 0, 0, 0, 0, 0, 47, 210
"/opt/projects/swiftkube/vendor/github.com/spf13/pflag/count.go", "Go", 80, 0, 0, 0, 0, 0, 17, 97
"/opt/projects/swiftkube/vendor/github.com/spf13/pflag/duration.go", "Go", 70, 0, 0, 0, 0, 0, 17, 87
"/opt/projects/swiftkube/vendor/github.com/spf13/pflag/duration_slice.go", "Go", 143, 0, 0, 0, 0, 0, 24, 167
"/opt/projects/swiftkube/vendor/github.com/spf13/pflag/flag.go", "Go", 1081, 0, 0, 0, 0, 0, 159, 1240
"/opt/projects/swiftkube/vendor/github.com/spf13/pflag/float32.go", "Go", 72, 0, 0, 0, 0, 0, 17, 89
"/opt/projects/swiftkube/vendor/github.com/spf13/pflag/float32_slice.go", "Go", 151, 0, 0, 0, 0, 0, 24, 175
"/opt/projects/swiftkube/vendor/github.com/spf13/pflag/float64.go", "Go", 68, 0, 0, 0, 0, 0, 17, 85
"/opt/projects/swiftkube/vendor/github.com/spf13/pflag/float64_slice.go", "Go", 143, 0, 0, 0, 0, 0, 24, 167
"/opt/projects/swiftkube/vendor/github.com/spf13/pflag/golangflag.go", "Go", 91, 0, 0, 0, 0, 0, 15, 106
"/opt/projects/swiftkube/vendor/github.com/spf13/pflag/int.go", "Go", 68, 0, 0, 0, 0, 0, 17, 85
"/opt/projects/swiftkube/vendor/github.com/spf13/pflag/int16.go", "Go", 72, 0, 0, 0, 0, 0, 17, 89
"/opt/projects/swiftkube/vendor/github.com/spf13/pflag/int32.go", "Go", 72, 0, 0, 0, 0, 0, 17, 89
"/opt/projects/swiftkube/vendor/github.com/spf13/pflag/int32_slice.go", "Go", 151, 0, 0, 0, 0, 0, 24, 175
"/opt/projects/swiftkube/vendor/github.com/spf13/pflag/int64.go", "Go", 68, 0, 0, 0, 0, 0, 17, 85
"/opt/projects/swiftkube/vendor/github.com/spf13/pflag/int64_slice.go", "Go", 143, 0, 0, 0, 0, 0, 24, 167
"/opt/projects/swiftkube/vendor/github.com/spf13/pflag/int8.go", "Go", 72, 0, 0, 0, 0, 0, 17, 89
"/opt/projects/swiftkube/vendor/github.com/spf13/pflag/int_slice.go", "Go", 137, 0, 0, 0, 0, 0, 22, 159
"/opt/projects/swiftkube/vendor/github.com/spf13/pflag/ip.go", "Go", 79, 0, 0, 0, 0, 0, 16, 95
"/opt/projects/swiftkube/vendor/github.com/spf13/pflag/ip_slice.go", "Go", 156, 0, 0, 0, 0, 0, 31, 187
"/opt/projects/swiftkube/vendor/github.com/spf13/pflag/ipmask.go", "Go", 106, 0, 0, 0, 0, 0, 17, 123
"/opt/projects/swiftkube/vendor/github.com/spf13/pflag/ipnet.go", "Go", 82, 0, 0, 0, 0, 0, 17, 99
"/opt/projects/swiftkube/vendor/github.com/spf13/pflag/string.go", "Go", 66, 0, 0, 0, 0, 0, 15, 81
"/opt/projects/swiftkube/vendor/github.com/spf13/pflag/string_array.go", "Go", 111, 0, 0, 0, 0, 0, 19, 130
"/opt/projects/swiftkube/vendor/github.com/spf13/pflag/string_slice.go", "Go", 142, 0, 0, 0, 0, 0, 22, 164
"/opt/projects/swiftkube/vendor/github.com/spf13/pflag/string_to_int.go", "Go", 133, 0, 0, 0, 0, 0, 17, 150
"/opt/projects/swiftkube/vendor/github.com/spf13/pflag/string_to_int64.go", "Go", 133, 0, 0, 0, 0, 0, 17, 150
"/opt/projects/swiftkube/vendor/github.com/spf13/pflag/string_to_string.go", "Go", 142, 0, 0, 0, 0, 0, 19, 161
"/opt/projects/swiftkube/vendor/github.com/spf13/pflag/uint.go", "Go", 72, 0, 0, 0, 0, 0, 17, 89
"/opt/projects/swiftkube/vendor/github.com/spf13/pflag/uint16.go", "Go", 72, 0, 0, 0, 0, 0, 17, 89
"/opt/projects/swiftkube/vendor/github.com/spf13/pflag/uint32.go", "Go", 72, 0, 0, 0, 0, 0, 17, 89
"/opt/projects/swiftkube/vendor/github.com/spf13/pflag/uint64.go", "Go", 72, 0, 0, 0, 0, 0, 17, 89
"/opt/projects/swiftkube/vendor/github.com/spf13/pflag/uint8.go", "Go", 72, 0, 0, 0, 0, 0, 17, 89
"/opt/projects/swiftkube/vendor/github.com/spf13/pflag/uint_slice.go", "Go", 147, 0, 0, 0, 0, 0, 22, 169
"/opt/projects/swiftkube/vendor/github.com/stoewer/go-strcase/camel.go", "Go", 30, 0, 0, 0, 0, 0, 8, 38
"/opt/projects/swiftkube/vendor/github.com/stoewer/go-strcase/doc.go", "Go", 7, 0, 0, 0, 0, 0, 2, 9
"/opt/projects/swiftkube/vendor/github.com/stoewer/go-strcase/helper.go", "Go", 59, 0, 0, 0, 0, 0, 13, 72
"/opt/projects/swiftkube/vendor/github.com/stoewer/go-strcase/kebab.go", "Go", 11, 0, 0, 0, 0, 0, 4, 15
"/opt/projects/swiftkube/vendor/github.com/stoewer/go-strcase/snake.go", "Go", 49, 0, 0, 0, 0, 0, 10, 59
"/opt/projects/swiftkube/vendor/github.com/syndtr/gocapability/capability/capability.go", "Go", 117, 0, 0, 0, 0, 0, 17, 134
"/opt/projects/swiftkube/vendor/github.com/syndtr/gocapability/capability/capability_linux.go", "Go", 566, 0, 0, 0, 0, 0, 77, 643
"/opt/projects/swiftkube/vendor/github.com/syndtr/gocapability/capability/capability_noop.go", "Go", 14, 0, 0, 0, 0, 0, 6, 20
"/opt/projects/swiftkube/vendor/github.com/syndtr/gocapability/capability/enum.go", "Go", 261, 0, 0, 0, 0, 0, 49, 310
"/opt/projects/swiftkube/vendor/github.com/syndtr/gocapability/capability/enum_gen.go", "Go", 135, 0, 0, 0, 0, 0, 4, 139
"/opt/projects/swiftkube/vendor/github.com/syndtr/gocapability/capability/syscall_linux.go", "Go", 137, 0, 0, 0, 0, 0, 18, 155
"/opt/projects/swiftkube/vendor/github.com/vishvananda/netlink/addr.go", "Go", 50, 0, 0, 0, 0, 0, 7, 57
"/opt/projects/swiftkube/vendor/github.com/vishvananda/netlink/addr_linux.go", "Go", 370, 0, 0, 0, 0, 0, 48, 418
"/opt/projects/swiftkube/vendor/github.com/vishvananda/netlink/bpf_linux.go", "Go", 47, 0, 0, 0, 0, 0, 7, 54
"/opt/projects/swiftkube/vendor/github.com/vishvananda/netlink/bridge_linux.go", "Go", 99, 0, 0, 0, 0, 0, 14, 113
"/opt/projects/swiftkube/vendor/github.com/vishvananda/netlink/class.go", "Go", 178, 0, 0, 0, 0, 0, 34, 212
"/opt/projects/swiftkube/vendor/github.com/vishvananda/netlink/class_linux.go", "Go", 348, 0, 0, 0, 0, 0, 37, 385
"/opt/projects/swiftkube/vendor/github.com/vishvananda/netlink/conntrack_linux.go", "Go", 342, 0, 0, 0, 0, 0, 53, 395
"/opt/projects/swiftkube/vendor/github.com/vishvananda/netlink/conntrack_unspecified.go", "Go", 42, 0, 0, 0, 0, 0, 12, 54
"/opt/projects/swiftkube/vendor/github.com/vishvananda/netlink/devlink_linux.go", "Go", 240, 0, 0, 0, 0, 0, 33, 273
"/opt/projects/swiftkube/vendor/github.com/vishvananda/netlink/filter.go", "Go", 274, 0, 0, 0, 0, 0, 51, 325
"/opt/projects/swiftkube/vendor/github.com/vishvananda/netlink/filter_linux.go", "Go", 756, 0, 0, 0, 0, 0, 52, 808
"/opt/projects/swiftkube/vendor/github.com/vishvananda/netlink/fou.go", "Go", 18, 0, 0, 0, 0, 0, 4, 22
"/opt/projects/swiftkube/vendor/github.com/vishvananda/netlink/fou_linux.go", "Go", 168, 0, 0, 0, 0, 0, 44, 212
"/opt/projects/swiftkube/vendor/github.com/vishvananda/netlink/fou_unspecified.go", "Go", 11, 0, 0, 0, 0, 0, 5, 16
"/opt/projects/swiftkube/vendor/github.com/vishvananda/netlink/genetlink_linux.go", "Go", 156, 0, 0, 0, 0, 0, 16, 172
"/opt/projects/swiftkube/vendor/github.com/vishvananda/netlink/genetlink_unspecified.go", "Go", 17, 0, 0, 0, 0, 0, 9, 26
"/opt/projects/swiftkube/vendor/github.com/vishvananda/netlink/gtp_linux.go", "Go", 218, 0, 0, 0, 0, 0, 22, 240
"/opt/projects/swiftkube/vendor/github.com/vishvananda/netlink/handle_linux.go", "Go", 130, 0, 0, 0, 0, 0, 15, 145
"/opt/projects/swiftkube/vendor/github.com/vishvananda/netlink/handle_unspecified.go", "Go", 201, 0, 0, 0, 0, 0, 70, 271
"/opt/projects/swiftkube/vendor/github.com/vishvananda/netlink/ioctl_linux.go", "Go", 78, 0, 0, 0, 0, 0, 13, 91
"/opt/projects/swiftkube/vendor/github.com/vishvananda/netlink/link.go", "Go", 923, 0, 0, 0, 0, 0, 142, 1065
"/opt/projects/swiftkube/vendor/github.com/vishvananda/netlink/link_linux.go", "Go", 2622, 0, 0, 0, 0, 0, 397, 3019
"/opt/projects/swiftkube/vendor/github.com/vishvananda/netlink/link_tuntap_linux.go", "Go", 12, 0, 0, 0, 0, 0, 3, 15
"/opt/projects/swiftkube/vendor/github.com/vishvananda/netlink/neigh.go", "Go", 28, 0, 0, 0, 0, 0, 5, 33
"/opt/projects/swiftkube/vendor/github.com/vishvananda/netlink/neigh_linux.go", "Go", 371, 0, 0, 0, 0, 0, 52, 423
"/opt/projects/swiftkube/vendor/github.com/vishvananda/netlink/netlink.go", "Go", 36, 0, 0, 0, 0, 0, 5, 41
"/opt/projects/swiftkube/vendor/github.com/vishvananda/netlink/netlink_linux.go", "Go", 9, 0, 0, 0, 0, 0, 3, 12
"/opt/projects/swiftkube/vendor/github.com/vishvananda/netlink/netlink_unspecified.go", "Go", 177, 0, 0, 0, 0, 0, 61, 238
"/opt/projects/swiftkube/vendor/github.com/vishvananda/netlink/netns_linux.go", "Go", 115, 0, 0, 0, 0, 0, 27, 142
"/opt/projects/swiftkube/vendor/github.com/vishvananda/netlink/netns_unspecified.go", "Go", 14, 0, 0, 0, 0, 0, 6, 20
"/opt/projects/swiftkube/vendor/github.com/vishvananda/netlink/nl/addr_linux.go", "Go", 62, 0, 0, 0, 0, 0, 16, 78
"/opt/projects/swiftkube/vendor/github.com/vishvananda/netlink/nl/bridge_linux.go", "Go", 61, 0, 0, 0, 0, 0, 14, 75
"/opt/projects/swiftkube/vendor/github.com/vishvananda/netlink/nl/conntrack_linux.go", "Go", 198, 0, 0, 0, 0, 0, 20, 218
"/opt/projects/swiftkube/vendor/github.com/vishvananda/netlink/nl/devlink_linux.go", "Go", 33, 0, 0, 0, 0, 0, 8, 41
"/opt/projects/swiftkube/vendor/github.com/vishvananda/netlink/nl/genetlink_linux.go", "Go", 74, 0, 0, 0, 0, 0, 16, 90
"/opt/projects/swiftkube/vendor/github.com/vishvananda/netlink/nl/link_linux.go", "Go", 531, 0, 0, 0, 0, 0, 80, 611
"/opt/projects/swiftkube/vendor/github.com/vishvananda/netlink/nl/mpls_linux.go", "Go", 32, 0, 0, 0, 0, 0, 5, 37
"/opt/projects/swiftkube/vendor/github.com/vishvananda/netlink/nl/nl_linux.go", "Go", 688, 0, 0, 0, 0, 0, 73, 761
"/opt/projects/swiftkube/vendor/github.com/vishvananda/netlink/nl/nl_unspecified.go", "Go", 7, 0, 0, 0, 0, 0, 5, 12
"/opt/projects/swiftkube/vendor/github.com/vishvananda/netlink/nl/rdma_link_linux.go", "Go", 31, 0, 0, 0, 0, 0, 5, 36
"/opt/projects/swiftkube/vendor/github.com/vishvananda/netlink/nl/route_linux.go", "Go", 89, 0, 0, 0, 0, 0, 19, 108
"/opt/projects/swiftkube/vendor/github.com/vishvananda/netlink/nl/seg6_linux.go", "Go", 144, 0, 0, 0, 0, 0, 11, 155
"/opt/projects/swiftkube/vendor/github.com/vishvananda/netlink/nl/seg6local_linux.go", "Go", 72, 0, 0, 0, 0, 0, 5, 77
"/opt/projects/swiftkube/vendor/github.com/vishvananda/netlink/nl/syscall.go", "Go", 63, 0, 0, 0, 0, 0, 7, 70
"/opt/projects/swiftkube/vendor/github.com/vishvananda/netlink/nl/tc_linux.go", "Go", 736, 0, 0, 0, 0, 0, 139, 875
"/opt/projects/swiftkube/vendor/github.com/vishvananda/netlink/nl/xfrm_linux.go", "Go", 265, 0, 0, 0, 0, 0, 42, 307
"/opt/projects/swiftkube/vendor/github.com/vishvananda/netlink/nl/xfrm_monitor_linux.go", "Go", 25, 0, 0, 0, 0, 0, 8, 33
"/opt/projects/swiftkube/vendor/github.com/vishvananda/netlink/nl/xfrm_policy_linux.go", "Go", 102, 0, 0, 0, 0, 0, 18, 120
"/opt/projects/swiftkube/vendor/github.com/vishvananda/netlink/nl/xfrm_state_linux.go", "Go", 283, 0, 0, 0, 0, 0, 52, 335
"/opt/projects/swiftkube/vendor/github.com/vishvananda/netlink/order.go", "Go", 25, 0, 0, 0, 0, 0, 8, 33
"/opt/projects/swiftkube/vendor/github.com/vishvananda/netlink/protinfo.go", "Go", 56, 0, 0, 0, 0, 0, 7, 63
"/opt/projects/swiftkube/vendor/github.com/vishvananda/netlink/protinfo_linux.go", "Go", 67, 0, 0, 0, 0, 0, 8, 75
"/opt/projects/swiftkube/vendor/github.com/vishvananda/netlink/qdisc.go", "Go", 289, 0, 0, 0, 0, 0, 52, 341
"/opt/projects/swiftkube/vendor/github.com/vishvananda/netlink/qdisc_linux.go", "Go", 608, 0, 0, 0, 0, 0, 61, 669
"/opt/projects/swiftkube/vendor/github.com/vishvananda/netlink/rdma_link_linux.go", "Go", 221, 0, 0, 0, 0, 0, 44, 265
"/opt/projects/swiftkube/vendor/github.com/vishvananda/netlink/route.go", "Go", 162, 0, 0, 0, 0, 0, 19, 181
"/opt/projects/swiftkube/vendor/github.com/vishvananda/netlink/route_linux.go", "Go", 1006, 0, 0, 0, 0, 0, 76, 1082
"/opt/projects/swiftkube/vendor/github.com/vishvananda/netlink/route_unspecified.go", "Go", 8, 0, 0, 0, 0, 0, 4, 12
"/opt/projects/swiftkube/vendor/github.com/vishvananda/netlink/rule.go", "Go", 38, 0, 0, 0, 0, 0, 5, 43
"/opt/projects/swiftkube/vendor/github.com/vishvananda/netlink/rule_linux.go", "Go", 212, 0, 0, 0, 0, 0, 23, 235
"/opt/projects/swiftkube/vendor/github.com/vishvananda/netlink/socket.go", "Go", 24, 0, 0, 0, 0, 0, 4, 28
"/opt/projects/swiftkube/vendor/github.com/vishvananda/netlink/socket_linux.go", "Go", 147, 0, 0, 0, 0, 0, 16, 163
"/opt/projects/swiftkube/vendor/github.com/vishvananda/netlink/xfrm.go", "Go", 65, 0, 0, 0, 0, 0, 11, 76
"/opt/projects/swiftkube/vendor/github.com/vishvananda/netlink/xfrm_monitor_linux.go", "Go", 81, 0, 0, 0, 0, 0, 21, 102
"/opt/projects/swiftkube/vendor/github.com/vishvananda/netlink/xfrm_policy.go", "Go", 85, 0, 0, 0, 0, 0, 12, 97
"/opt/projects/swiftkube/vendor/github.com/vishvananda/netlink/xfrm_policy_linux.go", "Go", 226, 0, 0, 0, 0, 0, 38, 264
"/opt/projects/swiftkube/vendor/github.com/vishvananda/netlink/xfrm_state.go", "Go", 118, 0, 0, 0, 0, 0, 14, 132
"/opt/projects/swiftkube/vendor/github.com/vishvananda/netlink/xfrm_state_linux.go", "Go", 399, 0, 0, 0, 0, 0, 64, 463
"/opt/projects/swiftkube/vendor/github.com/vishvananda/netns/doc.go", "Go", 9, 0, 0, 0, 0, 0, 1, 10
"/opt/projects/swiftkube/vendor/github.com/vishvananda/netns/netns_linux.go", "Go", 244, 0, 0, 0, 0, 0, 40, 284
"/opt/projects/swiftkube/vendor/github.com/vishvananda/netns/netns_others.go", "Go", 46, 0, 0, 0, 0, 0, 15, 61
"/opt/projects/swiftkube/vendor/github.com/vishvananda/netns/nshandle_linux.go", "Go", 64, 0, 0, 0, 0, 0, 10, 74
"/opt/projects/swiftkube/vendor/github.com/vishvananda/netns/nshandle_others.go", "Go", 37, 0, 0, 0, 0, 0, 9, 46
"/opt/projects/swiftkube/vendor/github.com/vmware/govmomi/find/doc.go", "Go", 29, 0, 0, 0, 0, 0, 9, 38
"/opt/projects/swiftkube/vendor/github.com/vmware/govmomi/find/error.go", "Go", 50, 0, 0, 0, 0, 0, 15, 65
"/opt/projects/swiftkube/vendor/github.com/vmware/govmomi/find/finder.go", "Go", 893, 0, 0, 0, 0, 0, 222, 1115
"/opt/projects/swiftkube/vendor/github.com/vmware/govmomi/find/recurser.go", "Go", 201, 0, 0, 0, 0, 0, 53, 254
"/opt/projects/swiftkube/vendor/github.com/vmware/govmomi/history/collector.go", "Go", 72, 0, 0, 0, 0, 0, 20, 92
"/opt/projects/swiftkube/vendor/github.com/vmware/govmomi/internal/helpers.go", "Go", 51, 0, 0, 0, 0, 0, 13, 64
"/opt/projects/swiftkube/vendor/github.com/vmware/govmomi/internal/methods.go", "Go", 87, 0, 0, 0, 0, 0, 37, 124
"/opt/projects/swiftkube/vendor/github.com/vmware/govmomi/internal/types.go", "Go", 206, 0, 0, 0, 0, 0, 65, 271
"/opt/projects/swiftkube/vendor/github.com/vmware/govmomi/internal/version/version.go", "Go", 19, 0, 0, 0, 0, 0, 7, 26
"/opt/projects/swiftkube/vendor/github.com/vmware/govmomi/list/lister.go", "Go", 516, 0, 0, 0, 0, 0, 113, 629
"/opt/projects/swiftkube/vendor/github.com/vmware/govmomi/list/path.go", "Go", 35, 0, 0, 0, 0, 0, 10, 45
"/opt/projects/swiftkube/vendor/github.com/vmware/govmomi/lookup/client.go", "Go", 130, 0, 0, 0, 0, 0, 28, 158
"/opt/projects/swiftkube/vendor/github.com/vmware/govmomi/lookup/methods/methods.go", "Go", 158, 0, 0, 0, 0, 0, 67, 225
"/opt/projects/swiftkube/vendor/github.com/vmware/govmomi/lookup/types/types.go", "Go", 304, 0, 0, 0, 0, 0, 109, 413
"/opt/projects/swiftkube/vendor/github.com/vmware/govmomi/nfc/lease.go", "Go", 185, 0, 0, 0, 0, 0, 49, 234
"/opt/projects/swiftkube/vendor/github.com/vmware/govmomi/nfc/lease_updater.go", "Go", 117, 0, 0, 0, 0, 0, 30, 147
"/opt/projects/swiftkube/vendor/github.com/vmware/govmomi/object/authorization_manager.go", "Go", 175, 0, 0, 0, 0, 0, 47, 222
"/opt/projects/swiftkube/vendor/github.com/vmware/govmomi/object/authorization_manager_internal.go", "Go", 67, 0, 0, 0, 0, 0, 20, 87
"/opt/projects/swiftkube/vendor/github.com/vmware/govmomi/object/cluster_compute_resource.go", "Go", 80, 0, 0, 0, 0, 0, 24, 104
"/opt/projects/swiftkube/vendor/github.com/vmware/govmomi/object/common.go", "Go", 117, 0, 0, 0, 0, 0, 32, 149
"/opt/projects/swiftkube/vendor/github.com/vmware/govmomi/object/compute_resource.go", "Go", 86, 0, 0, 0, 0, 0, 26, 112
"/opt/projects/swiftkube/vendor/github.com/vmware/govmomi/object/custom_fields_manager.go", "Go", 117, 0, 0, 0, 0, 0, 30, 147
"/opt/projects/swiftkube/vendor/github.com/vmware/govmomi/object/customization_spec_manager.go", "Go", 135, 0, 0, 0, 0, 0, 39, 174
"/opt/projects/swiftkube/vendor/github.com/vmware/govmomi/object/datacenter.go", "Go", 105, 0, 0, 0, 0, 0, 25, 130
"/opt/projects/swiftkube/vendor/github.com/vmware/govmomi/object/datastore.go", "Go", 352, 0, 0, 0, 0, 0, 88, 440
"/opt/projects/swiftkube/vendor/github.com/vmware/govmomi/object/datastore_file.go", "Go", 336, 0, 0, 0, 0, 0, 77, 413
"/opt/projects/swiftkube/vendor/github.com/vmware/govmomi/object/datastore_file_manager.go", "Go", 178, 0, 0, 0, 0, 0, 51, 229
"/opt/projects/swiftkube/vendor/github.com/vmware/govmomi/object/datastore_path.go", "Go", 54, 0, 0, 0, 0, 0, 18, 72
"/opt/projects/swiftkube/vendor/github.com/vmware/govmomi/object/diagnostic_log.go", "Go", 59, 0, 0, 0, 0, 0, 18, 77
"/opt/projects/swiftkube/vendor/github.com/vmware/govmomi/object/diagnostic_manager.go", "Go", 80, 0, 0, 0, 0, 0, 23, 103
"/opt/projects/swiftkube/vendor/github.com/vmware/govmomi/object/distributed_virtual_portgroup.go", "Go", 72, 0, 0, 0, 0, 0, 19, 91
"/opt/projects/swiftkube/vendor/github.com/vmware/govmomi/object/distributed_virtual_switch.go", "Go", 94, 0, 0, 0, 0, 0, 25, 119
"/opt/projects/swiftkube/vendor/github.com/vmware/govmomi/object/extension_manager.go", "Go", 89, 0, 0, 0, 0, 0, 25, 114
"/opt/projects/swiftkube/vendor/github.com/vmware/govmomi/object/file_manager.go", "Go", 100, 0, 0, 0, 0, 0, 27, 127
"/opt/projects/swiftkube/vendor/github.com/vmware/govmomi/object/folder.go", "Go", 190, 0, 0, 0, 0, 0, 52, 242
"/opt/projects/swiftkube/vendor/github.com/vmware/govmomi/object/host_account_manager.go", "Go", 51, 0, 0, 0, 0, 0, 15, 66
"/opt/projects/swiftkube/vendor/github.com/vmware/govmomi/object/host_certificate_info.go", "Go", 200, 0, 0, 0, 0, 0, 51, 251
"/opt/projects/swiftkube/vendor/github.com/vmware/govmomi/object/host_certificate_manager.go", "Go", 131, 0, 0, 0, 0, 0, 32, 163
"/opt/projects/swiftkube/vendor/github.com/vmware/govmomi/object/host_config_manager.go", "Go", 145, 0, 0, 0, 0, 0, 27, 172
"/opt/projects/swiftkube/vendor/github.com/vmware/govmomi/object/host_datastore_browser.go", "Go", 51, 0, 0, 0, 0, 0, 15, 66
"/opt/projects/swiftkube/vendor/github.com/vmware/govmomi/object/host_datastore_system.go", "Go", 106, 0, 0, 0, 0, 0, 30, 136
"/opt/projects/swiftkube/vendor/github.com/vmware/govmomi/object/host_date_time_system.go", "Go", 54, 0, 0, 0, 0, 0, 16, 70
"/opt/projects/swiftkube/vendor/github.com/vmware/govmomi/object/host_firewall_system.go", "Go", 141, 0, 0, 0, 0, 0, 41, 182
"/opt/projects/swiftkube/vendor/github.com/vmware/govmomi/object/host_network_system.go", "Go", 287, 0, 0, 0, 0, 0, 72, 359
"/opt/projects/swiftkube/vendor/github.com/vmware/govmomi/object/host_service_system.go", "Go", 69, 0, 0, 0, 0, 0, 20, 89
"/opt/projects/swiftkube/vendor/github.com/vmware/govmomi/object/host_storage_system.go", "Go", 157, 0, 0, 0, 0, 0, 44, 201
"/opt/projects/swiftkube/vendor/github.com/vmware/govmomi/object/host_system.go", "Go", 122, 0, 0, 0, 0, 0, 33, 155
"/opt/projects/swiftkube/vendor/github.com/vmware/govmomi/object/host_virtual_nic_manager.go", "Go", 74, 0, 0, 0, 0, 0, 20, 94
"/opt/projects/swiftkube/vendor/github.com/vmware/govmomi/object/host_vsan_internal_system.go", "Go", 92, 0, 0, 0, 0, 0, 26, 118
"/opt/projects/swiftkube/vendor/github.com/vmware/govmomi/object/host_vsan_system.go", "Go", 67, 0, 0, 0, 0, 0, 22, 89
"/opt/projects/swiftkube/vendor/github.com/vmware/govmomi/object/namespace_manager.go", "Go", 58, 0, 0, 0, 0, 0, 19, 77
"/opt/projects/swiftkube/vendor/github.com/vmware/govmomi/object/network.go", "Go", 42, 0, 0, 0, 0, 0, 13, 55
"/opt/projects/swiftkube/vendor/github.com/vmware/govmomi/object/network_reference.go", "Go", 24, 0, 0, 0, 0, 0, 8, 32
"/opt/projects/swiftkube/vendor/github.com/vmware/govmomi/object/opaque_network.go", "Go", 56, 0, 0, 0, 0, 0, 17, 73
"/opt/projects/swiftkube/vendor/github.com/vmware/govmomi/object/option_manager.go", "Go", 46, 0, 0, 0, 0, 0, 14, 60
"/opt/projects/swiftkube/vendor/github.com/vmware/govmomi/object/resource_pool.go", "Go", 119, 0, 0, 0, 0, 0, 33, 152
"/opt/projects/swiftkube/vendor/github.com/vmware/govmomi/object/search_index.go", "Go", 209, 0, 0, 0, 0, 0, 40, 249
"/opt/projects/swiftkube/vendor/github.com/vmware/govmomi/object/storage_pod.go", "Go", 27, 0, 0, 0, 0, 0, 8, 35
"/opt/projects/swiftkube/vendor/github.com/vmware/govmomi/object/storage_resource_manager.go", "Go", 137, 0, 0, 0, 0, 0, 43, 180
"/opt/projects/swiftkube/vendor/github.com/vmware/govmomi/object/task.go", "Go", 84, 0, 0, 0, 0, 0, 17, 101
"/opt/projects/swiftkube/vendor/github.com/vmware/govmomi/object/tenant_manager.go", "Go", 60, 0, 0, 0, 0, 0, 19, 79
"/opt/projects/swiftkube/vendor/github.com/vmware/govmomi/object/types.go", "Go", 60, 0, 0, 0, 0, 0, 8, 68
"/opt/projects/swiftkube/vendor/github.com/vmware/govmomi/object/virtual_app.go", "Go", 94, 0, 0, 0, 0, 0, 28, 122
"/opt/projects/swiftkube/vendor/github.com/vmware/govmomi/object/virtual_device_list.go", "Go", 809, 0, 0, 0, 0, 0, 157, 966
"/opt/projects/swiftkube/vendor/github.com/vmware/govmomi/object/virtual_disk_manager.go", "Go", 182, 0, 0, 0, 0, 0, 46, 228
"/opt/projects/swiftkube/vendor/github.com/vmware/govmomi/object/virtual_disk_manager_internal.go", "Go", 128, 0, 0, 0, 0, 0, 39, 167
"/opt/projects/swiftkube/vendor/github.com/vmware/govmomi/object/virtual_machine.go", "Go", 874, 0, 0, 0, 0, 0, 209, 1083
"/opt/projects/swiftkube/vendor/github.com/vmware/govmomi/object/vmware_distributed_virtual_switch.go", "Go", 19, 0, 0, 0, 0, 0, 7, 26
"/opt/projects/swiftkube/vendor/github.com/vmware/govmomi/pbm/client.go", "Go", 230, 0, 0, 0, 0, 0, 58, 288
"/opt/projects/swiftkube/vendor/github.com/vmware/govmomi/pbm/methods/methods.go", "Go", 466, 0, 0, 0, 0, 0, 199, 665
"/opt/projects/swiftkube/vendor/github.com/vmware/govmomi/pbm/pbm_util.go", "Go", 133, 0, 0, 0, 0, 0, 16, 149
"/opt/projects/swiftkube/vendor/github.com/vmware/govmomi/pbm/types/enum.go", "Go", 238, 0, 0, 0, 0, 0, 70, 308
"/opt/projects/swiftkube/vendor/github.com/vmware/govmomi/pbm/types/if.go", "Go", 100, 0, 0, 0, 0, 0, 40, 140
"/opt/projects/swiftkube/vendor/github.com/vmware/govmomi/pbm/types/types.go", "Go", 1302, 0, 0, 0, 0, 0, 456, 1758
"/opt/projects/swiftkube/vendor/github.com/vmware/govmomi/property/collector.go", "Go", 174, 0, 0, 0, 0, 0, 44, 218
"/opt/projects/swiftkube/vendor/github.com/vmware/govmomi/property/filter.go", "Go", 138, 0, 0, 0, 0, 0, 31, 169
"/opt/projects/swiftkube/vendor/github.com/vmware/govmomi/property/wait.go", "Go", 126, 0, 0, 0, 0, 0, 26, 152
"/opt/projects/swiftkube/vendor/github.com/vmware/govmomi/session/keep_alive.go", "Go", 32, 0, 0, 0, 0, 0, 9, 41
"/opt/projects/swiftkube/vendor/github.com/vmware/govmomi/session/keepalive/handler.go", "Go", 167, 0, 0, 0, 0, 0, 38, 205
"/opt/projects/swiftkube/vendor/github.com/vmware/govmomi/session/manager.go", "Go", 239, 0, 0, 0, 0, 0, 56, 295
"/opt/projects/swiftkube/vendor/github.com/vmware/govmomi/sts/client.go", "Go", 184, 0, 0, 0, 0, 0, 36, 220
"/opt/projects/swiftkube/vendor/github.com/vmware/govmomi/sts/internal/types.go", "Go", 582, 0, 0, 0, 0, 0, 113, 695
"/opt/projects/swiftkube/vendor/github.com/vmware/govmomi/sts/signer.go", "Go", 314, 0, 0, 0, 0, 0, 42, 356
"/opt/projects/swiftkube/vendor/github.com/vmware/govmomi/task/error.go", "Go", 25, 0, 0, 0, 0, 0, 9, 34
"/opt/projects/swiftkube/vendor/github.com/vmware/govmomi/task/history_collector.go", "Go", 72, 0, 0, 0, 0, 0, 18, 90
"/opt/projects/swiftkube/vendor/github.com/vmware/govmomi/task/manager.go", "Go", 48, 0, 0, 0, 0, 0, 14, 62
"/opt/projects/swiftkube/vendor/github.com/vmware/govmomi/task/wait.go", "Go", 117, 0, 0, 0, 0, 0, 27, 144
"/opt/projects/swiftkube/vendor/github.com/vmware/govmomi/vapi/internal/internal.go", "Go", 76, 0, 0, 0, 0, 0, 14, 90
"/opt/projects/swiftkube/vendor/github.com/vmware/govmomi/vapi/rest/client.go", "Go", 277, 0, 0, 0, 0, 0, 60, 337
"/opt/projects/swiftkube/vendor/github.com/vmware/govmomi/vapi/rest/resource.go", "Go", 98, 0, 0, 0, 0, 0, 17, 115
"/opt/projects/swiftkube/vendor/github.com/vmware/govmomi/vapi/tags/categories.go", "Go", 149, 0, 0, 0, 0, 0, 19, 168
"/opt/projects/swiftkube/vendor/github.com/vmware/govmomi/vapi/tags/errors.go", "Go", 44, 0, 0, 0, 0, 0, 12, 56
"/opt/projects/swiftkube/vendor/github.com/vmware/govmomi/vapi/tags/tag_association.go", "Go", 326, 0, 0, 0, 0, 0, 52, 378
"/opt/projects/swiftkube/vendor/github.com/vmware/govmomi/vapi/tags/tags.go", "Go", 194, 0, 0, 0, 0, 0, 33, 227
"/opt/projects/swiftkube/vendor/github.com/vmware/govmomi/view/container_view.go", "Go", 113, 0, 0, 0, 0, 0, 33, 146
"/opt/projects/swiftkube/vendor/github.com/vmware/govmomi/view/list_view.go", "Go", 51, 0, 0, 0, 0, 0, 12, 63
"/opt/projects/swiftkube/vendor/github.com/vmware/govmomi/view/managed_object_view.go", "Go", 41, 0, 0, 0, 0, 0, 12, 53
"/opt/projects/swiftkube/vendor/github.com/vmware/govmomi/view/manager.go", "Go", 53, 0, 0, 0, 0, 0, 17, 70
"/opt/projects/swiftkube/vendor/github.com/vmware/govmomi/view/task_view.go", "Go", 98, 0, 0, 0, 0, 0, 28, 126
"/opt/projects/swiftkube/vendor/github.com/vmware/govmomi/vim25/client.go", "Go", 154, 0, 0, 0, 0, 0, 38, 192
"/opt/projects/swiftkube/vendor/github.com/vmware/govmomi/vim25/debug/debug.go", "Go", 59, 0, 0, 0, 0, 0, 15, 74
"/opt/projects/swiftkube/vendor/github.com/vmware/govmomi/vim25/debug/file.go", "Go", 60, 0, 0, 0, 0, 0, 16, 76
"/opt/projects/swiftkube/vendor/github.com/vmware/govmomi/vim25/debug/log.go", "Go", 37, 0, 0, 0, 0, 0, 13, 50
"/opt/projects/swiftkube/vendor/github.com/vmware/govmomi/vim25/doc.go", "Go", 24, 0, 0, 0, 0, 0, 6, 30
"/opt/projects/swiftkube/vendor/github.com/vmware/govmomi/vim25/methods/methods.go", "Go", 13094, 0, 0, 0, 0, 0, 5611, 18705
"/opt/projects/swiftkube/vendor/github.com/vmware/govmomi/vim25/methods/service_content.go", "Go", 44, 0, 0, 0, 0, 0, 14, 58
"/opt/projects/swiftkube/vendor/github.com/vmware/govmomi/vim25/methods/unreleased.go", "Go", 32, 0, 0, 0, 0, 0, 13, 45
"/opt/projects/swiftkube/vendor/github.com/vmware/govmomi/vim25/mo/ancestors.go", "Go", 118, 0, 0, 0, 0, 0, 20, 138
"/opt/projects/swiftkube/vendor/github.com/vmware/govmomi/vim25/mo/entity.go", "Go", 19, 0, 0, 0, 0, 0, 6, 25
"/opt/projects/swiftkube/vendor/github.com/vmware/govmomi/vim25/mo/extra.go", "Go", 46, 0, 0, 0, 0, 0, 16, 62
"/opt/projects/swiftkube/vendor/github.com/vmware/govmomi/vim25/mo/mo.go", "Go", 1402, 0, 0, 0, 0, 0, 467, 1869
"/opt/projects/swiftkube/vendor/github.com/vmware/govmomi/vim25/mo/reference.go", "Go", 20, 0, 0, 0, 0, 0, 7, 27
"/opt/projects/swiftkube/vendor/github.com/vmware/govmomi/vim25/mo/registry.go", "Go", 15, 0, 0, 0, 0, 0, 7, 22
"/opt/projects/swiftkube/vendor/github.com/vmware/govmomi/vim25/mo/retrieve.go", "Go", 214, 0, 0, 0, 0, 0, 42, 256
"/opt/projects/swiftkube/vendor/github.com/vmware/govmomi/vim25/mo/type_info.go", "Go", 212, 0, 0, 0, 0, 0, 52, 264
"/opt/projects/swiftkube/vendor/github.com/vmware/govmomi/vim25/progress/aggregator.go", "Go", 57, 0, 0, 0, 0, 0, 17, 74
"/opt/projects/swiftkube/vendor/github.com/vmware/govmomi/vim25/progress/doc.go", "Go", 26, 0, 0, 0, 0, 0, 7, 33
"/opt/projects/swiftkube/vendor/github.com/vmware/govmomi/vim25/progress/prefix.go", "Go", 42, 0, 0, 0, 0, 0, 13, 55
"/opt/projects/swiftkube/vendor/github.com/vmware/govmomi/vim25/progress/reader.go", "Go", 154, 0, 0, 0, 0, 0, 35, 189
"/opt/projects/swiftkube/vendor/github.com/vmware/govmomi/vim25/progress/report.go", "Go", 21, 0, 0, 0, 0, 0, 6, 27
"/opt/projects/swiftkube/vendor/github.com/vmware/govmomi/vim25/progress/scale.go", "Go", 62, 0, 0, 0, 0, 0, 15, 77
"/opt/projects/swiftkube/vendor/github.com/vmware/govmomi/vim25/progress/sinker.go", "Go", 26, 0, 0, 0, 0, 0, 8, 34
"/opt/projects/swiftkube/vendor/github.com/vmware/govmomi/vim25/progress/tee.go", "Go", 33, 0, 0, 0, 0, 0, 9, 42
"/opt/projects/swiftkube/vendor/github.com/vmware/govmomi/vim25/retry.go", "Go", 91, 0, 0, 0, 0, 0, 23, 114
"/opt/projects/swiftkube/vendor/github.com/vmware/govmomi/vim25/soap/client.go", "Go", 734, 0, 0, 0, 0, 0, 176, 910
"/opt/projects/swiftkube/vendor/github.com/vmware/govmomi/vim25/soap/debug.go", "Go", 124, 0, 0, 0, 0, 0, 31, 155
"/opt/projects/swiftkube/vendor/github.com/vmware/govmomi/vim25/soap/error.go", "Go", 101, 0, 0, 0, 0, 0, 29, 130
"/opt/projects/swiftkube/vendor/github.com/vmware/govmomi/vim25/soap/soap.go", "Go", 40, 0, 0, 0, 0, 0, 10, 50
"/opt/projects/swiftkube/vendor/github.com/vmware/govmomi/vim25/types/base.go", "Go", 14, 0, 0, 0, 0, 0, 6, 20
"/opt/projects/swiftkube/vendor/github.com/vmware/govmomi/vim25/types/enum.go", "Go", 4327, 0, 0, 0, 0, 0, 1221, 5548
"/opt/projects/swiftkube/vendor/github.com/vmware/govmomi/vim25/types/fault.go", "Go", 34, 0, 0, 0, 0, 0, 10, 44
"/opt/projects/swiftkube/vendor/github.com/vmware/govmomi/vim25/types/helpers.go", "Go", 280, 0, 0, 0, 0, 0, 37, 317
"/opt/projects/swiftkube/vendor/github.com/vmware/govmomi/vim25/types/if.go", "Go", 2539, 0, 0, 0, 0, 0, 1023, 3562
"/opt/projects/swiftkube/vendor/github.com/vmware/govmomi/vim25/types/registry.go", "Go", 34, 0, 0, 0, 0, 0, 10, 44
"/opt/projects/swiftkube/vendor/github.com/vmware/govmomi/vim25/types/types.go", "Go", 44256, 0, 0, 0, 0, 0, 15157, 59413
"/opt/projects/swiftkube/vendor/github.com/vmware/govmomi/vim25/types/unreleased.go", "Go", 89, 0, 0, 0, 0, 0, 33, 122
"/opt/projects/swiftkube/vendor/github.com/vmware/govmomi/vim25/xml/extras.go", "Go", 87, 0, 0, 0, 0, 0, 13, 100
"/opt/projects/swiftkube/vendor/github.com/vmware/govmomi/vim25/xml/marshal.go", "Go", 977, 0, 0, 0, 0, 0, 90, 1067
"/opt/projects/swiftkube/vendor/github.com/vmware/govmomi/vim25/xml/read.go", "Go", 765, 0, 0, 0, 0, 0, 73, 838
"/opt/projects/swiftkube/vendor/github.com/vmware/govmomi/vim25/xml/typeinfo.go", "Go", 340, 0, 0, 0, 0, 0, 38, 378
"/opt/projects/swiftkube/vendor/github.com/vmware/govmomi/vim25/xml/xml.go", "Go", 1942, 0, 0, 0, 0, 0, 115, 2057
"/opt/projects/swiftkube/vendor/github.com/xlab/treeprint/helpers.go", "Go", 43, 0, 0, 0, 0, 0, 5, 48
"/opt/projects/swiftkube/vendor/github.com/xlab/treeprint/struct.go", "Go", 306, 0, 0, 0, 0, 0, 17, 323
"/opt/projects/swiftkube/vendor/github.com/xlab/treeprint/treeprint.go", "Go", 251, 0, 0, 0, 0, 0, 44, 295
"/opt/projects/swiftkube/vendor/go.etcd.io/etcd/api/v3/authpb/auth.pb.go", "Go", 1110, 0, 0, 0, 0, 0, 49, 1159
"/opt/projects/swiftkube/vendor/go.etcd.io/etcd/api/v3/authpb/auth.proto", "Protocol Buffers", 0, 0, 31, 0, 0, 3, 9, 43
"/opt/projects/swiftkube/vendor/go.etcd.io/etcd/api/v3/etcdserverpb/etcdserver.pb.go", "Go", 976, 0, 0, 0, 0, 0, 27, 1003
"/opt/projects/swiftkube/vendor/go.etcd.io/etcd/api/v3/etcdserverpb/etcdserver.proto", "Protocol Buffers", 0, 0, 30, 0, 0, 0, 5, 35
"/opt/projects/swiftkube/vendor/go.etcd.io/etcd/api/v3/etcdserverpb/raft_internal.pb.go", "Go", 2631, 0, 0, 0, 0, 0, 43, 2674
"/opt/projects/swiftkube/vendor/go.etcd.io/etcd/api/v3/etcdserverpb/raft_internal.proto", "Protocol Buffers", 0, 0, 56, 0, 0, 8, 18, 82
"/opt/projects/swiftkube/vendor/go.etcd.io/etcd/api/v3/etcdserverpb/raft_internal_stringer.go", "Go", 166, 0, 0, 0, 0, 0, 18, 184
"/opt/projects/swiftkube/vendor/go.etcd.io/etcd/api/v3/etcdserverpb/rpc.pb.go", "Go", 24644, 0, 0, 0, 0, 0, 1219, 25863
"/opt/projects/swiftkube/vendor/go.etcd.io/etcd/api/v3/etcdserverpb/rpc.proto", "Protocol Buffers", 0, 0, 730, 0, 0, 292, 178, 1200
"/opt/projects/swiftkube/vendor/go.etcd.io/etcd/api/v3/membershippb/membership.pb.go", "Go", 1396, 0, 0, 0, 0, 0, 59, 1455
"/opt/projects/swiftkube/vendor/go.etcd.io/etcd/api/v3/membershippb/membership.proto", "Protocol Buffers", 0, 0, 31, 0, 0, 4, 8, 43
"/opt/projects/swiftkube/vendor/go.etcd.io/etcd/api/v3/mvccpb/kv.pb.go", "Go", 766, 0, 0, 0, 0, 0, 33, 799
"/opt/projects/swiftkube/vendor/go.etcd.io/etcd/api/v3/mvccpb/kv.proto", "Protocol Buffers", 0, 0, 25, 0, 0, 19, 6, 50
"/opt/projects/swiftkube/vendor/go.etcd.io/etcd/api/v3/v3rpc/rpctypes/doc.go", "Go", 15, 0, 0, 0, 0, 0, 2, 17
"/opt/projects/swiftkube/vendor/go.etcd.io/etcd/api/v3/v3rpc/rpctypes/error.go", "Go", 233, 0, 0, 0, 0, 0, 32, 265
"/opt/projects/swiftkube/vendor/go.etcd.io/etcd/api/v3/v3rpc/rpctypes/md.go", "Go", 19, 0, 0, 0, 0, 0, 4, 23
"/opt/projects/swiftkube/vendor/go.etcd.io/etcd/api/v3/v3rpc/rpctypes/metadatafields.go", "Go", 18, 0, 0, 0, 0, 0, 3, 21
"/opt/projects/swiftkube/vendor/go.etcd.io/etcd/api/v3/version/version.go", "Go", 48, 0, 0, 0, 0, 0, 9, 57
"/opt/projects/swiftkube/vendor/go.etcd.io/etcd/client/pkg/v3/fileutil/dir_unix.go", "Go", 23, 0, 0, 0, 0, 0, 6, 29
"/opt/projects/swiftkube/vendor/go.etcd.io/etcd/client/pkg/v3/fileutil/dir_windows.go", "Go", 46, 0, 0, 0, 0, 0, 7, 53
"/opt/projects/swiftkube/vendor/go.etcd.io/etcd/client/pkg/v3/fileutil/doc.go", "Go", 15, 0, 0, 0, 0, 0, 2, 17
"/opt/projects/swiftkube/vendor/go.etcd.io/etcd/client/pkg/v3/fileutil/filereader.go", "Go", 51, 0, 0, 0, 0, 0, 10, 61
"/opt/projects/swiftkube/vendor/go.etcd.io/etcd/client/pkg/v3/fileutil/fileutil.go", "Go", 155, 0, 0, 0, 0, 0, 14, 169
"/opt/projects/swiftkube/vendor/go.etcd.io/etcd/client/pkg/v3/fileutil/lock.go", "Go", 22, 0, 0, 0, 0, 0, 5, 27
"/opt/projects/swiftkube/vendor/go.etcd.io/etcd/client/pkg/v3/fileutil/lock_flock.go", "Go", 45, 0, 0, 0, 0, 0, 6, 51
"/opt/projects/swiftkube/vendor/go.etcd.io/etcd/client/pkg/v3/fileutil/lock_linux.go", "Go", 79, 0, 0, 0, 0, 0, 15, 94
"/opt/projects/swiftkube/vendor/go.etcd.io/etcd/client/pkg/v3/fileutil/lock_plan9.go", "Go", 41, 0, 0, 0, 0, 0, 5, 46
"/opt/projects/swiftkube/vendor/go.etcd.io/etcd/client/pkg/v3/fileutil/lock_solaris.go", "Go", 58, 0, 0, 0, 0, 0, 6, 64
"/opt/projects/swiftkube/vendor/go.etcd.io/etcd/client/pkg/v3/fileutil/lock_unix.go", "Go", 25, 0, 0, 0, 0, 0, 6, 31
"/opt/projects/swiftkube/vendor/go.etcd.io/etcd/client/pkg/v3/fileutil/lock_windows.go", "Go", 114, 0, 0, 0, 0, 0, 13, 127
"/opt/projects/swiftkube/vendor/go.etcd.io/etcd/client/pkg/v3/fileutil/preallocate.go", "Go", 50, 0, 0, 0, 0, 0, 5, 55
"/opt/projects/swiftkube/vendor/go.etcd.io/etcd/client/pkg/v3/fileutil/preallocate_darwin.go", "Go", 58, 0, 0, 0, 0, 0, 10, 68
"/opt/projects/swiftkube/vendor/go.etcd.io/etcd/client/pkg/v3/fileutil/preallocate_unix.go", "Go", 45, 0, 0, 0, 0, 0, 6, 51
"/opt/projects/swiftkube/vendor/go.etcd.io/etcd/client/pkg/v3/fileutil/preallocate_unsupported.go", "Go", 21, 0, 0, 0, 0, 0, 6, 27
"/opt/projects/swiftkube/vendor/go.etcd.io/etcd/client/pkg/v3/fileutil/purge.go", "Go", 94, 0, 0, 0, 0, 0, 8, 102
"/opt/projects/swiftkube/vendor/go.etcd.io/etcd/client/pkg/v3/fileutil/read_dir.go", "Go", 60, 0, 0, 0, 0, 0, 11, 71
"/opt/projects/swiftkube/vendor/go.etcd.io/etcd/client/pkg/v3/fileutil/sync.go", "Go", 25, 0, 0, 0, 0, 0, 6, 31
"/opt/projects/swiftkube/vendor/go.etcd.io/etcd/client/pkg/v3/fileutil/sync_darwin.go", "Go", 33, 0, 0, 0, 0, 0, 7, 40
"/opt/projects/swiftkube/vendor/go.etcd.io/etcd/client/pkg/v3/fileutil/sync_linux.go", "Go", 30, 0, 0, 0, 0, 0, 6, 36
"/opt/projects/swiftkube/vendor/go.etcd.io/etcd/client/pkg/v3/logutil/doc.go", "Go", 15, 0, 0, 0, 0, 0, 2, 17
"/opt/projects/swiftkube/vendor/go.etcd.io/etcd/client/pkg/v3/logutil/log_level.go", "Go", 26, 0, 0, 0, 0, 0, 5, 31
"/opt/projects/swiftkube/vendor/go.etcd.io/etcd/client/pkg/v3/logutil/zap.go", "Go", 94, 0, 0, 0, 0, 0, 15, 109
"/opt/projects/swiftkube/vendor/go.etcd.io/etcd/client/pkg/v3/logutil/zap_journal.go", "Go", 79, 0, 0, 0, 0, 0, 15, 94
"/opt/projects/swiftkube/vendor/go.etcd.io/etcd/client/pkg/v3/systemd/doc.go", "Go", 15, 0, 0, 0, 0, 0, 2, 17
"/opt/projects/swiftkube/vendor/go.etcd.io/etcd/client/pkg/v3/systemd/journal.go", "Go", 26, 0, 0, 0, 0, 0, 4, 30
"/opt/projects/swiftkube/vendor/go.etcd.io/etcd/client/pkg/v3/tlsutil/cipher_suites.go", "Go", 51, 0, 0, 0, 0, 0, 6, 57
"/opt/projects/swiftkube/vendor/go.etcd.io/etcd/client/pkg/v3/tlsutil/doc.go", "Go", 15, 0, 0, 0, 0, 0, 2, 17
"/opt/projects/swiftkube/vendor/go.etcd.io/etcd/client/pkg/v3/tlsutil/tlsutil.go", "Go", 62, 0, 0, 0, 0, 0, 12, 74
"/opt/projects/swiftkube/vendor/go.etcd.io/etcd/client/pkg/v3/tlsutil/versions.go", "Go", 40, 0, 0, 0, 0, 0, 8, 48
"/opt/projects/swiftkube/vendor/go.etcd.io/etcd/client/pkg/v3/transport/doc.go", "Go", 16, 0, 0, 0, 0, 0, 2, 18
"/opt/projects/swiftkube/vendor/go.etcd.io/etcd/client/pkg/v3/transport/keepalive_listener.go", "Go", 106, 0, 0, 0, 0, 0, 16, 122
"/opt/projects/swiftkube/vendor/go.etcd.io/etcd/client/pkg/v3/transport/limit_listen.go", "Go", 75, 0, 0, 0, 0, 0, 12, 87
"/opt/projects/swiftkube/vendor/go.etcd.io/etcd/client/pkg/v3/transport/listener.go", "Go", 532, 0, 0, 0, 0, 0, 63, 595
"/opt/projects/swiftkube/vendor/go.etcd.io/etcd/client/pkg/v3/transport/listener_opts.go", "Go", 63, 0, 0, 0, 0, 0, 14, 77
"/opt/projects/swiftkube/vendor/go.etcd.io/etcd/client/pkg/v3/transport/listener_tls.go", "Go", 248, 0, 0, 0, 0, 0, 25, 273
"/opt/projects/swiftkube/vendor/go.etcd.io/etcd/client/pkg/v3/transport/sockopt.go", "Go", 39, 0, 0, 0, 0, 0, 7, 46
"/opt/projects/swiftkube/vendor/go.etcd.io/etcd/client/pkg/v3/transport/sockopt_solaris.go", "Go", 29, 0, 0, 0, 0, 0, 7, 36
"/opt/projects/swiftkube/vendor/go.etcd.io/etcd/client/pkg/v3/transport/sockopt_unix.go", "Go", 30, 0, 0, 0, 0, 0, 7, 37
"/opt/projects/swiftkube/vendor/go.etcd.io/etcd/client/pkg/v3/transport/sockopt_windows.go", "Go", 15, 0, 0, 0, 0, 0, 5, 20
"/opt/projects/swiftkube/vendor/go.etcd.io/etcd/client/pkg/v3/transport/timeout_conn.go", "Go", 39, 0, 0, 0, 0, 0, 6, 45
"/opt/projects/swiftkube/vendor/go.etcd.io/etcd/client/pkg/v3/transport/timeout_dialer.go", "Go", 32, 0, 0, 0, 0, 0, 5, 37
"/opt/projects/swiftkube/vendor/go.etcd.io/etcd/client/pkg/v3/transport/timeout_listener.go", "Go", 40, 0, 0, 0, 0, 0, 6, 46
"/opt/projects/swiftkube/vendor/go.etcd.io/etcd/client/pkg/v3/transport/timeout_transport.go", "Go", 46, 0, 0, 0, 0, 0, 6, 52
"/opt/projects/swiftkube/vendor/go.etcd.io/etcd/client/pkg/v3/transport/tls.go", "Go", 46, 0, 0, 0, 0, 0, 4, 50
"/opt/projects/swiftkube/vendor/go.etcd.io/etcd/client/pkg/v3/transport/transport.go", "Go", 67, 0, 0, 0, 0, 0, 11, 78
"/opt/projects/swiftkube/vendor/go.etcd.io/etcd/client/pkg/v3/transport/unix_listener.go", "Go", 35, 0, 0, 0, 0, 0, 6, 41
"/opt/projects/swiftkube/vendor/go.etcd.io/etcd/client/pkg/v3/types/doc.go", "Go", 16, 0, 0, 0, 0, 0, 2, 18
"/opt/projects/swiftkube/vendor/go.etcd.io/etcd/client/pkg/v3/types/id.go", "Go", 32, 0, 0, 0, 0, 0, 8, 40
"/opt/projects/swiftkube/vendor/go.etcd.io/etcd/client/pkg/v3/types/set.go", "Go", 166, 0, 0, 0, 0, 0, 30, 196
"/opt/projects/swiftkube/vendor/go.etcd.io/etcd/client/pkg/v3/types/slice.go", "Go", 19, 0, 0, 0, 0, 0, 4, 23
"/opt/projects/swiftkube/vendor/go.etcd.io/etcd/client/pkg/v3/types/urls.go", "Go", 72, 0, 0, 0, 0, 0, 11, 83
"/opt/projects/swiftkube/vendor/go.etcd.io/etcd/client/pkg/v3/types/urlsmap.go", "Go", 97, 0, 0, 0, 0, 0, 11, 108
"/opt/projects/swiftkube/vendor/go.etcd.io/etcd/client/v3/auth.go", "Go", 189, 0, 0, 0, 0, 0, 48, 237
"/opt/projects/swiftkube/vendor/go.etcd.io/etcd/client/v3/client.go", "Go", 543, 0, 0, 0, 0, 0, 69, 612
"/opt/projects/swiftkube/vendor/go.etcd.io/etcd/client/v3/cluster.go", "Go", 118, 0, 0, 0, 0, 0, 24, 142
"/opt/projects/swiftkube/vendor/go.etcd.io/etcd/client/v3/compact_op.go", "Go", 43, 0, 0, 0, 0, 0, 9, 52
"/opt/projects/swiftkube/vendor/go.etcd.io/etcd/client/v3/compare.go", "Go", 119, 0, 0, 0, 0, 0, 22, 141
"/opt/projects/swiftkube/vendor/go.etcd.io/etcd/client/v3/config.go", "Go", 72, 0, 0, 0, 0, 0, 21, 93
"/opt/projects/swiftkube/vendor/go.etcd.io/etcd/client/v3/credentials/credentials.go", "Go", 108, 0, 0, 0, 0, 0, 24, 132
"/opt/projects/swiftkube/vendor/go.etcd.io/etcd/client/v3/ctx.go", "Go", 45, 0, 0, 0, 0, 0, 6, 51
"/opt/projects/swiftkube/vendor/go.etcd.io/etcd/client/v3/doc.go", "Go", 105, 0, 0, 0, 0, 0, 2, 107
"/opt/projects/swiftkube/vendor/go.etcd.io/etcd/client/v3/internal/endpoint/endpoint.go", "Go", 126, 0, 0, 0, 0, 0, 13, 139
"/opt/projects/swiftkube/vendor/go.etcd.io/etcd/client/v3/internal/resolver/resolver.go", "Go", 66, 0, 0, 0, 0, 0, 9, 75
"/opt/projects/swiftkube/vendor/go.etcd.io/etcd/client/v3/kv.go", "Go", 154, 0, 0, 0, 0, 0, 24, 178
"/opt/projects/swiftkube/vendor/go.etcd.io/etcd/client/v3/lease.go", "Go", 526, 0, 0, 0, 0, 0, 80, 606
"/opt/projects/swiftkube/vendor/go.etcd.io/etcd/client/v3/logger.go", "Go", 53, 0, 0, 0, 0, 0, 7, 60
"/opt/projects/swiftkube/vendor/go.etcd.io/etcd/client/v3/maintenance.go", "Go", 225, 0, 0, 0, 0, 0, 31, 256
"/opt/projects/swiftkube/vendor/go.etcd.io/etcd/client/v3/op.go", "Go", 495, 0, 0, 0, 0, 0, 89, 584
"/opt/projects/swiftkube/vendor/go.etcd.io/etcd/client/v3/options.go", "Go", 57, 0, 0, 0, 0, 0, 13, 70
"/opt/projects/swiftkube/vendor/go.etcd.io/etcd/client/v3/retry.go", "Go", 248, 0, 0, 0, 0, 0, 59, 307
"/opt/projects/swiftkube/vendor/go.etcd.io/etcd/client/v3/retry_interceptor.go", "Go", 397, 0, 0, 0, 0, 0, 37, 434
"/opt/projects/swiftkube/vendor/go.etcd.io/etcd/client/v3/sort.go", "Go", 32, 0, 0, 0, 0, 0, 6, 38
"/opt/projects/swiftkube/vendor/go.etcd.io/etcd/client/v3/txn.go", "Go", 116, 0, 0, 0, 0, 0, 35, 151
"/opt/projects/swiftkube/vendor/go.etcd.io/etcd/client/v3/utils.go", "Go", 28, 0, 0, 0, 0, 0, 4, 32
"/opt/projects/swiftkube/vendor/go.etcd.io/etcd/client/v3/watch.go", "Go", 924, 0, 0, 0, 0, 0, 119, 1043
"/opt/projects/swiftkube/vendor/go.opencensus.io/internal/internal.go", "Go", 32, 0, 0, 0, 0, 0, 6, 38
"/opt/projects/swiftkube/vendor/go.opencensus.io/internal/sanitize.go", "Go", 45, 0, 0, 0, 0, 0, 6, 51
"/opt/projects/swiftkube/vendor/go.opencensus.io/internal/tagencoding/tagencoding.go", "Go", 65, 0, 0, 0, 0, 0, 11, 76
"/opt/projects/swiftkube/vendor/go.opencensus.io/internal/traceinternals.go", "Go", 45, 0, 0, 0, 0, 0, 9, 54
"/opt/projects/swiftkube/vendor/go.opencensus.io/metric/metricdata/doc.go", "Go", 18, 0, 0, 0, 0, 0, 2, 20
"/opt/projects/swiftkube/vendor/go.opencensus.io/metric/metricdata/exemplar.go", "Go", 33, 0, 0, 0, 0, 0, 6, 39
"/opt/projects/swiftkube/vendor/go.opencensus.io/metric/metricdata/label.go", "Go", 31, 0, 0, 0, 0, 0, 5, 36
"/opt/projects/swiftkube/vendor/go.opencensus.io/metric/metricdata/metric.go", "Go", 40, 0, 0, 0, 0, 0, 7, 47
"/opt/projects/swiftkube/vendor/go.opencensus.io/metric/metricdata/point.go", "Go", 175, 0, 0, 0, 0, 0, 19, 194
"/opt/projects/swiftkube/vendor/go.opencensus.io/metric/metricdata/type_string.go", "Go", 11, 0, 0, 0, 0, 0, 6, 17
"/opt/projects/swiftkube/vendor/go.opencensus.io/metric/metricdata/unit.go", "Go", 24, 0, 0, 0, 0, 0, 4, 28
"/opt/projects/swiftkube/vendor/go.opencensus.io/metric/metricproducer/manager.go", "Go", 70, 0, 0, 0, 0, 0, 9, 79
"/opt/projects/swiftkube/vendor/go.opencensus.io/metric/metricproducer/producer.go", "Go", 25, 0, 0, 0, 0, 0, 4, 29
"/opt/projects/swiftkube/vendor/go.opencensus.io/opencensus.go", "Go", 19, 0, 0, 0, 0, 0, 3, 22
"/opt/projects/swiftkube/vendor/go.opencensus.io/plugin/ochttp/client.go", "Go", 102, 0, 0, 0, 0, 0, 16, 118
"/opt/projects/swiftkube/vendor/go.opencensus.io/plugin/ochttp/client_stats.go", "Go", 129, 0, 0, 0, 0, 0, 15, 144
"/opt/projects/swiftkube/vendor/go.opencensus.io/plugin/ochttp/doc.go", "Go", 18, 0, 0, 0, 0, 0, 2, 20
"/opt/projects/swiftkube/vendor/go.opencensus.io/plugin/ochttp/propagation/b3/b3.go", "Go", 110, 0, 0, 0, 0, 0, 14, 124
"/opt/projects/swiftkube/vendor/go.opencensus.io/plugin/ochttp/route.go", "Go", 52, 0, 0, 0, 0, 0, 10, 62
"/opt/projects/swiftkube/vendor/go.opencensus.io/plugin/ochttp/server.go", "Go", 429, 0, 0, 0, 0, 0, 27, 456
"/opt/projects/swiftkube/vendor/go.opencensus.io/plugin/ochttp/span_annotating_client_trace.go", "Go", 147, 0, 0, 0, 0, 0, 23, 170
"/opt/projects/swiftkube/vendor/go.opencensus.io/plugin/ochttp/stats.go", "Go", 262, 0, 0, 0, 0, 0, 31, 293
"/opt/projects/swiftkube/vendor/go.opencensus.io/plugin/ochttp/trace.go", "Go", 214, 0, 0, 0, 0, 0, 31, 245
"/opt/projects/swiftkube/vendor/go.opencensus.io/plugin/ochttp/wrapped_body.go", "Go", 40, 0, 0, 0, 0, 0, 5, 45
"/opt/projects/swiftkube/vendor/go.opencensus.io/resource/resource.go", "Go", 148, 0, 0, 0, 0, 0, 17, 165
"/opt/projects/swiftkube/vendor/go.opencensus.io/stats/doc.go", "Go", 53, 0, 0, 0, 0, 0, 16, 69
"/opt/projects/swiftkube/vendor/go.opencensus.io/stats/internal/record.go", "Go", 26, 0, 0, 0, 0, 0, 6, 32
"/opt/projects/swiftkube/vendor/go.opencensus.io/stats/measure.go", "Go", 94, 0, 0, 0, 0, 0, 16, 110
"/opt/projects/swiftkube/vendor/go.opencensus.io/stats/measure_float64.go", "Go", 48, 0, 0, 0, 0, 0, 8, 56
"/opt/projects/swiftkube/vendor/go.opencensus.io/stats/measure_int64.go", "Go", 48, 0, 0, 0, 0, 0, 8, 56
"/opt/projects/swiftkube/vendor/go.opencensus.io/stats/record.go", "Go", 140, 0, 0, 0, 0, 0, 17, 157
"/opt/projects/swiftkube/vendor/go.opencensus.io/stats/units.go", "Go", 24, 0, 0, 0, 0, 0, 3, 27
"/opt/projects/swiftkube/vendor/go.opencensus.io/stats/view/aggregation.go", "Go", 110, 0, 0, 0, 0, 0, 14, 124
"/opt/projects/swiftkube/vendor/go.opencensus.io/stats/view/aggregation_data.go", "Go", 292, 0, 0, 0, 0, 0, 45, 337
"/opt/projects/swiftkube/vendor/go.opencensus.io/stats/view/collector.go", "Go", 84, 0, 0, 0, 0, 0, 10, 94
"/opt/projects/swiftkube/vendor/go.opencensus.io/stats/view/doc.go", "Go", 45, 0, 0, 0, 0, 0, 3, 48
"/opt/projects/swiftkube/vendor/go.opencensus.io/stats/view/export.go", "Go", 41, 0, 0, 0, 0, 0, 5, 46
"/opt/projects/swiftkube/vendor/go.opencensus.io/stats/view/view.go", "Go", 193, 0, 0, 0, 0, 0, 29, 222
"/opt/projects/swiftkube/vendor/go.opencensus.io/stats/view/view_to_metric.go", "Go", 131, 0, 0, 0, 0, 0, 17, 148
"/opt/projects/swiftkube/vendor/go.opencensus.io/stats/view/worker.go", "Go", 373, 0, 0, 0, 0, 0, 52, 425
"/opt/projects/swiftkube/vendor/go.opencensus.io/stats/view/worker_commands.go", "Go", 165, 0, 0, 0, 0, 0, 22, 187
"/opt/projects/swiftkube/vendor/go.opencensus.io/tag/context.go", "Go", 37, 0, 0, 0, 0, 0, 7, 44
"/opt/projects/swiftkube/vendor/go.opencensus.io/tag/doc.go", "Go", 23, 0, 0, 0, 0, 0, 4, 27
"/opt/projects/swiftkube/vendor/go.opencensus.io/tag/key.go", "Go", 39, 0, 0, 0, 0, 0, 6, 45
"/opt/projects/swiftkube/vendor/go.opencensus.io/tag/map.go", "Go", 205, 0, 0, 0, 0, 0, 25, 230
"/opt/projects/swiftkube/vendor/go.opencensus.io/tag/map_codec.go", "Go", 203, 0, 0, 0, 0, 0, 37, 240
"/opt/projects/swiftkube/vendor/go.opencensus.io/tag/metadata.go", "Go", 43, 0, 0, 0, 0, 0, 10, 53
"/opt/projects/swiftkube/vendor/go.opencensus.io/tag/profile_19.go", "Go", 28, 0, 0, 0, 0, 0, 5, 33
"/opt/projects/swiftkube/vendor/go.opencensus.io/tag/profile_not19.go", "Go", 20, 0, 0, 0, 0, 0, 5, 25
"/opt/projects/swiftkube/vendor/go.opencensus.io/tag/validate.go", "Go", 48, 0, 0, 0, 0, 0, 9, 57
"/opt/projects/swiftkube/vendor/go.opencensus.io/trace/basetypes.go", "Go", 108, 0, 0, 0, 0, 0, 22, 130
"/opt/projects/swiftkube/vendor/go.opencensus.io/trace/config.go", "Go", 71, 0, 0, 0, 0, 0, 16, 87
"/opt/projects/swiftkube/vendor/go.opencensus.io/trace/doc.go", "Go", 39, 0, 0, 0, 0, 0, 14, 53
"/opt/projects/swiftkube/vendor/go.opencensus.io/trace/evictedqueue.go", "Go", 33, 0, 0, 0, 0, 0, 6, 39
"/opt/projects/swiftkube/vendor/go.opencensus.io/trace/export.go", "Go", 88, 0, 0, 0, 0, 0, 10, 98
"/opt/projects/swiftkube/vendor/go.opencensus.io/trace/internal/internal.go", "Go", 20, 0, 0, 0, 0, 0, 3, 23
"/opt/projects/swiftkube/vendor/go.opencensus.io/trace/lrumap.go", "Go", 53, 0, 0, 0, 0, 0, 9, 62
"/opt/projects/swiftkube/vendor/go.opencensus.io/trace/propagation/propagation.go", "Go", 99, 0, 0, 0, 0, 0, 10, 109
"/opt/projects/swiftkube/vendor/go.opencensus.io/trace/sampling.go", "Go", 65, 0, 0, 0, 0, 0, 11, 76
"/opt/projects/swiftkube/vendor/go.opencensus.io/trace/spanbucket.go", "Go", 118, 0, 0, 0, 0, 0, 13, 131
"/opt/projects/swiftkube/vendor/go.opencensus.io/trace/spanstore.go", "Go", 287, 0, 0, 0, 0, 0, 22, 309
"/opt/projects/swiftkube/vendor/go.opencensus.io/trace/status_codes.go", "Go", 35, 0, 0, 0, 0, 0, 3, 38
"/opt/projects/swiftkube/vendor/go.opencensus.io/trace/trace.go", "Go", 529, 0, 0, 0, 0, 0, 67, 596
"/opt/projects/swiftkube/vendor/go.opencensus.io/trace/trace_api.go", "Go", 225, 0, 0, 0, 0, 0, 41, 266
"/opt/projects/swiftkube/vendor/go.opencensus.io/trace/trace_go11.go", "Go", 29, 0, 0, 0, 0, 0, 5, 34
"/opt/projects/swiftkube/vendor/go.opencensus.io/trace/trace_nongo11.go", "Go", 22, 0, 0, 0, 0, 0, 5, 27
"/opt/projects/swiftkube/vendor/go.opencensus.io/trace/tracestate/tracestate.go", "Go", 128, 0, 0, 0, 0, 0, 20, 148
"/opt/projects/swiftkube/vendor/go.opentelemetry.io/contrib/instrumentation/github.com/emicklei/go-restful/otelrestful/config.go", "Go", 50, 0, 0, 0, 0, 0, 9, 59
"/opt/projects/swiftkube/vendor/go.opentelemetry.io/contrib/instrumentation/github.com/emicklei/go-restful/otelrestful/doc.go", "Go", 24, 0, 0, 0, 0, 0, 2, 26
"/opt/projects/swiftkube/vendor/go.opentelemetry.io/contrib/instrumentation/github.com/emicklei/go-restful/otelrestful/restful.go", "Go", 63, 0, 0, 0, 0, 0, 10, 73
"/opt/projects/swiftkube/vendor/go.opentelemetry.io/contrib/instrumentation/github.com/emicklei/go-restful/otelrestful/version.go", "Go", 23, 0, 0, 0, 0, 0, 4, 27
"/opt/projects/swiftkube/vendor/go.opentelemetry.io/contrib/instrumentation/google.golang.org/grpc/otelgrpc/grpctrace.go", "Go", 135, 0, 0, 0, 0, 0, 29, 164
"/opt/projects/swiftkube/vendor/go.opentelemetry.io/contrib/instrumentation/google.golang.org/grpc/otelgrpc/interceptor.go", "Go", 415, 0, 0, 0, 0, 0, 86, 501
"/opt/projects/swiftkube/vendor/go.opentelemetry.io/contrib/instrumentation/google.golang.org/grpc/otelgrpc/interceptorinfo.go", "Go", 45, 0, 0, 0, 0, 0, 6, 51
"/opt/projects/swiftkube/vendor/go.opentelemetry.io/contrib/instrumentation/google.golang.org/grpc/otelgrpc/internal/parse.go", "Go", 38, 0, 0, 0, 0, 0, 6, 44
"/opt/projects/swiftkube/vendor/go.opentelemetry.io/contrib/instrumentation/google.golang.org/grpc/otelgrpc/semconv.go", "Go", 42, 0, 0, 0, 0, 0, 11, 53
"/opt/projects/swiftkube/vendor/go.opentelemetry.io/contrib/instrumentation/google.golang.org/grpc/otelgrpc/version.go", "Go", 23, 0, 0, 0, 0, 0, 4, 27
"/opt/projects/swiftkube/vendor/go.opentelemetry.io/contrib/instrumentation/net/http/otelhttp/client.go", "Go", 54, 0, 0, 0, 0, 0, 8, 62
"/opt/projects/swiftkube/vendor/go.opentelemetry.io/contrib/instrumentation/net/http/otelhttp/common.go", "Go", 39, 0, 0, 0, 0, 0, 8, 47
"/opt/projects/swiftkube/vendor/go.opentelemetry.io/contrib/instrumentation/net/http/otelhttp/config.go", "Go", 175, 0, 0, 0, 0, 0, 26, 201
"/opt/projects/swiftkube/vendor/go.opentelemetry.io/contrib/instrumentation/net/http/otelhttp/doc.go", "Go", 17, 0, 0, 0, 0, 0, 2, 19
"/opt/projects/swiftkube/vendor/go.opentelemetry.io/contrib/instrumentation/net/http/otelhttp/handler.go", "Go", 211, 0, 0, 0, 0, 0, 41, 252
"/opt/projects/swiftkube/vendor/go.opentelemetry.io/contrib/instrumentation/net/http/otelhttp/labeler.go", "Go", 55, 0, 0, 0, 0, 0, 11, 66
"/opt/projects/swiftkube/vendor/go.opentelemetry.io/contrib/instrumentation/net/http/otelhttp/transport.go", "Go", 162, 0, 0, 0, 0, 0, 32, 194
"/opt/projects/swiftkube/vendor/go.opentelemetry.io/contrib/instrumentation/net/http/otelhttp/version.go", "Go", 23, 0, 0, 0, 0, 0, 4, 27
"/opt/projects/swiftkube/vendor/go.opentelemetry.io/contrib/instrumentation/net/http/otelhttp/wrap.go", "Go", 79, 0, 0, 0, 0, 0, 17, 96
"/opt/projects/swiftkube/vendor/go.opentelemetry.io/otel/attribute/doc.go", "Go", 15, 0, 0, 0, 0, 0, 2, 17
"/opt/projects/swiftkube/vendor/go.opentelemetry.io/otel/attribute/encoder.go", "Go", 127, 0, 0, 0, 0, 0, 20, 147
"/opt/projects/swiftkube/vendor/go.opentelemetry.io/otel/attribute/iterator.go", "Go", 144, 0, 0, 0, 0, 0, 18, 162
"/opt/projects/swiftkube/vendor/go.opentelemetry.io/otel/attribute/key.go", "Go", 121, 0, 0, 0, 0, 0, 14, 135
"/opt/projects/swiftkube/vendor/go.opentelemetry.io/otel/attribute/kv.go", "Go", 71, 0, 0, 0, 0, 0, 16, 87
"/opt/projects/swiftkube/vendor/go.opentelemetry.io/otel/attribute/set.go", "Go", 376, 0, 0, 0, 0, 0, 49, 425
"/opt/projects/swiftkube/vendor/go.opentelemetry.io/otel/attribute/type_string.go", "Go", 25, 0, 0, 0, 0, 0, 7, 32
"/opt/projects/swiftkube/vendor/go.opentelemetry.io/otel/attribute/value.go", "Go", 241, 0, 0, 0, 0, 0, 31, 272
"/opt/projects/swiftkube/vendor/go.opentelemetry.io/otel/baggage/baggage.go", "Go", 485, 0, 0, 0, 0, 0, 78, 563
"/opt/projects/swiftkube/vendor/go.opentelemetry.io/otel/baggage/context.go", "Go", 33, 0, 0, 0, 0, 0, 7, 40
"/opt/projects/swiftkube/vendor/go.opentelemetry.io/otel/baggage/doc.go", "Go", 19, 0, 0, 0, 0, 0, 2, 21
"/opt/projects/swiftkube/vendor/go.opentelemetry.io/otel/codes/codes.go", "Go", 94, 0, 0, 0, 0, 0, 13, 107
"/opt/projects/swiftkube/vendor/go.opentelemetry.io/otel/codes/doc.go", "Go", 19, 0, 0, 0, 0, 0, 3, 22
"/opt/projects/swiftkube/vendor/go.opentelemetry.io/otel/doc.go", "Go", 28, 0, 0, 0, 0, 0, 7, 35
"/opt/projects/swiftkube/vendor/go.opentelemetry.io/otel/error_handler.go", "Go", 32, 0, 0, 0, 0, 0, 7, 39
"/opt/projects/swiftkube/vendor/go.opentelemetry.io/otel/exporters/otlp/internal/config.go", "Go", 31, 0, 0, 0, 0, 0, 4, 35
"/opt/projects/swiftkube/vendor/go.opentelemetry.io/otel/exporters/otlp/internal/envconfig/envconfig.go", "Go", 130, 0, 0, 0, 0, 0, 19, 149
"/opt/projects/swiftkube/vendor/go.opentelemetry.io/otel/exporters/otlp/internal/partialsuccess.go", "Go", 58, 0, 0, 0, 0, 0, 11, 69
"/opt/projects/swiftkube/vendor/go.opentelemetry.io/otel/exporters/otlp/internal/retry/retry.go", "Go", 132, 0, 0, 0, 0, 0, 19, 151
"/opt/projects/swiftkube/vendor/go.opentelemetry.io/otel/exporters/otlp/otlptrace/clients.go", "Go", 47, 0, 0, 0, 0, 0, 8, 55
"/opt/projects/swiftkube/vendor/go.opentelemetry.io/otel/exporters/otlp/otlptrace/exporter.go", "Go", 93, 0, 0, 0, 0, 0, 21, 114
"/opt/projects/swiftkube/vendor/go.opentelemetry.io/otel/exporters/otlp/otlptrace/internal/otlpconfig/envconfig.go", "Go", 114, 0, 0, 0, 0, 0, 14, 128
"/opt/projects/swiftkube/vendor/go.opentelemetry.io/otel/exporters/otlp/otlptrace/internal/otlpconfig/options.go", "Go", 259, 0, 0, 0, 0, 0, 49, 308
"/opt/projects/swiftkube/vendor/go.opentelemetry.io/otel/exporters/otlp/otlptrace/internal/otlpconfig/optiontypes.go", "Go", 42, 0, 0, 0, 0, 0, 7, 49
"/opt/projects/swiftkube/vendor/go.opentelemetry.io/otel/exporters/otlp/otlptrace/internal/otlpconfig/tls.go", "Go", 30, 0, 0, 0, 0, 0, 5, 35
"/opt/projects/swiftkube/vendor/go.opentelemetry.io/otel/exporters/otlp/otlptrace/internal/tracetransform/attribute.go", "Go", 145, 0, 0, 0, 0, 0, 14, 159
"/opt/projects/swiftkube/vendor/go.opentelemetry.io/otel/exporters/otlp/otlptrace/internal/tracetransform/instrumentation.go", "Go", 27, 0, 0, 0, 0, 0, 4, 31
"/opt/projects/swiftkube/vendor/go.opentelemetry.io/otel/exporters/otlp/otlptrace/internal/tracetransform/resource.go", "Go", 25, 0, 0, 0, 0, 0, 4, 29
"/opt/projects/swiftkube/vendor/go.opentelemetry.io/otel/exporters/otlp/otlptrace/internal/tracetransform/span.go", "Go", 182, 0, 0, 0, 0, 0, 24, 206
"/opt/projects/swiftkube/vendor/go.opentelemetry.io/otel/exporters/otlp/otlptrace/otlptracegrpc/client.go", "Go", 258, 0, 0, 0, 0, 0, 38, 296
"/opt/projects/swiftkube/vendor/go.opentelemetry.io/otel/exporters/otlp/otlptrace/otlptracegrpc/exporter.go", "Go", 26, 0, 0, 0, 0, 0, 6, 32
"/opt/projects/swiftkube/vendor/go.opentelemetry.io/otel/exporters/otlp/otlptrace/otlptracegrpc/options.go", "Go", 167, 0, 0, 0, 0, 0, 23, 190
"/opt/projects/swiftkube/vendor/go.opentelemetry.io/otel/handler.go", "Go", 84, 0, 0, 0, 0, 0, 14, 98
"/opt/projects/swiftkube/vendor/go.opentelemetry.io/otel/internal/baggage/baggage.go", "Go", 38, 0, 0, 0, 0, 0, 6, 44
"/opt/projects/swiftkube/vendor/go.opentelemetry.io/otel/internal/baggage/context.go", "Go", 76, 0, 0, 0, 0, 0, 17, 93
"/opt/projects/swiftkube/vendor/go.opentelemetry.io/otel/internal/global/internal_logging.go", "Go", 55, 0, 0, 0, 0, 0, 9, 64
"/opt/projects/swiftkube/vendor/go.opentelemetry.io/otel/internal/global/propagator.go", "Go", 70, 0, 0, 0, 0, 0, 13, 83
"/opt/projects/swiftkube/vendor/go.opentelemetry.io/otel/internal/global/state.go", "Go", 98, 0, 0, 0, 0, 0, 18, 116
"/opt/projects/swiftkube/vendor/go.opentelemetry.io/otel/internal/global/trace.go", "Go", 153, 0, 0, 0, 0, 0, 40, 193
"/opt/projects/swiftkube/vendor/go.opentelemetry.io/otel/internal/rawhelpers.go", "Go", 45, 0, 0, 0, 0, 0, 11, 56
"/opt/projects/swiftkube/vendor/go.opentelemetry.io/otel/internal_logging.go", "Go", 22, 0, 0, 0, 0, 0, 5, 27
"/opt/projects/swiftkube/vendor/go.opentelemetry.io/otel/metric/config.go", "Go", 59, 0, 0, 0, 0, 0, 11, 70
"/opt/projects/swiftkube/vendor/go.opentelemetry.io/otel/metric/doc.go", "Go", 21, 0, 0, 0, 0, 0, 3, 24
"/opt/projects/swiftkube/vendor/go.opentelemetry.io/otel/metric/global/global.go", "Go", 37, 0, 0, 0, 0, 0, 6, 43
"/opt/projects/swiftkube/vendor/go.opentelemetry.io/otel/metric/instrument/asyncfloat64/asyncfloat64.go", "Go", 58, 0, 0, 0, 0, 0, 13, 71
"/opt/projects/swiftkube/vendor/go.opentelemetry.io/otel/metric/instrument/asyncint64/asyncint64.go", "Go", 58, 0, 0, 0, 0, 0, 13, 71
"/opt/projects/swiftkube/vendor/go.opentelemetry.io/otel/metric/instrument/config.go", "Go", 58, 0, 0, 0, 0, 0, 12, 70
"/opt/projects/swiftkube/vendor/go.opentelemetry.io/otel/metric/instrument/instrument.go", "Go", 27, 0, 0, 0, 0, 0, 4, 31
"/opt/projects/swiftkube/vendor/go.opentelemetry.io/otel/metric/instrument/syncfloat64/syncfloat64.go", "Go", 46, 0, 0, 0, 0, 0, 11, 57
"/opt/projects/swiftkube/vendor/go.opentelemetry.io/otel/metric/instrument/syncint64/syncint64.go", "Go", 46, 0, 0, 0, 0, 0, 11, 57
"/opt/projects/swiftkube/vendor/go.opentelemetry.io/otel/metric/internal/global/instruments.go", "Go", 291, 0, 0, 0, 0, 0, 70, 361
"/opt/projects/swiftkube/vendor/go.opentelemetry.io/otel/metric/internal/global/meter.go", "Go", 291, 0, 0, 0, 0, 0, 57, 348
"/opt/projects/swiftkube/vendor/go.opentelemetry.io/otel/metric/internal/global/state.go", "Go", 58, 0, 0, 0, 0, 0, 11, 69
"/opt/projects/swiftkube/vendor/go.opentelemetry.io/otel/metric/meter.go", "Go", 52, 0, 0, 0, 0, 0, 9, 61
"/opt/projects/swiftkube/vendor/go.opentelemetry.io/otel/metric/noop.go", "Go", 140, 0, 0, 0, 0, 0, 42, 182
"/opt/projects/swiftkube/vendor/go.opentelemetry.io/otel/metric/unit/doc.go", "Go", 19, 0, 0, 0, 0, 0, 2, 21
"/opt/projects/swiftkube/vendor/go.opentelemetry.io/otel/metric/unit/unit.go", "Go", 22, 0, 0, 0, 0, 0, 4, 26
"/opt/projects/swiftkube/vendor/go.opentelemetry.io/otel/propagation.go", "Go", 27, 0, 0, 0, 0, 0, 5, 32
"/opt/projects/swiftkube/vendor/go.opentelemetry.io/otel/propagation/baggage.go", "Go", 48, 0, 0, 0, 0, 0, 11, 59
"/opt/projects/swiftkube/vendor/go.opentelemetry.io/otel/propagation/doc.go", "Go", 22, 0, 0, 0, 0, 0, 3, 25
"/opt/projects/swiftkube/vendor/go.opentelemetry.io/otel/propagation/propagation.go", "Go", 128, 0, 0, 0, 0, 0, 26, 154
"/opt/projects/swiftkube/vendor/go.opentelemetry.io/otel/propagation/trace_context.go", "Go", 133, 0, 0, 0, 0, 0, 27, 160
"/opt/projects/swiftkube/vendor/go.opentelemetry.io/otel/sdk/instrumentation/doc.go", "Go", 23, 0, 0, 0, 0, 0, 2, 25
"/opt/projects/swiftkube/vendor/go.opentelemetry.io/otel/sdk/instrumentation/library.go", "Go", 17, 0, 0, 0, 0, 0, 3, 20
"/opt/projects/swiftkube/vendor/go.opentelemetry.io/otel/sdk/instrumentation/scope.go", "Go", 24, 0, 0, 0, 0, 0, 3, 27
"/opt/projects/swiftkube/vendor/go.opentelemetry.io/otel/sdk/internal/env/env.go", "Go", 148, 0, 0, 0, 0, 0, 30, 178
"/opt/projects/swiftkube/vendor/go.opentelemetry.io/otel/sdk/internal/internal.go", "Go", 32, 0, 0, 0, 0, 0, 6, 38
"/opt/projects/swiftkube/vendor/go.opentelemetry.io/otel/sdk/resource/auto.go", "Go", 65, 0, 0, 0, 0, 0, 8, 73
"/opt/projects/swiftkube/vendor/go.opentelemetry.io/otel/sdk/resource/builtin.go", "Go", 95, 0, 0, 0, 0, 0, 14, 109
"/opt/projects/swiftkube/vendor/go.opentelemetry.io/otel/sdk/resource/config.go", "Go", 168, 0, 0, 0, 0, 0, 32, 200
"/opt/projects/swiftkube/vendor/go.opentelemetry.io/otel/sdk/resource/container.go", "Go", 83, 0, 0, 0, 0, 0, 18, 101
"/opt/projects/swiftkube/vendor/go.opentelemetry.io/otel/sdk/resource/doc.go", "Go", 27, 0, 0, 0, 0, 0, 2, 29
"/opt/projects/swiftkube/vendor/go.opentelemetry.io/otel/sdk/resource/env.go", "Go", 82, 0, 0, 0, 0, 0, 18, 100
"/opt/projects/swiftkube/vendor/go.opentelemetry.io/otel/sdk/resource/os.go", "Go", 78, 0, 0, 0, 0, 0, 20, 98
"/opt/projects/swiftkube/vendor/go.opentelemetry.io/otel/sdk/resource/os_release_darwin.go", "Go", 85, 0, 0, 0, 0, 0, 18, 103
"/opt/projects/swiftkube/vendor/go.opentelemetry.io/otel/sdk/resource/os_release_unix.go", "Go", 126, 0, 0, 0, 0, 0, 29, 155
"/opt/projects/swiftkube/vendor/go.opentelemetry.io/otel/sdk/resource/os_unix.go", "Go", 73, 0, 0, 0, 0, 0, 18, 91
"/opt/projects/swiftkube/vendor/go.opentelemetry.io/otel/sdk/resource/os_unsupported.go", "Go", 31, 0, 0, 0, 0, 0, 4, 35
"/opt/projects/swiftkube/vendor/go.opentelemetry.io/otel/sdk/resource/os_windows.go", "Go", 81, 0, 0, 0, 0, 0, 21, 102
"/opt/projects/swiftkube/vendor/go.opentelemetry.io/otel/sdk/resource/process.go", "Go", 155, 0, 0, 0, 0, 0, 26, 181
"/opt/projects/swiftkube/vendor/go.opentelemetry.io/otel/sdk/resource/resource.go", "Go", 250, 0, 0, 0, 0, 0, 33, 283
"/opt/projects/swiftkube/vendor/go.opentelemetry.io/otel/sdk/trace/batch_span_processor.go", "Go", 379, 0, 0, 0, 0, 0, 54, 433
"/opt/projects/swiftkube/vendor/go.opentelemetry.io/otel/sdk/trace/doc.go", "Go", 19, 0, 0, 0, 0, 0, 3, 22
"/opt/projects/swiftkube/vendor/go.opentelemetry.io/otel/sdk/trace/event.go", "Go", 30, 0, 0, 0, 0, 0, 8, 38
"/opt/projects/swiftkube/vendor/go.opentelemetry.io/otel/sdk/trace/evictedqueue.go", "Go", 39, 0, 0, 0, 0, 0, 6, 45
"/opt/projects/swiftkube/vendor/go.opentelemetry.io/otel/sdk/trace/id_generator.go", "Go", 66, 0, 0, 0, 0, 0, 12, 78
"/opt/projects/swiftkube/vendor/go.opentelemetry.io/otel/sdk/trace/link.go", "Go", 29, 0, 0, 0, 0, 0, 6, 35
"/opt/projects/swiftkube/vendor/go.opentelemetry.io/otel/sdk/trace/provider.go", "Go", 406, 0, 0, 0, 0, 0, 50, 456
"/opt/projects/swiftkube/vendor/go.opentelemetry.io/otel/sdk/trace/sampler_env.go", "Go", 93, 0, 0, 0, 0, 0, 16, 109
"/opt/projects/swiftkube/vendor/go.opentelemetry.io/otel/sdk/trace/sampling.go", "Go", 245, 0, 0, 0, 0, 0, 49, 294
"/opt/projects/swiftkube/vendor/go.opentelemetry.io/otel/sdk/trace/simple_span_processor.go", "Go", 113, 0, 0, 0, 0, 0, 16, 129
"/opt/projects/swiftkube/vendor/go.opentelemetry.io/otel/sdk/trace/snapshot.go", "Go", 121, 0, 0, 0, 0, 0, 24, 145
"/opt/projects/swiftkube/vendor/go.opentelemetry.io/otel/sdk/trace/span.go", "Go", 728, 0, 0, 0, 0, 0, 112, 840
"/opt/projects/swiftkube/vendor/go.opentelemetry.io/otel/sdk/trace/span_exporter.go", "Go", 42, 0, 0, 0, 0, 0, 6, 48
"/opt/projects/swiftkube/vendor/go.opentelemetry.io/otel/sdk/trace/span_limits.go", "Go", 110, 0, 0, 0, 0, 0, 16, 126
"/opt/projects/swiftkube/vendor/go.opentelemetry.io/otel/sdk/trace/span_processor.go", "Go", 59, 0, 0, 0, 0, 0, 9, 68
"/opt/projects/swiftkube/vendor/go.opentelemetry.io/otel/sdk/trace/tracer.go", "Go", 138, 0, 0, 0, 0, 0, 24, 162
"/opt/projects/swiftkube/vendor/go.opentelemetry.io/otel/semconv/internal/http.go", "Go", 301, 0, 0, 0, 0, 0, 36, 337
"/opt/projects/swiftkube/vendor/go.opentelemetry.io/otel/semconv/v1.12.0/doc.go", "Go", 19, 0, 0, 0, 0, 0, 2, 21
"/opt/projects/swiftkube/vendor/go.opentelemetry.io/otel/semconv/v1.12.0/exception.go", "Go", 18, 0, 0, 0, 0, 0, 3, 21
"/opt/projects/swiftkube/vendor/go.opentelemetry.io/otel/semconv/v1.12.0/http.go", "Go", 101, 0, 0, 0, 0, 0, 14, 115
"/opt/projects/swiftkube/vendor/go.opentelemetry.io/otel/semconv/v1.12.0/resource.go", "Go", 1001, 0, 0, 0, 0, 0, 42, 1043
"/opt/projects/swiftkube/vendor/go.opentelemetry.io/otel/semconv/v1.12.0/schema.go", "Go", 18, 0, 0, 0, 0, 0, 3, 21
"/opt/projects/swiftkube/vendor/go.opentelemetry.io/otel/semconv/v1.12.0/trace.go", "Go", 1643, 0, 0, 0, 0, 0, 62, 1705
"/opt/projects/swiftkube/vendor/go.opentelemetry.io/otel/trace.go", "Go", 42, 0, 0, 0, 0, 0, 6, 48
"/opt/projects/swiftkube/vendor/go.opentelemetry.io/otel/trace/config.go", "Go", 267, 0, 0, 0, 0, 0, 50, 317
"/opt/projects/swiftkube/vendor/go.opentelemetry.io/otel/trace/context.go", "Go", 52, 0, 0, 0, 0, 0, 10, 62
"/opt/projects/swiftkube/vendor/go.opentelemetry.io/otel/trace/doc.go", "Go", 56, 0, 0, 0, 0, 0, 11, 67
"/opt/projects/swiftkube/vendor/go.opentelemetry.io/otel/trace/nonrecording.go", "Go", 23, 0, 0, 0, 0, 0, 5, 28
"/opt/projects/swiftkube/vendor/go.opentelemetry.io/otel/trace/noop.go", "Go", 67, 0, 0, 0, 0, 0, 23, 90
"/opt/projects/swiftkube/vendor/go.opentelemetry.io/otel/trace/trace.go", "Go", 478, 0, 0, 0, 0, 0, 73, 551
"/opt/projects/swiftkube/vendor/go.opentelemetry.io/otel/trace/tracestate.go", "Go", 182, 0, 0, 0, 0, 0, 31, 213
"/opt/projects/swiftkube/vendor/go.opentelemetry.io/otel/version.go", "Go", 18, 0, 0, 0, 0, 0, 3, 21
"/opt/projects/swiftkube/vendor/go.opentelemetry.io/proto/otlp/collector/trace/v1/trace_service.pb.go", "Go", 332, 0, 0, 0, 0, 0, 36, 368
"/opt/projects/swiftkube/vendor/go.opentelemetry.io/proto/otlp/collector/trace/v1/trace_service.pb.gw.go", "Go", 139, 0, 0, 0, 0, 0, 29, 168
"/opt/projects/swiftkube/vendor/go.opentelemetry.io/proto/otlp/collector/trace/v1/trace_service_grpc.pb.go", "Go", 95, 0, 0, 0, 0, 0, 15, 110
"/opt/projects/swiftkube/vendor/go.opentelemetry.io/proto/otlp/common/v1/common.pb.go", "Go", 551, 0, 0, 0, 0, 0, 77, 628
"/opt/projects/swiftkube/vendor/go.opentelemetry.io/proto/otlp/resource/v1/resource.pb.go", "Go", 174, 0, 0, 0, 0, 0, 20, 194
"/opt/projects/swiftkube/vendor/go.opentelemetry.io/proto/otlp/trace/v1/trace.pb.go", "Go", 1030, 0, 0, 0, 0, 0, 111, 1141
"/opt/projects/swiftkube/vendor/go.starlark.net/internal/compile/compile.go", "Go", 1709, 0, 0, 0, 0, 0, 216, 1925
"/opt/projects/swiftkube/vendor/go.starlark.net/internal/compile/serial.go", "Go", 356, 0, 0, 0, 0, 0, 40, 396
"/opt/projects/swiftkube/vendor/go.starlark.net/internal/spell/spell.go", "Go", 102, 0, 0, 0, 0, 0, 14, 116
"/opt/projects/swiftkube/vendor/go.starlark.net/resolve/binding.go", "Go", 61, 0, 0, 0, 0, 0, 14, 75
"/opt/projects/swiftkube/vendor/go.starlark.net/resolve/resolve.go", "Go", 861, 0, 0, 0, 0, 0, 109, 970
"/opt/projects/swiftkube/vendor/go.starlark.net/starlark/debug.go", "Go", 37, 0, 0, 0, 0, 0, 6, 43
"/opt/projects/swiftkube/vendor/go.starlark.net/starlark/eval.go", "Go", 1483, 0, 0, 0, 0, 0, 166, 1649
"/opt/projects/swiftkube/vendor/go.starlark.net/starlark/hashtable.go", "Go", 345, 0, 0, 0, 0, 0, 46, 391
"/opt/projects/swiftkube/vendor/go.starlark.net/starlark/int.go", "Go", 412, 0, 0, 0, 0, 0, 41, 453
"/opt/projects/swiftkube/vendor/go.starlark.net/starlark/int_generic.go", "Go", 26, 0, 0, 0, 0, 0, 9, 35
"/opt/projects/swiftkube/vendor/go.starlark.net/starlark/int_posix64.go", "Go", 77, 0, 0, 0, 0, 0, 15, 92
"/opt/projects/swiftkube/vendor/go.starlark.net/starlark/interp.go", "Go", 617, 0, 0, 0, 0, 0, 89, 706
"/opt/projects/swiftkube/vendor/go.starlark.net/starlark/library.go", "Go", 2109, 0, 0, 0, 0, 0, 181, 2290
"/opt/projects/swiftkube/vendor/go.starlark.net/starlark/profile.go", "Go", 388, 0, 0, 0, 0, 0, 62, 450
"/opt/projects/swiftkube/vendor/go.starlark.net/starlark/unpack.go", "Go", 331, 0, 0, 0, 0, 0, 25, 356
"/opt/projects/swiftkube/vendor/go.starlark.net/starlark/value.go", "Go", 1328, 0, 0, 0, 0, 0, 173, 1501
"/opt/projects/swiftkube/vendor/go.starlark.net/starlarkstruct/module.go", "Go", 37, 0, 0, 0, 0, 0, 7, 44
"/opt/projects/swiftkube/vendor/go.starlark.net/starlarkstruct/struct.go", "Go", 253, 0, 0, 0, 0, 0, 30, 283
"/opt/projects/swiftkube/vendor/go.starlark.net/syntax/parse.go", "Go", 915, 0, 0, 0, 0, 0, 114, 1029
"/opt/projects/swiftkube/vendor/go.starlark.net/syntax/quote.go", "Go", 285, 0, 0, 0, 0, 0, 25, 310
"/opt/projects/swiftkube/vendor/go.starlark.net/syntax/scan.go", "Go", 1032, 0, 0, 0, 0, 0, 92, 1124
"/opt/projects/swiftkube/vendor/go.starlark.net/syntax/syntax.go", "Go", 448, 0, 0, 0, 0, 0, 78, 526
"/opt/projects/swiftkube/vendor/go.starlark.net/syntax/walk.go", "Go", 130, 0, 0, 0, 0, 0, 32, 162
"/opt/projects/swiftkube/vendor/go.uber.org/atomic/bool.go", "Go", 74, 0, 0, 0, 0, 0, 15, 89
"/opt/projects/swiftkube/vendor/go.uber.org/atomic/bool_ext.go", "Go", 46, 0, 0, 0, 0, 0, 8, 54
"/opt/projects/swiftkube/vendor/go.uber.org/atomic/doc.go", "Go", 22, 0, 0, 0, 0, 0, 2, 24
"/opt/projects/swiftkube/vendor/go.uber.org/atomic/duration.go", "Go", 75, 0, 0, 0, 0, 0, 15, 90
"/opt/projects/swiftkube/vendor/go.uber.org/atomic/duration_ext.go", "Go", 34, 0, 0, 0, 0, 0, 7, 41
"/opt/projects/swiftkube/vendor/go.uber.org/atomic/error.go", "Go", 52, 0, 0, 0, 0, 0, 11, 63
"/opt/projects/swiftkube/vendor/go.uber.org/atomic/error_ext.go", "Go", 33, 0, 0, 0, 0, 0, 7, 40
"/opt/projects/swiftkube/vendor/go.uber.org/atomic/float32.go", "Go", 65, 0, 0, 0, 0, 0, 13, 78
"/opt/projects/swiftkube/vendor/go.uber.org/atomic/float32_ext.go", "Go", 68, 0, 0, 0, 0, 0, 9, 77
"/opt/projects/swiftkube/vendor/go.uber.org/atomic/float64.go", "Go", 65, 0, 0, 0, 0, 0, 13, 78
"/opt/projects/swiftkube/vendor/go.uber.org/atomic/float64_ext.go", "Go", 68, 0, 0, 0, 0, 0, 9, 77
"/opt/projects/swiftkube/vendor/go.uber.org/atomic/gen.go", "Go", 25, 0, 0, 0, 0, 0, 3, 28
"/opt/projects/swiftkube/vendor/go.uber.org/atomic/int32.go", "Go", 91, 0, 0, 0, 0, 0, 19, 110
"/opt/projects/swiftkube/vendor/go.uber.org/atomic/int64.go", "Go", 91, 0, 0, 0, 0, 0, 19, 110
"/opt/projects/swiftkube/vendor/go.uber.org/atomic/nocmp.go", "Go", 33, 0, 0, 0, 0, 0, 3, 36
"/opt/projects/swiftkube/vendor/go.uber.org/atomic/pointer_go118.go", "Go", 51, 0, 0, 0, 0, 0, 10, 61
"/opt/projects/swiftkube/vendor/go.uber.org/atomic/pointer_go119.go", "Go", 52, 0, 0, 0, 0, 0, 10, 62
"/opt/projects/swiftkube/vendor/go.uber.org/atomic/string.go", "Go", 55, 0, 0, 0, 0, 0, 11, 66
"/opt/projects/swiftkube/vendor/go.uber.org/atomic/string_ext.go", "Go", 38, 0, 0, 0, 0, 0, 6, 44
"/opt/projects/swiftkube/vendor/go.uber.org/atomic/time.go", "Go", 46, 0, 0, 0, 0, 0, 10, 56
"/opt/projects/swiftkube/vendor/go.uber.org/atomic/time_ext.go", "Go", 31, 0, 0, 0, 0, 0, 6, 37
"/opt/projects/swiftkube/vendor/go.uber.org/atomic/uint32.go", "Go", 91, 0, 0, 0, 0, 0, 19, 110
"/opt/projects/swiftkube/vendor/go.uber.org/atomic/uint64.go", "Go", 91, 0, 0, 0, 0, 0, 19, 110
"/opt/projects/swiftkube/vendor/go.uber.org/atomic/uintptr.go", "Go", 91, 0, 0, 0, 0, 0, 19, 110
"/opt/projects/swiftkube/vendor/go.uber.org/atomic/unsafe_pointer.go", "Go", 55, 0, 0, 0, 0, 0, 11, 66
"/opt/projects/swiftkube/vendor/go.uber.org/atomic/value.go", "Go", 27, 0, 0, 0, 0, 0, 5, 32
"/opt/projects/swiftkube/vendor/go.uber.org/multierr/error.go", "Go", 601, 0, 0, 0, 0, 0, 46, 647
"/opt/projects/swiftkube/vendor/go.uber.org/multierr/error_post_go120.go", "Go", 41, 0, 0, 0, 0, 0, 8, 49
"/opt/projects/swiftkube/vendor/go.uber.org/multierr/error_pre_go120.go", "Go", 70, 0, 0, 0, 0, 0, 10, 80
"/opt/projects/swiftkube/vendor/go.uber.org/zap/.readme.tmpl", "Go Template File", 0, 0, 0, 80, 0, 0, 30, 110
"/opt/projects/swiftkube/vendor/go.uber.org/zap/array.go", "Go", 255, 0, 0, 0, 0, 0, 66, 321
"/opt/projects/swiftkube/vendor/go.uber.org/zap/buffer/buffer.go", "Go", 120, 0, 0, 0, 0, 0, 22, 142
"/opt/projects/swiftkube/vendor/go.uber.org/zap/buffer/pool.go", "Go", 43, 0, 0, 0, 0, 0, 7, 50
"/opt/projects/swiftkube/vendor/go.uber.org/zap/config.go", "Go", 242, 0, 0, 0, 0, 0, 23, 265
"/opt/projects/swiftkube/vendor/go.uber.org/zap/doc.go", "Go", 112, 0, 0, 0, 0, 0, 2, 114
"/opt/projects/swiftkube/vendor/go.uber.org/zap/encoder.go", "Go", 71, 0, 0, 0, 0, 0, 9, 80
"/opt/projects/swiftkube/vendor/go.uber.org/zap/error.go", "Go", 70, 0, 0, 0, 0, 0, 11, 81
"/opt/projects/swiftkube/vendor/go.uber.org/zap/field.go", "Go", 494, 0, 0, 0, 0, 0, 56, 550
"/opt/projects/swiftkube/vendor/go.uber.org/zap/flag.go", "Go", 35, 0, 0, 0, 0, 0, 5, 40
"/opt/projects/swiftkube/vendor/go.uber.org/zap/global.go", "Go", 152, 0, 0, 0, 0, 0, 17, 169
"/opt/projects/swiftkube/vendor/go.uber.org/zap/global_go112.go", "Go", 23, 0, 0, 0, 0, 0, 4, 27
"/opt/projects/swiftkube/vendor/go.uber.org/zap/global_prego112.go", "Go", 23, 0, 0, 0, 0, 0, 4, 27
"/opt/projects/swiftkube/vendor/go.uber.org/zap/http_handler.go", "Go", 122, 0, 0, 0, 0, 0, 11, 133
"/opt/projects/swiftkube/vendor/go.uber.org/zap/internal/bufferpool/bufferpool.go", "Go", 28, 0, 0, 0, 0, 0, 4, 32
"/opt/projects/swiftkube/vendor/go.uber.org/zap/internal/color/color.go", "Go", 39, 0, 0, 0, 0, 0, 6, 45
"/opt/projects/swiftkube/vendor/go.uber.org/zap/internal/exit/exit.go", "Go", 55, 0, 0, 0, 0, 0, 10, 65
"/opt/projects/swiftkube/vendor/go.uber.org/zap/level.go", "Go", 116, 0, 0, 0, 0, 0, 17, 133
"/opt/projects/swiftkube/vendor/go.uber.org/zap/logger.go", "Go", 308, 0, 0, 0, 0, 0, 41, 349
"/opt/projects/swiftkube/vendor/go.uber.org/zap/options.go", "Go", 130, 0, 0, 0, 0, 0, 19, 149
"/opt/projects/swiftkube/vendor/go.uber.org/zap/sink.go", "Go", 142, 0, 0, 0, 0, 0, 20, 162
"/opt/projects/swiftkube/vendor/go.uber.org/zap/stacktrace.go", "Go", 74, 0, 0, 0, 0, 0, 12, 86
"/opt/projects/swiftkube/vendor/go.uber.org/zap/sugar.go", "Go", 269, 0, 0, 0, 0, 0, 47, 316
"/opt/projects/swiftkube/vendor/go.uber.org/zap/time.go", "Go", 24, 0, 0, 0, 0, 0, 4, 28
"/opt/projects/swiftkube/vendor/go.uber.org/zap/writer.go", "Go", 89, 0, 0, 0, 0, 0, 11, 100
"/opt/projects/swiftkube/vendor/go.uber.org/zap/zapcore/buffered_write_syncer.go", "Go", 158, 0, 0, 0, 0, 0, 31, 189
"/opt/projects/swiftkube/vendor/go.uber.org/zap/zapcore/clock.go", "Go", 42, 0, 0, 0, 0, 0, 9, 51
"/opt/projects/swiftkube/vendor/go.uber.org/zap/zapcore/console_encoder.go", "Go", 140, 0, 0, 0, 0, 0, 22, 162
"/opt/projects/swiftkube/vendor/go.uber.org/zap/zapcore/core.go", "Go", 101, 0, 0, 0, 0, 0, 13, 114
"/opt/projects/swiftkube/vendor/go.uber.org/zap/zapcore/doc.go", "Go", 23, 0, 0, 0, 0, 0, 2, 25
"/opt/projects/swiftkube/vendor/go.uber.org/zap/zapcore/encoder.go", "Go", 392, 0, 0, 0, 0, 0, 52, 444
"/opt/projects/swiftkube/vendor/go.uber.org/zap/zapcore/entry.go", "Go", 238, 0, 0, 0, 0, 0, 25, 263
"/opt/projects/swiftkube/vendor/go.uber.org/zap/zapcore/error.go", "Go", 115, 0, 0, 0, 0, 0, 18, 133
"/opt/projects/swiftkube/vendor/go.uber.org/zap/zapcore/field.go", "Go", 218, 0, 0, 0, 0, 0, 16, 234
"/opt/projects/swiftkube/vendor/go.uber.org/zap/zapcore/hook.go", "Go", 61, 0, 0, 0, 0, 0, 8, 69
"/opt/projects/swiftkube/vendor/go.uber.org/zap/zapcore/increase_level.go", "Go", 55, 0, 0, 0, 0, 0, 12, 67
"/opt/projects/swiftkube/vendor/go.uber.org/zap/zapcore/json_encoder.go", "Go", 476, 0, 0, 0, 0, 0, 59, 535
"/opt/projects/swiftkube/vendor/go.uber.org/zap/zapcore/level.go", "Go", 160, 0, 0, 0, 0, 0, 16, 176
"/opt/projects/swiftkube/vendor/go.uber.org/zap/zapcore/level_strings.go", "Go", 41, 0, 0, 0, 0, 0, 6, 47
"/opt/projects/swiftkube/vendor/go.uber.org/zap/zapcore/marshaler.go", "Go", 54, 0, 0, 0, 0, 0, 8, 62
"/opt/projects/swiftkube/vendor/go.uber.org/zap/zapcore/memory_encoder.go", "Go", 145, 0, 0, 0, 0, 0, 35, 180
"/opt/projects/swiftkube/vendor/go.uber.org/zap/zapcore/sampler.go", "Go", 182, 0, 0, 0, 0, 0, 29, 211
"/opt/projects/swiftkube/vendor/go.uber.org/zap/zapcore/tee.go", "Go", 72, 0, 0, 0, 0, 0, 10, 82
"/opt/projects/swiftkube/vendor/go.uber.org/zap/zapcore/write_syncer.go", "Go", 107, 0, 0, 0, 0, 0, 16, 123
"/opt/projects/swiftkube/vendor/go.uber.org/zap/zapgrpc/zapgrpc.go", "Go", 208, 0, 0, 0, 0, 0, 34, 242
"/opt/projects/swiftkube/vendor/golang.org/x/crypto/cryptobyte/asn1.go", "Go", 735, 0, 0, 0, 0, 0, 90, 825
"/opt/projects/swiftkube/vendor/golang.org/x/crypto/cryptobyte/asn1/asn1.go", "Go", 40, 0, 0, 0, 0, 0, 7, 47
"/opt/projects/swiftkube/vendor/golang.org/x/crypto/cryptobyte/builder.go", "Go", 302, 0, 0, 0, 0, 0, 44, 346
"/opt/projects/swiftkube/vendor/golang.org/x/crypto/cryptobyte/string.go", "Go", 155, 0, 0, 0, 0, 0, 18, 173
"/opt/projects/swiftkube/vendor/golang.org/x/crypto/hkdf/hkdf.go", "Go", 81, 0, 0, 0, 0, 0, 13, 94
"/opt/projects/swiftkube/vendor/golang.org/x/crypto/internal/alias/alias.go", "Go", 27, 0, 0, 0, 0, 0, 6, 33
"/opt/projects/swiftkube/vendor/golang.org/x/crypto/internal/alias/alias_purego.go", "Go", 29, 0, 0, 0, 0, 0, 7, 36
"/opt/projects/swiftkube/vendor/golang.org/x/crypto/internal/poly1305/bits_compat.go", "Go", 34, 0, 0, 0, 0, 0, 7, 41
"/opt/projects/swiftkube/vendor/golang.org/x/crypto/internal/poly1305/bits_go1.13.go", "Go", 16, 0, 0, 0, 0, 0, 7, 23
"/opt/projects/swiftkube/vendor/golang.org/x/crypto/internal/poly1305/mac_noasm.go", "Go", 7, 0, 0, 0, 0, 0, 4, 11
"/opt/projects/swiftkube/vendor/golang.org/x/crypto/internal/poly1305/poly1305.go", "Go", 87, 0, 0, 0, 0, 0, 13, 100
"/opt/projects/swiftkube/vendor/golang.org/x/crypto/internal/poly1305/sum_amd64.go", "Go", 42, 0, 0, 0, 0, 0, 7, 49
"/opt/projects/swiftkube/vendor/golang.org/x/crypto/internal/poly1305/sum_generic.go", "Go", 264, 0, 0, 0, 0, 0, 46, 310
"/opt/projects/swiftkube/vendor/golang.org/x/crypto/internal/poly1305/sum_ppc64le.go", "Go", 42, 0, 0, 0, 0, 0, 7, 49
"/opt/projects/swiftkube/vendor/golang.org/x/crypto/internal/poly1305/sum_s390x.go", "Go", 67, 0, 0, 0, 0, 0, 11, 78
"/opt/projects/swiftkube/vendor/golang.org/x/crypto/nacl/secretbox/secretbox.go", "Go", 139, 0, 0, 0, 0, 0, 35, 174
"/opt/projects/swiftkube/vendor/golang.org/x/crypto/pkcs12/bmp-string.go", "Go", 40, 0, 0, 0, 0, 0, 11, 51
"/opt/projects/swiftkube/vendor/golang.org/x/crypto/pkcs12/crypto.go", "Go", 105, 0, 0, 0, 0, 0, 27, 132
"/opt/projects/swiftkube/vendor/golang.org/x/crypto/pkcs12/errors.go", "Go", 17, 0, 0, 0, 0, 0, 7, 24
"/opt/projects/swiftkube/vendor/golang.org/x/crypto/pkcs12/internal/rc2/rc2.go", "Go", 211, 0, 0, 0, 0, 0, 58, 269
"/opt/projects/swiftkube/vendor/golang.org/x/crypto/pkcs12/mac.go", "Go", 36, 0, 0, 0, 0, 0, 10, 46
"/opt/projects/swiftkube/vendor/golang.org/x/crypto/pkcs12/pbkdf.go", "Go", 140, 0, 0, 0, 0, 0, 31, 171
"/opt/projects/swiftkube/vendor/golang.org/x/crypto/pkcs12/pkcs12.go", "Go", 307, 0, 0, 0, 0, 0, 54, 361
"/opt/projects/swiftkube/vendor/golang.org/x/crypto/pkcs12/safebags.go", "Go", 47, 0, 0, 0, 0, 0, 11, 58
"/opt/projects/swiftkube/vendor/golang.org/x/crypto/salsa20/salsa/hsalsa20.go", "Go", 127, 0, 0, 0, 0, 0, 20, 147
"/opt/projects/swiftkube/vendor/golang.org/x/crypto/salsa20/salsa/salsa208.go", "Go", 173, 0, 0, 0, 0, 0, 29, 202
"/opt/projects/swiftkube/vendor/golang.org/x/crypto/salsa20/salsa/salsa20_amd64.go", "Go", 19, 0, 0, 0, 0, 0, 6, 25
"/opt/projects/swiftkube/vendor/golang.org/x/crypto/salsa20/salsa/salsa20_noasm.go", "Go", 12, 0, 0, 0, 0, 0, 4, 16
"/opt/projects/swiftkube/vendor/golang.org/x/crypto/salsa20/salsa/salsa20_ref.go", "Go", 201, 0, 0, 0, 0, 0, 33, 234
"/opt/projects/swiftkube/vendor/golang.org/x/exp/constraints/constraints.go", "Go", 43, 0, 0, 0, 0, 0, 8, 51
"/opt/projects/swiftkube/vendor/golang.org/x/exp/slices/slices.go", "Go", 202, 0, 0, 0, 0, 0, 17, 219
"/opt/projects/swiftkube/vendor/golang.org/x/exp/slices/sort.go", "Go", 111, 0, 0, 0, 0, 0, 17, 128
"/opt/projects/swiftkube/vendor/golang.org/x/exp/slices/zsortfunc.go", "Go", 430, 0, 0, 0, 0, 0, 50, 480
"/opt/projects/swiftkube/vendor/golang.org/x/exp/slices/zsortordered.go", "Go", 431, 0, 0, 0, 0, 0, 51, 482
"/opt/projects/swiftkube/vendor/golang.org/x/mod/internal/lazyregexp/lazyre.go", "Go", 63, 0, 0, 0, 0, 0, 16, 79
"/opt/projects/swiftkube/vendor/golang.org/x/mod/module/module.go", "Go", 785, 0, 0, 0, 0, 0, 57, 842
"/opt/projects/swiftkube/vendor/golang.org/x/mod/module/pseudo.go", "Go", 228, 0, 0, 0, 0, 0, 23, 251
"/opt/projects/swiftkube/vendor/golang.org/x/mod/semver/semver.go", "Go", 377, 0, 0, 0, 0, 0, 25, 402
"/opt/projects/swiftkube/vendor/golang.org/x/net/bpf/asm.go", "Go", 37, 0, 0, 0, 0, 0, 5, 42
"/opt/projects/swiftkube/vendor/golang.org/x/net/bpf/constants.go", "Go", 202, 0, 0, 0, 0, 0, 21, 223
"/opt/projects/swiftkube/vendor/golang.org/x/net/bpf/doc.go", "Go", 66, 0, 0, 0, 0, 0, 15, 81
"/opt/projects/swiftkube/vendor/golang.org/x/net/bpf/instructions.go", "Go", 652, 0, 0, 0, 0, 0, 75, 727
"/opt/projects/swiftkube/vendor/golang.org/x/net/bpf/setter.go", "Go", 8, 0, 0, 0, 0, 0, 3, 11
"/opt/projects/swiftkube/vendor/golang.org/x/net/bpf/vm.go", "Go", 134, 0, 0, 0, 0, 0, 17, 151
"/opt/projects/swiftkube/vendor/golang.org/x/net/bpf/vm_instructions.go", "Go", 153, 0, 0, 0, 0, 0, 30, 183
"/opt/projects/swiftkube/vendor/golang.org/x/net/context/context.go", "Go", 53, 0, 0, 0, 0, 0, 4, 57
"/opt/projects/swiftkube/vendor/golang.org/x/net/context/go17.go", "Go", 63, 0, 0, 0, 0, 0, 11, 74
"/opt/projects/swiftkube/vendor/golang.org/x/net/context/go19.go", "Go", 16, 0, 0, 0, 0, 0, 6, 22
"/opt/projects/swiftkube/vendor/golang.org/x/net/context/pre_go17.go", "Go", 264, 0, 0, 0, 0, 0, 38, 302
"/opt/projects/swiftkube/vendor/golang.org/x/net/context/pre_go19.go", "Go", 102, 0, 0, 0, 0, 0, 9, 111
"/opt/projects/swiftkube/vendor/golang.org/x/net/html/atom/atom.go", "Go", 70, 0, 0, 0, 0, 0, 9, 79
"/opt/projects/swiftkube/vendor/golang.org/x/net/html/atom/table.go", "Go", 776, 0, 0, 0, 0, 0, 8, 784
"/opt/projects/swiftkube/vendor/golang.org/x/net/html/const.go", "Go", 108, 0, 0, 0, 0, 0, 4, 112
"/opt/projects/swiftkube/vendor/golang.org/x/net/html/doc.go", "Go", 106, 0, 0, 0, 0, 0, 22, 128
"/opt/projects/swiftkube/vendor/golang.org/x/net/html/doctype.go", "Go", 147, 0, 0, 0, 0, 0, 10, 157
"/opt/projects/swiftkube/vendor/golang.org/x/net/html/entity.go", "Go", 2249, 0, 0, 0, 0, 0, 5, 2254
"/opt/projects/swiftkube/vendor/golang.org/x/net/html/escape.go", "Go", 310, 0, 0, 0, 0, 0, 30, 340
"/opt/projects/swiftkube/vendor/golang.org/x/net/html/foreign.go", "Go", 212, 0, 0, 0, 0, 0, 11, 223
"/opt/projects/swiftkube/vendor/golang.org/x/net/html/node.go", "Go", 203, 0, 0, 0, 0, 0, 23, 226
"/opt/projects/swiftkube/vendor/golang.org/x/net/html/parse.go", "Go", 2349, 0, 0, 0, 0, 0, 112, 2461
"/opt/projects/swiftkube/vendor/golang.org/x/net/html/render.go", "Go", 279, 0, 0, 0, 0, 0, 15, 294
"/opt/projects/swiftkube/vendor/golang.org/x/net/html/token.go", "Go", 1196, 0, 0, 0, 0, 0, 73, 1269
"/opt/projects/swiftkube/vendor/golang.org/x/net/http/httpguts/guts.go", "Go", 46, 0, 0, 0, 0, 0, 5, 51
"/opt/projects/swiftkube/vendor/golang.org/x/net/http/httpguts/httplex.go", "Go", 328, 0, 0, 0, 0, 0, 25, 353
"/opt/projects/swiftkube/vendor/golang.org/x/net/http2/ascii.go", "Go", 46, 0, 0, 0, 0, 0, 8, 54
"/opt/projects/swiftkube/vendor/golang.org/x/net/http2/ciphers.go", "Go", 637, 0, 0, 0, 0, 0, 5, 642
"/opt/projects/swiftkube/vendor/golang.org/x/net/http2/client_conn_pool.go", "Go", 283, 0, 0, 0, 0, 0, 29, 312
"/opt/projects/swiftkube/vendor/golang.org/x/net/http2/databuffer.go", "Go", 134, 0, 0, 0, 0, 0, 13, 147
"/opt/projects/swiftkube/vendor/golang.org/x/net/http2/errors.go", "Go", 119, 0, 0, 0, 0, 0, 27, 146
"/opt/projects/swiftkube/vendor/golang.org/x/net/http2/flow.go", "Go", 105, 0, 0, 0, 0, 0, 16, 121
"/opt/projects/swiftkube/vendor/golang.org/x/net/http2/frame.go", "Go", 1486, 0, 0, 0, 0, 0, 173, 1659
"/opt/projects/swiftkube/vendor/golang.org/x/net/http2/go111.go", "Go", 24, 0, 0, 0, 0, 0, 7, 31
"/opt/projects/swiftkube/vendor/golang.org/x/net/http2/go115.go", "Go", 23, 0, 0, 0, 0, 0, 5, 28
"/opt/projects/swiftkube/vendor/golang.org/x/net/http2/go118.go", "Go", 13, 0, 0, 0, 0, 0, 5, 18
"/opt/projects/swiftkube/vendor/golang.org/x/net/http2/gotrack.go", "Go", 146, 0, 0, 0, 0, 0, 25, 171
"/opt/projects/swiftkube/vendor/golang.org/x/net/http2/headermap.go", "Go", 98, 0, 0, 0, 0, 0, 8, 106
"/opt/projects/swiftkube/vendor/golang.org/x/net/http2/hpack/encode.go", "Go", 222, 0, 0, 0, 0, 0, 24, 246
"/opt/projects/swiftkube/vendor/golang.org/x/net/http2/hpack/hpack.go", "Go", 469, 0, 0, 0, 0, 0, 55, 524
"/opt/projects/swiftkube/vendor/golang.org/x/net/http2/hpack/huffman.go", "Go", 205, 0, 0, 0, 0, 0, 22, 227
"/opt/projects/swiftkube/vendor/golang.org/x/net/http2/hpack/static_table.go", "Go", 186, 0, 0, 0, 0, 0, 3, 189
"/opt/projects/swiftkube/vendor/golang.org/x/net/http2/hpack/tables.go", "Go", 389, 0, 0, 0, 0, 0, 15, 404
"/opt/projects/swiftkube/vendor/golang.org/x/net/http2/http2.go", "Go", 332, 0, 0, 0, 0, 0, 54, 386
"/opt/projects/swiftkube/vendor/golang.org/x/net/http2/not_go111.go", "Go", 15, 0, 0, 0, 0, 0, 7, 22
"/opt/projects/swiftkube/vendor/golang.org/x/net/http2/not_go115.go", "Go", 27, 0, 0, 0, 0, 0, 5, 32
"/opt/projects/swiftkube/vendor/golang.org/x/net/http2/not_go118.go", "Go", 13, 0, 0, 0, 0, 0, 5, 18
"/opt/projects/swiftkube/vendor/golang.org/x/net/http2/pipe.go", "Go", 159, 0, 0, 0, 0, 0, 17, 176
"/opt/projects/swiftkube/vendor/golang.org/x/net/http2/server.go", "Go", 2956, 0, 0, 0, 0, 0, 287, 3243
"/opt/projects/swiftkube/vendor/golang.org/x/net/http2/transport.go", "Go", 2875, 0, 0, 0, 0, 0, 308, 3183
"/opt/projects/swiftkube/vendor/golang.org/x/net/http2/write.go", "Go", 310, 0, 0, 0, 0, 0, 61, 371
"/opt/projects/swiftkube/vendor/golang.org/x/net/http2/writesched.go", "Go", 223, 0, 0, 0, 0, 0, 29, 252
"/opt/projects/swiftkube/vendor/golang.org/x/net/http2/writesched_priority.go", "Go", 408, 0, 0, 0, 0, 0, 44, 452
"/opt/projects/swiftkube/vendor/golang.org/x/net/http2/writesched_random.go", "Go", 66, 0, 0, 0, 0, 0, 12, 78
"/opt/projects/swiftkube/vendor/golang.org/x/net/http2/writesched_roundrobin.go", "Go", 107, 0, 0, 0, 0, 0, 13, 120
"/opt/projects/swiftkube/vendor/golang.org/x/net/idna/go118.go", "Go", 10, 0, 0, 0, 0, 0, 5, 15
"/opt/projects/swiftkube/vendor/golang.org/x/net/idna/idna10.0.0.go", "Go", 708, 0, 0, 0, 0, 0, 63, 771
"/opt/projects/swiftkube/vendor/golang.org/x/net/idna/idna9.0.0.go", "Go", 657, 0, 0, 0, 0, 0, 62, 719
"/opt/projects/swiftkube/vendor/golang.org/x/net/idna/pre_go118.go", "Go", 8, 0, 0, 0, 0, 0, 5, 13
"/opt/projects/swiftkube/vendor/golang.org/x/net/idna/punycode.go", "Go", 205, 0, 0, 0, 0, 0, 13, 218
"/opt/projects/swiftkube/vendor/golang.org/x/net/idna/tables10.0.0.go", "Go", 4543, 0, 0, 0, 0, 0, 18, 4561
"/opt/projects/swiftkube/vendor/golang.org/x/net/idna/tables11.0.0.go", "Go", 4637, 0, 0, 0, 0, 0, 18, 4655
"/opt/projects/swiftkube/vendor/golang.org/x/net/idna/tables12.0.0.go", "Go", 4717, 0, 0, 0, 0, 0, 18, 4735
"/opt/projects/swiftkube/vendor/golang.org/x/net/idna/tables13.0.0.go", "Go", 4942, 0, 0, 0, 0, 0, 19, 4961
"/opt/projects/swiftkube/vendor/golang.org/x/net/idna/tables15.0.0.go", "Go", 5127, 0, 0, 0, 0, 0, 19, 5146
"/opt/projects/swiftkube/vendor/golang.org/x/net/idna/tables9.0.0.go", "Go", 4470, 0, 0, 0, 0, 0, 18, 4488
"/opt/projects/swiftkube/vendor/golang.org/x/net/idna/trie.go", "Go", 43, 0, 0, 0, 0, 0, 9, 52
"/opt/projects/swiftkube/vendor/golang.org/x/net/idna/trie12.0.0.go", "Go", 27, 0, 0, 0, 0, 0, 5, 32
"/opt/projects/swiftkube/vendor/golang.org/x/net/idna/trie13.0.0.go", "Go", 27, 0, 0, 0, 0, 0, 5, 32
"/opt/projects/swiftkube/vendor/golang.org/x/net/idna/trieval.go", "Go", 102, 0, 0, 0, 0, 0, 18, 120
"/opt/projects/swiftkube/vendor/golang.org/x/net/internal/socks/client.go", "Go", 159, 0, 0, 0, 0, 0, 10, 169
"/opt/projects/swiftkube/vendor/golang.org/x/net/internal/socks/socks.go", "Go", 286, 0, 0, 0, 0, 0, 32, 318
"/opt/projects/swiftkube/vendor/golang.org/x/net/internal/timeseries/timeseries.go", "Go", 444, 0, 0, 0, 0, 0, 82, 526
"/opt/projects/swiftkube/vendor/golang.org/x/net/proxy/dial.go", "Go", 49, 0, 0, 0, 0, 0, 6, 55
"/opt/projects/swiftkube/vendor/golang.org/x/net/proxy/direct.go", "Go", 24, 0, 0, 0, 0, 0, 8, 32
"/opt/projects/swiftkube/vendor/golang.org/x/net/proxy/per_host.go", "Go", 140, 0, 0, 0, 0, 0, 16, 156
"/opt/projects/swiftkube/vendor/golang.org/x/net/proxy/proxy.go", "Go", 129, 0, 0, 0, 0, 0, 21, 150
"/opt/projects/swiftkube/vendor/golang.org/x/net/proxy/socks5.go", "Go", 38, 0, 0, 0, 0, 0, 5, 43
"/opt/projects/swiftkube/vendor/golang.org/x/net/trace/events.go", "Go", 468, 0, 0, 0, 0, 0, 65, 533
"/opt/projects/swiftkube/vendor/golang.org/x/net/trace/histogram.go", "Go", 328, 0, 0, 0, 0, 0, 38, 366
"/opt/projects/swiftkube/vendor/golang.org/x/net/trace/trace.go", "Go", 981, 0, 0, 0, 0, 0, 150, 1131
"/opt/projects/swiftkube/vendor/golang.org/x/net/websocket/client.go", "Go", 95, 0, 0, 0, 0, 0, 12, 107
"/opt/projects/swiftkube/vendor/golang.org/x/net/websocket/dial.go", "Go", 19, 0, 0, 0, 0, 0, 6, 25
"/opt/projects/swiftkube/vendor/golang.org/x/net/websocket/hybi.go", "Go", 532, 0, 0, 0, 0, 0, 52, 584
"/opt/projects/swiftkube/vendor/golang.org/x/net/websocket/server.go", "Go", 102, 0, 0, 0, 0, 0, 12, 114
"/opt/projects/swiftkube/vendor/golang.org/x/net/websocket/websocket.go", "Go", 379, 0, 0, 0, 0, 0, 71, 450
"/opt/projects/swiftkube/vendor/golang.org/x/oauth2/authhandler/authhandler.go", "Go", 82, 0, 0, 0, 0, 0, 13, 95
"/opt/projects/swiftkube/vendor/golang.org/x/oauth2/google/appengine.go", "Go", 32, 0, 0, 0, 0, 0, 7, 39
"/opt/projects/swiftkube/vendor/golang.org/x/oauth2/google/appengine_gen1.go", "Go", 66, 0, 0, 0, 0, 0, 13, 79
"/opt/projects/swiftkube/vendor/golang.org/x/oauth2/google/appengine_gen2_flex.go", "Go", 21, 0, 0, 0, 0, 0, 8, 29
"/opt/projects/swiftkube/vendor/golang.org/x/oauth2/google/default.go", "Go", 206, 0, 0, 0, 0, 0, 31, 237
"/opt/projects/swiftkube/vendor/golang.org/x/oauth2/google/doc.go", "Go", 132, 0, 0, 0, 0, 0, 2, 134
"/opt/projects/swiftkube/vendor/golang.org/x/oauth2/google/error.go", "Go", 53, 0, 0, 0, 0, 0, 12, 65
"/opt/projects/swiftkube/vendor/golang.org/x/oauth2/google/google.go", "Go", 266, 0, 0, 0, 0, 0, 23, 289
"/opt/projects/swiftkube/vendor/golang.org/x/oauth2/google/internal/externalaccount/aws.go", "Go", 492, 0, 0, 0, 0, 0, 104, 596
"/opt/projects/swiftkube/vendor/golang.org/x/oauth2/google/internal/externalaccount/basecredentials.go", "Go", 238, 0, 0, 0, 0, 0, 32, 270
"/opt/projects/swiftkube/vendor/golang.org/x/oauth2/google/internal/externalaccount/clientauth.go", "Go", 39, 0, 0, 0, 0, 0, 7, 46
"/opt/projects/swiftkube/vendor/golang.org/x/oauth2/google/internal/externalaccount/err.go", "Go", 14, 0, 0, 0, 0, 0, 5, 19
"/opt/projects/swiftkube/vendor/golang.org/x/oauth2/google/internal/externalaccount/executablecredsource.go", "Go", 254, 0, 0, 0, 0, 0, 56, 310
"/opt/projects/swiftkube/vendor/golang.org/x/oauth2/google/internal/externalaccount/filecredsource.go", "Go", 52, 0, 0, 0, 0, 0, 6, 58
"/opt/projects/swiftkube/vendor/golang.org/x/oauth2/google/internal/externalaccount/impersonate.go", "Go", 95, 0, 0, 0, 0, 0, 11, 106
"/opt/projects/swiftkube/vendor/golang.org/x/oauth2/google/internal/externalaccount/sts_exchange.go", "Go", 91, 0, 0, 0, 0, 0, 17, 108
"/opt/projects/swiftkube/vendor/golang.org/x/oauth2/google/internal/externalaccount/urlcredsource.go", "Go", 66, 0, 0, 0, 0, 0, 10, 76
"/opt/projects/swiftkube/vendor/golang.org/x/oauth2/google/jwt.go", "Go", 93, 0, 0, 0, 0, 0, 10, 103
"/opt/projects/swiftkube/vendor/golang.org/x/oauth2/google/sdk.go", "Go", 187, 0, 0, 0, 0, 0, 15, 202
"/opt/projects/swiftkube/vendor/golang.org/x/oauth2/internal/client_appengine.go", "Go", 10, 0, 0, 0, 0, 0, 5, 15
"/opt/projects/swiftkube/vendor/golang.org/x/oauth2/internal/doc.go", "Go", 5, 0, 0, 0, 0, 0, 2, 7
"/opt/projects/swiftkube/vendor/golang.org/x/oauth2/internal/oauth2.go", "Go", 34, 0, 0, 0, 0, 0, 4, 38
"/opt/projects/swiftkube/vendor/golang.org/x/oauth2/internal/token.go", "Go", 306, 0, 0, 0, 0, 0, 27, 333
"/opt/projects/swiftkube/vendor/golang.org/x/oauth2/internal/transport.go", "Go", 27, 0, 0, 0, 0, 0, 7, 34
"/opt/projects/swiftkube/vendor/golang.org/x/oauth2/jws/jws.go", "Go", 160, 0, 0, 0, 0, 0, 23, 183
"/opt/projects/swiftkube/vendor/golang.org/x/oauth2/jwt/jwt.go", "Go", 166, 0, 0, 0, 0, 0, 20, 186
"/opt/projects/swiftkube/vendor/golang.org/x/oauth2/oauth2.go", "Go", 369, 0, 0, 0, 0, 0, 44, 413
"/opt/projects/swiftkube/vendor/golang.org/x/oauth2/token.go", "Go", 180, 0, 0, 0, 0, 0, 26, 206
"/opt/projects/swiftkube/vendor/golang.org/x/oauth2/transport.go", "Go", 77, 0, 0, 0, 0, 0, 13, 90
"/opt/projects/swiftkube/vendor/golang.org/x/sync/errgroup/errgroup.go", "Go", 115, 0, 0, 0, 0, 0, 18, 133
"/opt/projects/swiftkube/vendor/golang.org/x/sync/singleflight/singleflight.go", "Go", 179, 0, 0, 0, 0, 0, 27, 206
"/opt/projects/swiftkube/vendor/golang.org/x/sys/cpu/byteorder.go", "Go", 57, 0, 0, 0, 0, 0, 10, 67
"/opt/projects/swiftkube/vendor/golang.org/x/sys/cpu/cpu.go", "Go", 265, 0, 0, 0, 0, 0, 23, 288
"/opt/projects/swiftkube/vendor/golang.org/x/sys/cpu/cpu_aix.go", "Go", 28, 0, 0, 0, 0, 0, 7, 35
"/opt/projects/swiftkube/vendor/golang.org/x/sys/cpu/cpu_arm.go", "Go", 67, 0, 0, 0, 0, 0, 7, 74
"/opt/projects/swiftkube/vendor/golang.org/x/sys/cpu/cpu_arm64.go", "Go", 146, 0, 0, 0, 0, 0, 27, 173
"/opt/projects/swiftkube/vendor/golang.org/x/sys/cpu/cpu_gc_arm64.go", "Go", 9, 0, 0, 0, 0, 0, 4, 13
"/opt/projects/swiftkube/vendor/golang.org/x/sys/cpu/cpu_gc_s390x.go", "Go", 18, 0, 0, 0, 0, 0, 5, 23
"/opt/projects/swiftkube/vendor/golang.org/x/sys/cpu/cpu_gc_x86.go", "Go", 13, 0, 0, 0, 0, 0, 5, 18
"/opt/projects/swiftkube/vendor/golang.org/x/sys/cpu/cpu_gccgo_arm64.go", "Go", 9, 0, 0, 0, 0, 0, 4, 13
"/opt/projects/swiftkube/vendor/golang.org/x/sys/cpu/cpu_gccgo_s390x.go", "Go", 19, 0, 0, 0, 0, 0, 5, 24
"/opt/projects/swiftkube/vendor/golang.org/x/sys/cpu/cpu_gccgo_x86.go", "Go", 26, 0, 0, 0, 0, 0, 8, 34
"/opt/projects/swiftkube/vendor/golang.org/x/sys/cpu/cpu_linux.go", "Go", 13, 0, 0, 0, 0, 0, 4, 17
"/opt/projects/swiftkube/vendor/golang.org/x/sys/cpu/cpu_linux_arm.go", "Go", 36, 0, 0, 0, 0, 0, 4, 40
"/opt/projects/swiftkube/vendor/golang.org/x/sys/cpu/cpu_linux_arm64.go", "Go", 104, 0, 0, 0, 0, 0, 8, 112
"/opt/projects/swiftkube/vendor/golang.org/x/sys/cpu/cpu_linux_mips64x.go", "Go", 19, 0, 0, 0, 0, 0, 6, 25
"/opt/projects/swiftkube/vendor/golang.org/x/sys/cpu/cpu_linux_noinit.go", "Go", 7, 0, 0, 0, 0, 0, 4, 11
"/opt/projects/swiftkube/vendor/golang.org/x/sys/cpu/cpu_linux_ppc64x.go", "Go", 26, 0, 0, 0, 0, 0, 7, 33
"/opt/projects/swiftkube/vendor/golang.org/x/sys/cpu/cpu_linux_s390x.go", "Go", 35, 0, 0, 0, 0, 0, 6, 41
"/opt/projects/swiftkube/vendor/golang.org/x/sys/cpu/cpu_loong64.go", "Go", 9, 0, 0, 0, 0, 0, 5, 14
"/opt/projects/swiftkube/vendor/golang.org/x/sys/cpu/cpu_mips64x.go", "Go", 12, 0, 0, 0, 0, 0, 5, 17
"/opt/projects/swiftkube/vendor/golang.org/x/sys/cpu/cpu_mipsx.go", "Go", 8, 0, 0, 0, 0, 0, 5, 13
"/opt/projects/swiftkube/vendor/golang.org/x/sys/cpu/cpu_netbsd_arm64.go", "Go", 153, 0, 0, 0, 0, 0, 21, 174
"/opt/projects/swiftkube/vendor/golang.org/x/sys/cpu/cpu_openbsd_arm64.go", "Go", 51, 0, 0, 0, 0, 0, 15, 66
"/opt/projects/swiftkube/vendor/golang.org/x/sys/cpu/cpu_other_arm.go", "Go", 7, 0, 0, 0, 0, 0, 4, 11
"/opt/projects/swiftkube/vendor/golang.org/x/sys/cpu/cpu_other_arm64.go", "Go", 7, 0, 0, 0, 0, 0, 4, 11
"/opt/projects/swiftkube/vendor/golang.org/x/sys/cpu/cpu_other_mips64x.go", "Go", 10, 0, 0, 0, 0, 0, 4, 14
"/opt/projects/swiftkube/vendor/golang.org/x/sys/cpu/cpu_other_ppc64x.go", "Go", 12, 0, 0, 0, 0, 0, 4, 16
"/opt/projects/swiftkube/vendor/golang.org/x/sys/cpu/cpu_other_riscv64.go", "Go", 9, 0, 0, 0, 0, 0, 4, 13
"/opt/projects/swiftkube/vendor/golang.org/x/sys/cpu/cpu_ppc64x.go", "Go", 13, 0, 0, 0, 0, 0, 5, 18
"/opt/projects/swiftkube/vendor/golang.org/x/sys/cpu/cpu_riscv64.go", "Go", 8, 0, 0, 0, 0, 0, 5, 13
"/opt/projects/swiftkube/vendor/golang.org/x/sys/cpu/cpu_s390x.go", "Go", 150, 0, 0, 0, 0, 0, 23, 173
"/opt/projects/swiftkube/vendor/golang.org/x/sys/cpu/cpu_wasm.go", "Go", 12, 0, 0, 0, 0, 0, 7, 19
"/opt/projects/swiftkube/vendor/golang.org/x/sys/cpu/cpu_x86.go", "Go", 125, 0, 0, 0, 0, 0, 21, 146
"/opt/projects/swiftkube/vendor/golang.org/x/sys/cpu/cpu_zos.go", "Go", 8, 0, 0, 0, 0, 0, 3, 11
"/opt/projects/swiftkube/vendor/golang.org/x/sys/cpu/cpu_zos_s390x.go", "Go", 21, 0, 0, 0, 0, 0, 5, 26
"/opt/projects/swiftkube/vendor/golang.org/x/sys/cpu/endian_big.go", "Go", 8, 0, 0, 0, 0, 0, 4, 12
"/opt/projects/swiftkube/vendor/golang.org/x/sys/cpu/endian_little.go", "Go", 8, 0, 0, 0, 0, 0, 4, 12
"/opt/projects/swiftkube/vendor/golang.org/x/sys/cpu/hwcap_linux.go", "Go", 63, 0, 0, 0, 0, 0, 9, 72
"/opt/projects/swiftkube/vendor/golang.org/x/sys/cpu/parse.go", "Go", 39, 0, 0, 0, 0, 0, 5, 44
"/opt/projects/swiftkube/vendor/golang.org/x/sys/cpu/proc_cpuinfo_linux.go", "Go", 47, 0, 0, 0, 0, 0, 8, 55
"/opt/projects/swiftkube/vendor/golang.org/x/sys/cpu/runtime_auxv.go", "Go", 13, 0, 0, 0, 0, 0, 4, 17
"/opt/projects/swiftkube/vendor/golang.org/x/sys/cpu/runtime_auxv_go121.go", "Go", 14, 0, 0, 0, 0, 0, 6, 20
"/opt/projects/swiftkube/vendor/golang.org/x/sys/cpu/syscall_aix_gccgo.go", "Go", 21, 0, 0, 0, 0, 0, 7, 28
"/opt/projects/swiftkube/vendor/golang.org/x/sys/cpu/syscall_aix_ppc64_gc.go", "Go", 25, 0, 0, 0, 0, 0, 12, 37
"/opt/projects/swiftkube/vendor/golang.org/x/sys/execabs/execabs.go", "Go", 90, 0, 0, 0, 0, 0, 13, 103
"/opt/projects/swiftkube/vendor/golang.org/x/sys/execabs/execabs_go118.go", "Go", 13, 0, 0, 0, 0, 0, 6, 19
"/opt/projects/swiftkube/vendor/golang.org/x/sys/execabs/execabs_go119.go", "Go", 16, 0, 0, 0, 0, 0, 6, 22
"/opt/projects/swiftkube/vendor/golang.org/x/sys/internal/unsafeheader/unsafeheader.go", "Go", 26, 0, 0, 0, 0, 0, 5, 31
"/opt/projects/swiftkube/vendor/golang.org/x/sys/plan9/const_plan9.go", "Go", 63, 0, 0, 0, 0, 0, 8, 71
"/opt/projects/swiftkube/vendor/golang.org/x/sys/plan9/dir_plan9.go", "Go", 184, 0, 0, 0, 0, 0, 29, 213
"/opt/projects/swiftkube/vendor/golang.org/x/sys/plan9/env_plan9.go", "Go", 23, 0, 0, 0, 0, 0, 9, 32
"/opt/projects/swiftkube/vendor/golang.org/x/sys/plan9/errors_plan9.go", "Go", 44, 0, 0, 0, 0, 0, 7, 51
"/opt/projects/swiftkube/vendor/golang.org/x/sys/plan9/pwd_go15_plan9.go", "Go", 16, 0, 0, 0, 0, 0, 7, 23
"/opt/projects/swiftkube/vendor/golang.org/x/sys/plan9/pwd_plan9.go", "Go", 19, 0, 0, 0, 0, 0, 6, 25
"/opt/projects/swiftkube/vendor/golang.org/x/sys/plan9/race.go", "Go", 23, 0, 0, 0, 0, 0, 9, 32
"/opt/projects/swiftkube/vendor/golang.org/x/sys/plan9/race0.go", "Go", 18, 0, 0, 0, 0, 0, 9, 27
"/opt/projects/swiftkube/vendor/golang.org/x/sys/plan9/str.go", "Go", 20, 0, 0, 0, 0, 0, 4, 24
"/opt/projects/swiftkube/vendor/golang.org/x/sys/plan9/syscall.go", "Go", 95, 0, 0, 0, 0, 0, 16, 111
"/opt/projects/swiftkube/vendor/golang.org/x/sys/plan9/syscall_plan9.go", "Go", 283, 0, 0, 0, 0, 0, 79, 362
"/opt/projects/swiftkube/vendor/golang.org/x/sys/plan9/zsyscall_plan9_386.go", "Go", 248, 0, 0, 0, 0, 0, 38, 286
"/opt/projects/swiftkube/vendor/golang.org/x/sys/plan9/zsyscall_plan9_amd64.go", "Go", 248, 0, 0, 0, 0, 0, 38, 286
"/opt/projects/swiftkube/vendor/golang.org/x/sys/plan9/zsyscall_plan9_arm.go", "Go", 248, 0, 0, 0, 0, 0, 38, 286
"/opt/projects/swiftkube/vendor/golang.org/x/sys/plan9/zsysnum_plan9.go", "Go", 47, 0, 0, 0, 0, 0, 3, 50
"/opt/projects/swiftkube/vendor/golang.org/x/sys/unix/affinity_linux.go", "Go", 71, 0, 0, 0, 0, 0, 16, 87
"/opt/projects/swiftkube/vendor/golang.org/x/sys/unix/aliases.go", "Go", 11, 0, 0, 0, 0, 0, 5, 16
"/opt/projects/swiftkube/vendor/golang.org/x/sys/unix/bluetooth_linux.go", "Go", 31, 0, 0, 0, 0, 0, 6, 37
"/opt/projects/swiftkube/vendor/golang.org/x/sys/unix/cap_freebsd.go", "Go", 168, 0, 0, 0, 0, 0, 29, 197
"/opt/projects/swiftkube/vendor/golang.org/x/sys/unix/constants.go", "Go", 11, 0, 0, 0, 0, 0, 4, 15
"/opt/projects/swiftkube/vendor/golang.org/x/sys/unix/dev_aix_ppc.go", "Go", 21, 0, 0, 0, 0, 0, 7, 28
"/opt/projects/swiftkube/vendor/golang.org/x/sys/unix/dev_aix_ppc64.go", "Go", 23, 0, 0, 0, 0, 0, 7, 30
"/opt/projects/swiftkube/vendor/golang.org/x/sys/unix/dev_darwin.go", "Go", 19, 0, 0, 0, 0, 0, 6, 25
"/opt/projects/swiftkube/vendor/golang.org/x/sys/unix/dev_dragonfly.go", "Go", 25, 0, 0, 0, 0, 0, 6, 31
"/opt/projects/swiftkube/vendor/golang.org/x/sys/unix/dev_freebsd.go", "Go", 25, 0, 0, 0, 0, 0, 6, 31
"/opt/projects/swiftkube/vendor/golang.org/x/sys/unix/dev_linux.go", "Go", 37, 0, 0, 0, 0, 0, 6, 43
"/opt/projects/swiftkube/vendor/golang.org/x/sys/unix/dev_netbsd.go", "Go", 24, 0, 0, 0, 0, 0, 6, 30
"/opt/projects/swiftkube/vendor/golang.org/x/sys/unix/dev_openbsd.go", "Go", 24, 0, 0, 0, 0, 0, 6, 30
"/opt/projects/swiftkube/vendor/golang.org/x/sys/unix/dev_zos.go", "Go", 23, 0, 0, 0, 0, 0, 7, 30
"/opt/projects/swiftkube/vendor/golang.org/x/sys/unix/dirent.go", "Go", 96, 0, 0, 0, 0, 0, 8, 104
"/opt/projects/swiftkube/vendor/golang.org/x/sys/unix/endian_big.go", "Go", 8, 0, 0, 0, 0, 0, 3, 11
"/opt/projects/swiftkube/vendor/golang.org/x/sys/unix/endian_little.go", "Go", 8, 0, 0, 0, 0, 0, 3, 11
"/opt/projects/swiftkube/vendor/golang.org/x/sys/unix/env_unix.go", "Go", 23, 0, 0, 0, 0, 0, 10, 33
"/opt/projects/swiftkube/vendor/golang.org/x/sys/unix/epoll_zos.go", "Go", 185, 0, 0, 0, 0, 0, 37, 222
"/opt/projects/swiftkube/vendor/golang.org/x/sys/unix/fcntl.go", "Go", 30, 0, 0, 0, 0, 0, 8, 38
"/opt/projects/swiftkube/vendor/golang.org/x/sys/unix/fcntl_darwin.go", "Go", 19, 0, 0, 0, 0, 0, 6, 25
"/opt/projects/swiftkube/vendor/golang.org/x/sys/unix/fcntl_linux_32bit.go", "Go", 11, 0, 0, 0, 0, 0, 4, 15
"/opt/projects/swiftkube/vendor/golang.org/x/sys/unix/fdset.go", "Go", 24, 0, 0, 0, 0, 0, 7, 31
"/opt/projects/swiftkube/vendor/golang.org/x/sys/unix/fstatfs_zos.go", "Go", 154, 0, 0, 0, 0, 0, 11, 165
"/opt/projects/swiftkube/vendor/golang.org/x/sys/unix/gccgo.go", "Go", 47, 0, 0, 0, 0, 0, 14, 61
"/opt/projects/swiftkube/vendor/golang.org/x/sys/unix/gccgo_linux_amd64.go", "Go", 16, 0, 0, 0, 0, 0, 6, 22
"/opt/projects/swiftkube/vendor/golang.org/x/sys/unix/ifreq_linux.go", "Go", 117, 0, 0, 0, 0, 0, 26, 143
"/opt/projects/swiftkube/vendor/golang.org/x/sys/unix/ioctl_linux.go", "Go", 197, 0, 0, 0, 0, 0, 37, 234
"/opt/projects/swiftkube/vendor/golang.org/x/sys/unix/ioctl_signed.go", "Go", 59, 0, 0, 0, 0, 0, 12, 71
"/opt/projects/swiftkube/vendor/golang.org/x/sys/unix/ioctl_unsigned.go", "Go", 59, 0, 0, 0, 0, 0, 12, 71
"/opt/projects/swiftkube/vendor/golang.org/x/sys/unix/ioctl_zos.go", "Go", 62, 0, 0, 0, 0, 0, 11, 73
"/opt/projects/swiftkube/vendor/golang.org/x/sys/unix/mremap.go", "Go", 34, 0, 0, 0, 0, 0, 7, 41
"/opt/projects/swiftkube/vendor/golang.org/x/sys/unix/pagesize_unix.go", "Go", 11, 0, 0, 0, 0, 0, 6, 17
"/opt/projects/swiftkube/vendor/golang.org/x/sys/unix/pledge_openbsd.go", "Go", 135, 0, 0, 0, 0, 0, 29, 164
"/opt/projects/swiftkube/vendor/golang.org/x/sys/unix/ptrace_darwin.go", "Go", 13, 0, 0, 0, 0, 0, 6, 19
"/opt/projects/swiftkube/vendor/golang.org/x/sys/unix/ptrace_ios.go", "Go", 13, 0, 0, 0, 0, 0, 6, 19
"/opt/projects/swiftkube/vendor/golang.org/x/sys/unix/race.go", "Go", 23, 0, 0, 0, 0, 0, 9, 32
"/opt/projects/swiftkube/vendor/golang.org/x/sys/unix/race0.go", "Go", 18, 0, 0, 0, 0, 0, 9, 27
"/opt/projects/swiftkube/vendor/golang.org/x/sys/unix/readdirent_getdents.go", "Go", 10, 0, 0, 0, 0, 0, 4, 14
"/opt/projects/swiftkube/vendor/golang.org/x/sys/unix/readdirent_getdirentries.go", "Go", 16, 0, 0, 0, 0, 0, 5, 21
"/opt/projects/swiftkube/vendor/golang.org/x/sys/unix/sockcmsg_dragonfly.go", "Go", 14, 0, 0, 0, 0, 0, 3, 17
"/opt/projects/swiftkube/vendor/golang.org/x/sys/unix/sockcmsg_linux.go", "Go", 75, 0, 0, 0, 0, 0, 11, 86
"/opt/projects/swiftkube/vendor/golang.org/x/sys/unix/sockcmsg_unix.go", "Go", 94, 0, 0, 0, 0, 0, 14, 108
"/opt/projects/swiftkube/vendor/golang.org/x/sys/unix/sockcmsg_unix_other.go", "Go", 41, 0, 0, 0, 0, 0, 7, 48
"/opt/projects/swiftkube/vendor/golang.org/x/sys/unix/syscall.go", "Go", 77, 0, 0, 0, 0, 0, 11, 88
"/opt/projects/swiftkube/vendor/golang.org/x/sys/unix/syscall_aix.go", "Go", 514, 0, 0, 0, 0, 0, 86, 600
"/opt/projects/swiftkube/vendor/golang.org/x/sys/unix/syscall_aix_ppc.go", "Go", 39, 0, 0, 0, 0, 0, 15, 54
"/opt/projects/swiftkube/vendor/golang.org/x/sys/unix/syscall_aix_ppc64.go", "Go", 69, 0, 0, 0, 0, 0, 16, 85
"/opt/projects/swiftkube/vendor/golang.org/x/sys/unix/syscall_bsd.go", "Go", 543, 0, 0, 0, 0, 0, 82, 625
"/opt/projects/swiftkube/vendor/golang.org/x/sys/unix/syscall_darwin.go", "Go", 739, 0, 0, 0, 0, 0, 88, 827
"/opt/projects/swiftkube/vendor/golang.org/x/sys/unix/syscall_darwin_amd64.go", "Go", 40, 0, 0, 0, 0, 0, 13, 53
"/opt/projects/swiftkube/vendor/golang.org/x/sys/unix/syscall_darwin_arm64.go", "Go", 40, 0, 0, 0, 0, 0, 13, 53
"/opt/projects/swiftkube/vendor/golang.org/x/sys/unix/syscall_darwin_libSystem.go", "Go", 22, 0, 0, 0, 0, 0, 6, 28
"/opt/projects/swiftkube/vendor/golang.org/x/sys/unix/syscall_dragonfly.go", "Go", 506, 0, 0, 0, 0, 0, 40, 546
"/opt/projects/swiftkube/vendor/golang.org/x/sys/unix/syscall_dragonfly_amd64.go", "Go", 43, 0, 0, 0, 0, 0, 15, 58
"/opt/projects/swiftkube/vendor/golang.org/x/sys/unix/syscall_freebsd.go", "Go", 588, 0, 0, 0, 0, 0, 58, 646
"/opt/projects/swiftkube/vendor/golang.org/x/sys/unix/syscall_freebsd_386.go", "Go", 49, 0, 0, 0, 0, 0, 17, 66
"/opt/projects/swiftkube/vendor/golang.org/x/sys/unix/syscall_freebsd_amd64.go", "Go", 49, 0, 0, 0, 0, 0, 17, 66
"/opt/projects/swiftkube/vendor/golang.org/x/sys/unix/syscall_freebsd_arm.go", "Go", 46, 0, 0, 0, 0, 0, 16, 62
"/opt/projects/swiftkube/vendor/golang.org/x/sys/unix/syscall_freebsd_arm64.go", "Go", 46, 0, 0, 0, 0, 0, 16, 62
"/opt/projects/swiftkube/vendor/golang.org/x/sys/unix/syscall_freebsd_riscv64.go", "Go", 46, 0, 0, 0, 0, 0, 16, 62
"/opt/projects/swiftkube/vendor/golang.org/x/sys/unix/syscall_hurd.go", "Go", 25, 0, 0, 0, 0, 0, 6, 31
"/opt/projects/swiftkube/vendor/golang.org/x/sys/unix/syscall_hurd_386.go", "Go", 24, 0, 0, 0, 0, 0, 6, 30
"/opt/projects/swiftkube/vendor/golang.org/x/sys/unix/syscall_illumos.go", "Go", 64, 0, 0, 0, 0, 0, 16, 80
"/opt/projects/swiftkube/vendor/golang.org/x/sys/unix/syscall_linux.go", "Go", 2241, 0, 0, 0, 0, 0, 311, 2552
"/opt/projects/swiftkube/vendor/golang.org/x/sys/unix/syscall_linux_386.go", "Go", 272, 0, 0, 0, 0, 0, 44, 316
"/opt/projects/swiftkube/vendor/golang.org/x/sys/unix/syscall_linux_alarm.go", "Go", 10, 0, 0, 0, 0, 0, 5, 15
"/opt/projects/swiftkube/vendor/golang.org/x/sys/unix/syscall_linux_amd64.go", "Go", 122, 0, 0, 0, 0, 0, 25, 147
"/opt/projects/swiftkube/vendor/golang.org/x/sys/unix/syscall_linux_amd64_gc.go", "Go", 9, 0, 0, 0, 0, 0, 5, 14
"/opt/projects/swiftkube/vendor/golang.org/x/sys/unix/syscall_linux_arm.go", "Go", 181, 0, 0, 0, 0, 0, 37, 218
"/opt/projects/swiftkube/vendor/golang.org/x/sys/unix/syscall_linux_arm64.go", "Go", 153, 0, 0, 0, 0, 0, 33, 186
"/opt/projects/swiftkube/vendor/golang.org/x/sys/unix/syscall_linux_gc.go", "Go", 11, 0, 0, 0, 0, 0, 5, 16
"/opt/projects/swiftkube/vendor/golang.org/x/sys/unix/syscall_linux_gc_386.go", "Go", 12, 0, 0, 0, 0, 0, 6, 18
"/opt/projects/swiftkube/vendor/golang.org/x/sys/unix/syscall_linux_gc_arm.go", "Go", 10, 0, 0, 0, 0, 0, 5, 15
"/opt/projects/swiftkube/vendor/golang.org/x/sys/unix/syscall_linux_gccgo_386.go", "Go", 25, 0, 0, 0, 0, 0, 7, 32
"/opt/projects/swiftkube/vendor/golang.org/x/sys/unix/syscall_linux_gccgo_arm.go", "Go", 17, 0, 0, 0, 0, 0, 5, 22
"/opt/projects/swiftkube/vendor/golang.org/x/sys/unix/syscall_linux_loong64.go", "Go", 179, 0, 0, 0, 0, 0, 39, 218
"/opt/projects/swiftkube/vendor/golang.org/x/sys/unix/syscall_linux_mips64x.go", "Go", 164, 0, 0, 0, 0, 0, 27, 191
"/opt/projects/swiftkube/vendor/golang.org/x/sys/unix/syscall_linux_mipsx.go", "Go", 146, 0, 0, 0, 0, 0, 31, 177
"/opt/projects/swiftkube/vendor/golang.org/x/sys/unix/syscall_linux_ppc.go", "Go", 173, 0, 0, 0, 0, 0, 33, 206
"/opt/projects/swiftkube/vendor/golang.org/x/sys/unix/syscall_linux_ppc64x.go", "Go", 100, 0, 0, 0, 0, 0, 18, 118
"/opt/projects/swiftkube/vendor/golang.org/x/sys/unix/syscall_linux_riscv64.go", "Go", 147, 0, 0, 0, 0, 0, 33, 180
"/opt/projects/swiftkube/vendor/golang.org/x/sys/unix/syscall_linux_s390x.go", "Go", 260, 0, 0, 0, 0, 0, 38, 298
"/opt/projects/swiftkube/vendor/golang.org/x/sys/unix/syscall_linux_sparc64.go", "Go", 96, 0, 0, 0, 0, 0, 18, 114
"/opt/projects/swiftkube/vendor/golang.org/x/sys/unix/syscall_netbsd.go", "Go", 580, 0, 0, 0, 0, 0, 42, 622
"/opt/projects/swiftkube/vendor/golang.org/x/sys/unix/syscall_netbsd_386.go", "Go", 29, 0, 0, 0, 0, 0, 10, 39
"/opt/projects/swiftkube/vendor/golang.org/x/sys/unix/syscall_netbsd_amd64.go", "Go", 29, 0, 0, 0, 0, 0, 10, 39
"/opt/projects/swiftkube/vendor/golang.org/x/sys/unix/syscall_netbsd_arm.go", "Go", 29, 0, 0, 0, 0, 0, 10, 39
"/opt/projects/swiftkube/vendor/golang.org/x/sys/unix/syscall_netbsd_arm64.go", "Go", 29, 0, 0, 0, 0, 0, 10, 39
"/opt/projects/swiftkube/vendor/golang.org/x/sys/unix/syscall_openbsd.go", "Go", 365, 0, 0, 0, 0, 0, 39, 404
"/opt/projects/swiftkube/vendor/golang.org/x/sys/unix/syscall_openbsd_386.go", "Go", 32, 0, 0, 0, 0, 0, 11, 43
"/opt/projects/swiftkube/vendor/golang.org/x/sys/unix/syscall_openbsd_amd64.go", "Go", 32, 0, 0, 0, 0, 0, 11, 43
"/opt/projects/swiftkube/vendor/golang.org/x/sys/unix/syscall_openbsd_arm.go", "Go", 32, 0, 0, 0, 0, 0, 11, 43
"/opt/projects/swiftkube/vendor/golang.org/x/sys/unix/syscall_openbsd_arm64.go", "Go", 32, 0, 0, 0, 0, 0, 11, 43
"/opt/projects/swiftkube/vendor/golang.org/x/sys/unix/syscall_openbsd_libc.go", "Go", 21, 0, 0, 0, 0, 0, 7, 28
"/opt/projects/swiftkube/vendor/golang.org/x/sys/unix/syscall_openbsd_mips64.go", "Go", 30, 0, 0, 0, 0, 0, 10, 40
"/opt/projects/swiftkube/vendor/golang.org/x/sys/unix/syscall_openbsd_ppc64.go", "Go", 32, 0, 0, 0, 0, 0, 11, 43
"/opt/projects/swiftkube/vendor/golang.org/x/sys/unix/syscall_openbsd_riscv64.go", "Go", 32, 0, 0, 0, 0, 0, 11, 43
"/opt/projects/swiftkube/vendor/golang.org/x/sys/unix/syscall_solaris.go", "Go", 1006, 0, 0, 0, 0, 0, 130, 1136
"/opt/projects/swiftkube/vendor/golang.org/x/sys/unix/syscall_solaris_amd64.go", "Go", 21, 0, 0, 0, 0, 0, 8, 29
"/opt/projects/swiftkube/vendor/golang.org/x/sys/unix/syscall_unix.go", "Go", 527, 0, 0, 0, 0, 0, 70, 597
"/opt/projects/swiftkube/vendor/golang.org/x/sys/unix/syscall_unix_gc.go", "Go", 12, 0, 0, 0, 0, 0, 5, 17
"/opt/projects/swiftkube/vendor/golang.org/x/sys/unix/syscall_unix_gc_ppc64x.go", "Go", 21, 0, 0, 0, 0, 0, 5, 26
"/opt/projects/swiftkube/vendor/golang.org/x/sys/unix/syscall_zos_s390x.go", "Go", 1769, 0, 0, 0, 0, 0, 226, 1995
"/opt/projects/swiftkube/vendor/golang.org/x/sys/unix/sysvshm_linux.go", "Go", 16, 0, 0, 0, 0, 0, 6, 22
"/opt/projects/swiftkube/vendor/golang.org/x/sys/unix/sysvshm_unix.go", "Go", 41, 0, 0, 0, 0, 0, 12, 53
"/opt/projects/swiftkube/vendor/golang.org/x/sys/unix/sysvshm_unix_other.go", "Go", 11, 0, 0, 0, 0, 0, 4, 15
"/opt/projects/swiftkube/vendor/golang.org/x/sys/unix/timestruct.go", "Go", 64, 0, 0, 0, 0, 0, 14, 78
"/opt/projects/swiftkube/vendor/golang.org/x/sys/unix/unveil_openbsd.go", "Go", 38, 0, 0, 0, 0, 0, 5, 43
"/opt/projects/swiftkube/vendor/golang.org/x/sys/unix/xattr_bsd.go", "Go", 223, 0, 0, 0, 0, 0, 59, 282
"/opt/projects/swiftkube/vendor/golang.org/x/sys/unix/zerrors_aix_ppc.go", "Go", 1376, 0, 0, 0, 0, 0, 10, 1386
"/opt/projects/swiftkube/vendor/golang.org/x/sys/unix/zerrors_aix_ppc64.go", "Go", 1377, 0, 0, 0, 0, 0, 10, 1387
"/opt/projects/swiftkube/vendor/golang.org/x/sys/unix/zerrors_darwin_amd64.go", "Go", 1902, 0, 0, 0, 0, 0, 10, 1912
"/opt/projects/swiftkube/vendor/golang.org/x/sys/unix/zerrors_darwin_arm64.go", "Go", 1902, 0, 0, 0, 0, 0, 10, 1912
"/opt/projects/swiftkube/vendor/golang.org/x/sys/unix/zerrors_dragonfly_amd64.go", "Go", 1729, 0, 0, 0, 0, 0, 10, 1739
"/opt/projects/swiftkube/vendor/golang.org/x/sys/unix/zerrors_freebsd_386.go", "Go", 2034, 0, 0, 0, 0, 0, 10, 2044
"/opt/projects/swiftkube/vendor/golang.org/x/sys/unix/zerrors_freebsd_amd64.go", "Go", 2031, 0, 0, 0, 0, 0, 10, 2041
"/opt/projects/swiftkube/vendor/golang.org/x/sys/unix/zerrors_freebsd_arm.go", "Go", 2025, 0, 0, 0, 0, 0, 10, 2035
"/opt/projects/swiftkube/vendor/golang.org/x/sys/unix/zerrors_freebsd_arm64.go", "Go", 2025, 0, 0, 0, 0, 0, 10, 2035
"/opt/projects/swiftkube/vendor/golang.org/x/sys/unix/zerrors_freebsd_riscv64.go", "Go", 2139, 0, 0, 0, 0, 0, 10, 2149
"/opt/projects/swiftkube/vendor/golang.org/x/sys/unix/zerrors_linux.go", "Go", 3507, 0, 0, 0, 0, 0, 7, 3514
"/opt/projects/swiftkube/vendor/golang.org/x/sys/unix/zerrors_linux_386.go", "Go", 820, 0, 0, 0, 0, 0, 10, 830
"/opt/projects/swiftkube/vendor/golang.org/x/sys/unix/zerrors_linux_amd64.go", "Go", 820, 0, 0, 0, 0, 0, 10, 830
"/opt/projects/swiftkube/vendor/golang.org/x/sys/unix/zerrors_linux_arm.go", "Go", 826, 0, 0, 0, 0, 0, 10, 836
"/opt/projects/swiftkube/vendor/golang.org/x/sys/unix/zerrors_linux_arm64.go", "Go", 820, 0, 0, 0, 0, 0, 10, 830
"/opt/projects/swiftkube/vendor/golang.org/x/sys/unix/zerrors_linux_loong64.go", "Go", 810, 0, 0, 0, 0, 0, 10, 820
"/opt/projects/swiftkube/vendor/golang.org/x/sys/unix/zerrors_linux_mips.go", "Go", 827, 0, 0, 0, 0, 0, 10, 837
"/opt/projects/swiftkube/vendor/golang.org/x/sys/unix/zerrors_linux_mips64.go", "Go", 827, 0, 0, 0, 0, 0, 10, 837
"/opt/projects/swiftkube/vendor/golang.org/x/sys/unix/zerrors_linux_mips64le.go", "Go", 827, 0, 0, 0, 0, 0, 10, 837
"/opt/projects/swiftkube/vendor/golang.org/x/sys/unix/zerrors_linux_mipsle.go", "Go", 827, 0, 0, 0, 0, 0, 10, 837
"/opt/projects/swiftkube/vendor/golang.org/x/sys/unix/zerrors_linux_ppc.go", "Go", 879, 0, 0, 0, 0, 0, 10, 889
"/opt/projects/swiftkube/vendor/golang.org/x/sys/unix/zerrors_linux_ppc64.go", "Go", 883, 0, 0, 0, 0, 0, 10, 893
"/opt/projects/swiftkube/vendor/golang.org/x/sys/unix/zerrors_linux_ppc64le.go", "Go", 883, 0, 0, 0, 0, 0, 10, 893
"/opt/projects/swiftkube/vendor/golang.org/x/sys/unix/zerrors_linux_riscv64.go", "Go", 807, 0, 0, 0, 0, 0, 10, 817
"/opt/projects/swiftkube/vendor/golang.org/x/sys/unix/zerrors_linux_s390x.go", "Go", 882, 0, 0, 0, 0, 0, 10, 892
"/opt/projects/swiftkube/vendor/golang.org/x/sys/unix/zerrors_linux_sparc64.go", "Go", 925, 0, 0, 0, 0, 0, 10, 935
"/opt/projects/swiftkube/vendor/golang.org/x/sys/unix/zerrors_netbsd_386.go", "Go", 1771, 0, 0, 0, 0, 0, 10, 1781
"/opt/projects/swiftkube/vendor/golang.org/x/sys/unix/zerrors_netbsd_amd64.go", "Go", 1761, 0, 0, 0, 0, 0, 10, 1771
"/opt/projects/swiftkube/vendor/golang.org/x/sys/unix/zerrors_netbsd_arm.go", "Go", 1750, 0, 0, 0, 0, 0, 10, 1760
"/opt/projects/swiftkube/vendor/golang.org/x/sys/unix/zerrors_netbsd_arm64.go", "Go", 1761, 0, 0, 0, 0, 0, 10, 1771
"/opt/projects/swiftkube/vendor/golang.org/x/sys/unix/zerrors_openbsd_386.go", "Go", 1897, 0, 0, 0, 0, 0, 10, 1907
"/opt/projects/swiftkube/vendor/golang.org/x/sys/unix/zerrors_openbsd_amd64.go", "Go", 1897, 0, 0, 0, 0, 0, 10, 1907
"/opt/projects/swiftkube/vendor/golang.org/x/sys/unix/zerrors_openbsd_arm.go", "Go", 1897, 0, 0, 0, 0, 0, 10, 1907
"/opt/projects/swiftkube/vendor/golang.org/x/sys/unix/zerrors_openbsd_arm64.go", "Go", 1897, 0, 0, 0, 0, 0, 10, 1907
"/opt/projects/swiftkube/vendor/golang.org/x/sys/unix/zerrors_openbsd_mips64.go", "Go", 1897, 0, 0, 0, 0, 0, 10, 1907
"/opt/projects/swiftkube/vendor/golang.org/x/sys/unix/zerrors_openbsd_ppc64.go", "Go", 1896, 0, 0, 0, 0, 0, 10, 1906
"/opt/projects/swiftkube/vendor/golang.org/x/sys/unix/zerrors_openbsd_riscv64.go", "Go", 1895, 0, 0, 0, 0, 0, 10, 1905
"/opt/projects/swiftkube/vendor/golang.org/x/sys/unix/zerrors_solaris_amd64.go", "Go", 1548, 0, 0, 0, 0, 0, 10, 1558
"/opt/projects/swiftkube/vendor/golang.org/x/sys/unix/zerrors_zos_s390x.go", "Go", 852, 0, 0, 0, 0, 0, 9, 861
"/opt/projects/swiftkube/vendor/golang.org/x/sys/unix/zptrace_armnn_linux.go", "Go", 33, 0, 0, 0, 0, 0, 10, 43
"/opt/projects/swiftkube/vendor/golang.org/x/sys/unix/zptrace_linux_arm64.go", "Go", 13, 0, 0, 0, 0, 0, 5, 18
"/opt/projects/swiftkube/vendor/golang.org/x/sys/unix/zptrace_mipsnn_linux.go", "Go", 42, 0, 0, 0, 0, 0, 10, 52
"/opt/projects/swiftkube/vendor/golang.org/x/sys/unix/zptrace_mipsnnle_linux.go", "Go", 42, 0, 0, 0, 0, 0, 10, 52
"/opt/projects/swiftkube/vendor/golang.org/x/sys/unix/zptrace_x86_linux.go", "Go", 72, 0, 0, 0, 0, 0, 10, 82
"/opt/projects/swiftkube/vendor/golang.org/x/sys/unix/zsyscall_aix_ppc.go", "Go", 1238, 0, 0, 0, 0, 0, 247, 1485
"/opt/projects/swiftkube/vendor/golang.org/x/sys/unix/zsyscall_aix_ppc64.go", "Go", 1198, 0, 0, 0, 0, 0, 246, 1444
"/opt/projects/swiftkube/vendor/golang.org/x/sys/unix/zsyscall_aix_ppc64_gc.go", "Go", 947, 0, 0, 0, 0, 0, 243, 1190
"/opt/projects/swiftkube/vendor/golang.org/x/sys/unix/zsyscall_aix_ppc64_gccgo.go", "Go", 832, 0, 0, 0, 0, 0, 239, 1071
"/opt/projects/swiftkube/vendor/golang.org/x/sys/unix/zsyscall_darwin_amd64.go", "Go", 1966, 0, 0, 0, 0, 0, 607, 2573
"/opt/projects/swiftkube/vendor/golang.org/x/sys/unix/zsyscall_darwin_arm64.go", "Go", 1966, 0, 0, 0, 0, 0, 607, 2573
"/opt/projects/swiftkube/vendor/golang.org/x/sys/unix/zsyscall_dragonfly_amd64.go", "Go", 1417, 0, 0, 0, 0, 0, 273, 1690
"/opt/projects/swiftkube/vendor/golang.org/x/sys/unix/zsyscall_freebsd_386.go", "Go", 1609, 0, 0, 0, 0, 0, 301, 1910
"/opt/projects/swiftkube/vendor/golang.org/x/sys/unix/zsyscall_freebsd_amd64.go", "Go", 1609, 0, 0, 0, 0, 0, 301, 1910
"/opt/projects/swiftkube/vendor/golang.org/x/sys/unix/zsyscall_freebsd_arm.go", "Go", 1609, 0, 0, 0, 0, 0, 301, 1910
"/opt/projects/swiftkube/vendor/golang.org/x/sys/unix/zsyscall_freebsd_arm64.go", "Go", 1609, 0, 0, 0, 0, 0, 301, 1910
"/opt/projects/swiftkube/vendor/golang.org/x/sys/unix/zsyscall_freebsd_riscv64.go", "Go", 1609, 0, 0, 0, 0, 0, 301, 1910
"/opt/projects/swiftkube/vendor/golang.org/x/sys/unix/zsyscall_illumos_amd64.go", "Go", 86, 0, 0, 0, 0, 0, 17, 103
"/opt/projects/swiftkube/vendor/golang.org/x/sys/unix/zsyscall_linux.go", "Go", 1880, 0, 0, 0, 0, 0, 320, 2200
"/opt/projects/swiftkube/vendor/golang.org/x/sys/unix/zsyscall_linux_386.go", "Go", 403, 0, 0, 0, 0, 0, 85, 488
"/opt/projects/swiftkube/vendor/golang.org/x/sys/unix/zsyscall_linux_amd64.go", "Go", 540, 0, 0, 0, 0, 0, 115, 655
"/opt/projects/swiftkube/vendor/golang.org/x/sys/unix/zsyscall_linux_arm.go", "Go", 498, 0, 0, 0, 0, 0, 105, 603
"/opt/projects/swiftkube/vendor/golang.org/x/sys/unix/zsyscall_linux_arm64.go", "Go", 455, 0, 0, 0, 0, 0, 99, 554
"/opt/projects/swiftkube/vendor/golang.org/x/sys/unix/zsyscall_linux_loong64.go", "Go", 399, 0, 0, 0, 0, 0, 89, 488
"/opt/projects/swiftkube/vendor/golang.org/x/sys/unix/zsyscall_linux_mips.go", "Go", 540, 0, 0, 0, 0, 0, 115, 655
"/opt/projects/swiftkube/vendor/golang.org/x/sys/unix/zsyscall_linux_mips64.go", "Go", 536, 0, 0, 0, 0, 0, 113, 649
"/opt/projects/swiftkube/vendor/golang.org/x/sys/unix/zsyscall_linux_mips64le.go", "Go", 527, 0, 0, 0, 0, 0, 111, 638
"/opt/projects/swiftkube/vendor/golang.org/x/sys/unix/zsyscall_linux_mipsle.go", "Go", 540, 0, 0, 0, 0, 0, 115, 655
"/opt/projects/swiftkube/vendor/golang.org/x/sys/unix/zsyscall_linux_ppc.go", "Go", 545, 0, 0, 0, 0, 0, 115, 660
"/opt/projects/swiftkube/vendor/golang.org/x/sys/unix/zsyscall_linux_ppc64.go", "Go", 583, 0, 0, 0, 0, 0, 123, 706
"/opt/projects/swiftkube/vendor/golang.org/x/sys/unix/zsyscall_linux_ppc64le.go", "Go", 583, 0, 0, 0, 0, 0, 123, 706
"/opt/projects/swiftkube/vendor/golang.org/x/sys/unix/zsyscall_linux_riscv64.go", "Go", 437, 0, 0, 0, 0, 0, 97, 534
"/opt/projects/swiftkube/vendor/golang.org/x/sys/unix/zsyscall_linux_s390x.go", "Go", 412, 0, 0, 0, 0, 0, 85, 497
"/opt/projects/swiftkube/vendor/golang.org/x/sys/unix/zsyscall_linux_sparc64.go", "Go", 537, 0, 0, 0, 0, 0, 113, 650
"/opt/projects/swiftkube/vendor/golang.org/x/sys/unix/zsyscall_netbsd_386.go", "Go", 1572, 0, 0, 0, 0, 0, 289, 1861
"/opt/projects/swiftkube/vendor/golang.org/x/sys/unix/zsyscall_netbsd_amd64.go", "Go", 1572, 0, 0, 0, 0, 0, 289, 1861
"/opt/projects/swiftkube/vendor/golang.org/x/sys/unix/zsyscall_netbsd_arm.go", "Go", 1572, 0, 0, 0, 0, 0, 289, 1861
"/opt/projects/swiftkube/vendor/golang.org/x/sys/unix/zsyscall_netbsd_arm64.go", "Go", 1572, 0, 0, 0, 0, 0, 289, 1861
"/opt/projects/swiftkube/vendor/golang.org/x/sys/unix/zsyscall_openbsd_386.go", "Go", 1706, 0, 0, 0, 0, 0, 546, 2252
"/opt/projects/swiftkube/vendor/golang.org/x/sys/unix/zsyscall_openbsd_amd64.go", "Go", 1707, 0, 0, 0, 0, 0, 547, 2254
"/opt/projects/swiftkube/vendor/golang.org/x/sys/unix/zsyscall_openbsd_arm.go", "Go", 1706, 0, 0, 0, 0, 0, 546, 2252
"/opt/projects/swiftkube/vendor/golang.org/x/sys/unix/zsyscall_openbsd_arm64.go", "Go", 1706, 0, 0, 0, 0, 0, 546, 2252
"/opt/projects/swiftkube/vendor/golang.org/x/sys/unix/zsyscall_openbsd_mips64.go", "Go", 1706, 0, 0, 0, 0, 0, 546, 2252
"/opt/projects/swiftkube/vendor/golang.org/x/sys/unix/zsyscall_openbsd_ppc64.go", "Go", 1706, 0, 0, 0, 0, 0, 546, 2252
"/opt/projects/swiftkube/vendor/golang.org/x/sys/unix/zsyscall_openbsd_riscv64.go", "Go", 1706, 0, 0, 0, 0, 0, 546, 2252
"/opt/projects/swiftkube/vendor/golang.org/x/sys/unix/zsyscall_solaris_amd64.go", "Go", 1820, 0, 0, 0, 0, 0, 285, 2105
"/opt/projects/swiftkube/vendor/golang.org/x/sys/unix/zsyscall_zos_s390x.go", "Go", 1056, 0, 0, 0, 0, 0, 210, 1266
"/opt/projects/swiftkube/vendor/golang.org/x/sys/unix/zsysctl_openbsd_386.go", "Go", 277, 0, 0, 0, 0, 0, 5, 282
"/opt/projects/swiftkube/vendor/golang.org/x/sys/unix/zsysctl_openbsd_amd64.go", "Go", 277, 0, 0, 0, 0, 0, 5, 282
"/opt/projects/swiftkube/vendor/golang.org/x/sys/unix/zsysctl_openbsd_arm.go", "Go", 277, 0, 0, 0, 0, 0, 5, 282
"/opt/projects/swiftkube/vendor/golang.org/x/sys/unix/zsysctl_openbsd_arm64.go", "Go", 277, 0, 0, 0, 0, 0, 5, 282
"/opt/projects/swiftkube/vendor/golang.org/x/sys/unix/zsysctl_openbsd_mips64.go", "Go", 277, 0, 0, 0, 0, 0, 5, 282
"/opt/projects/swiftkube/vendor/golang.org/x/sys/unix/zsysctl_openbsd_ppc64.go", "Go", 277, 0, 0, 0, 0, 0, 5, 282
"/opt/projects/swiftkube/vendor/golang.org/x/sys/unix/zsysctl_openbsd_riscv64.go", "Go", 278, 0, 0, 0, 0, 0, 5, 283
"/opt/projects/swiftkube/vendor/golang.org/x/sys/unix/zsysnum_darwin_amd64.go", "Go", 437, 0, 0, 0, 0, 0, 4, 441
"/opt/projects/swiftkube/vendor/golang.org/x/sys/unix/zsysnum_darwin_arm64.go", "Go", 435, 0, 0, 0, 0, 0, 4, 439
"/opt/projects/swiftkube/vendor/golang.org/x/sys/unix/zsysnum_dragonfly_amd64.go", "Go", 314, 0, 0, 0, 0, 0, 4, 318
"/opt/projects/swiftkube/vendor/golang.org/x/sys/unix/zsysnum_freebsd_386.go", "Go", 391, 0, 0, 0, 0, 0, 4, 395
"/opt/projects/swiftkube/vendor/golang.org/x/sys/unix/zsysnum_freebsd_amd64.go", "Go", 391, 0, 0, 0, 0, 0, 4, 395
"/opt/projects/swiftkube/vendor/golang.org/x/sys/unix/zsysnum_freebsd_arm.go", "Go", 391, 0, 0, 0, 0, 0, 4, 395
"/opt/projects/swiftkube/vendor/golang.org/x/sys/unix/zsysnum_freebsd_arm64.go", "Go", 391, 0, 0, 0, 0, 0, 4, 395
"/opt/projects/swiftkube/vendor/golang.org/x/sys/unix/zsysnum_freebsd_riscv64.go", "Go", 391, 0, 0, 0, 0, 0, 4, 395
"/opt/projects/swiftkube/vendor/golang.org/x/sys/unix/zsysnum_linux_386.go", "Go", 447, 0, 0, 0, 0, 0, 4, 451
"/opt/projects/swiftkube/vendor/golang.org/x/sys/unix/zsysnum_linux_amd64.go", "Go", 369, 0, 0, 0, 0, 0, 4, 373
"/opt/projects/swiftkube/vendor/golang.org/x/sys/unix/zsysnum_linux_arm.go", "Go", 411, 0, 0, 0, 0, 0, 4, 415
"/opt/projects/swiftkube/vendor/golang.org/x/sys/unix/zsysnum_linux_arm64.go", "Go", 314, 0, 0, 0, 0, 0, 4, 318
"/opt/projects/swiftkube/vendor/golang.org/x/sys/unix/zsysnum_linux_loong64.go", "Go", 308, 0, 0, 0, 0, 0, 4, 312
"/opt/projects/swiftkube/vendor/golang.org/x/sys/unix/zsysnum_linux_mips.go", "Go", 431, 0, 0, 0, 0, 0, 4, 435
"/opt/projects/swiftkube/vendor/golang.org/x/sys/unix/zsysnum_linux_mips64.go", "Go", 361, 0, 0, 0, 0, 0, 4, 365
"/opt/projects/swiftkube/vendor/golang.org/x/sys/unix/zsysnum_linux_mips64le.go", "Go", 361, 0, 0, 0, 0, 0, 4, 365
"/opt/projects/swiftkube/vendor/golang.org/x/sys/unix/zsysnum_linux_mipsle.go", "Go", 431, 0, 0, 0, 0, 0, 4, 435
"/opt/projects/swiftkube/vendor/golang.org/x/sys/unix/zsysnum_linux_ppc.go", "Go", 438, 0, 0, 0, 0, 0, 4, 442
"/opt/projects/swiftkube/vendor/golang.org/x/sys/unix/zsysnum_linux_ppc64.go", "Go", 410, 0, 0, 0, 0, 0, 4, 414
"/opt/projects/swiftkube/vendor/golang.org/x/sys/unix/zsysnum_linux_ppc64le.go", "Go", 410, 0, 0, 0, 0, 0, 4, 414
"/opt/projects/swiftkube/vendor/golang.org/x/sys/unix/zsysnum_linux_riscv64.go", "Go", 313, 0, 0, 0, 0, 0, 4, 317
"/opt/projects/swiftkube/vendor/golang.org/x/sys/unix/zsysnum_linux_s390x.go", "Go", 376, 0, 0, 0, 0, 0, 4, 380
"/opt/projects/swiftkube/vendor/golang.org/x/sys/unix/zsysnum_linux_sparc64.go", "Go", 389, 0, 0, 0, 0, 0, 4, 393
"/opt/projects/swiftkube/vendor/golang.org/x/sys/unix/zsysnum_netbsd_386.go", "Go", 272, 0, 0, 0, 0, 0, 4, 276
"/opt/projects/swiftkube/vendor/golang.org/x/sys/unix/zsysnum_netbsd_amd64.go", "Go", 272, 0, 0, 0, 0, 0, 4, 276
"/opt/projects/swiftkube/vendor/golang.org/x/sys/unix/zsysnum_netbsd_arm.go", "Go", 272, 0, 0, 0, 0, 0, 4, 276
"/opt/projects/swiftkube/vendor/golang.org/x/sys/unix/zsysnum_netbsd_arm64.go", "Go", 272, 0, 0, 0, 0, 0, 4, 276
"/opt/projects/swiftkube/vendor/golang.org/x/sys/unix/zsysnum_openbsd_386.go", "Go", 217, 0, 0, 0, 0, 0, 4, 221
"/opt/projects/swiftkube/vendor/golang.org/x/sys/unix/zsysnum_openbsd_amd64.go", "Go", 217, 0, 0, 0, 0, 0, 4, 221
"/opt/projects/swiftkube/vendor/golang.org/x/sys/unix/zsysnum_openbsd_arm.go", "Go", 217, 0, 0, 0, 0, 0, 4, 221
"/opt/projects/swiftkube/vendor/golang.org/x/sys/unix/zsysnum_openbsd_arm64.go", "Go", 216, 0, 0, 0, 0, 0, 4, 220
"/opt/projects/swiftkube/vendor/golang.org/x/sys/unix/zsysnum_openbsd_mips64.go", "Go", 219, 0, 0, 0, 0, 0, 4, 223
"/opt/projects/swiftkube/vendor/golang.org/x/sys/unix/zsysnum_openbsd_ppc64.go", "Go", 215, 0, 0, 0, 0, 0, 4, 219
"/opt/projects/swiftkube/vendor/golang.org/x/sys/unix/zsysnum_openbsd_riscv64.go", "Go", 216, 0, 0, 0, 0, 0, 4, 220
"/opt/projects/swiftkube/vendor/golang.org/x/sys/unix/zsysnum_zos_s390x.go", "Go", 2666, 0, 0, 0, 0, 0, 5, 2671
"/opt/projects/swiftkube/vendor/golang.org/x/sys/unix/ztypes_aix_ppc.go", "Go", 300, 0, 0, 0, 0, 0, 55, 355
"/opt/projects/swiftkube/vendor/golang.org/x/sys/unix/ztypes_aix_ppc64.go", "Go", 304, 0, 0, 0, 0, 0, 55, 359
"/opt/projects/swiftkube/vendor/golang.org/x/sys/unix/ztypes_darwin_amd64.go", "Go", 719, 0, 0, 0, 0, 0, 88, 807
"/opt/projects/swiftkube/vendor/golang.org/x/sys/unix/ztypes_darwin_arm64.go", "Go", 719, 0, 0, 0, 0, 0, 88, 807
"/opt/projects/swiftkube/vendor/golang.org/x/sys/unix/ztypes_dragonfly_amd64.go", "Go", 417, 0, 0, 0, 0, 0, 58, 475
"/opt/projects/swiftkube/vendor/golang.org/x/sys/unix/ztypes_freebsd_386.go", "Go", 577, 0, 0, 0, 0, 0, 75, 652
"/opt/projects/swiftkube/vendor/golang.org/x/sys/unix/ztypes_freebsd_amd64.go", "Go", 581, 0, 0, 0, 0, 0, 76, 657
"/opt/projects/swiftkube/vendor/golang.org/x/sys/unix/ztypes_freebsd_arm.go", "Go", 567, 0, 0, 0, 0, 0, 76, 643
"/opt/projects/swiftkube/vendor/golang.org/x/sys/unix/ztypes_freebsd_arm64.go", "Go", 561, 0, 0, 0, 0, 0, 76, 637
"/opt/projects/swiftkube/vendor/golang.org/x/sys/unix/ztypes_freebsd_riscv64.go", "Go", 563, 0, 0, 0, 0, 0, 76, 639
"/opt/projects/swiftkube/vendor/golang.org/x/sys/unix/ztypes_linux.go", "Go", 5634, 0, 0, 0, 0, 0, 232, 5866
"/opt/projects/swiftkube/vendor/golang.org/x/sys/unix/ztypes_linux_386.go", "Go", 621, 0, 0, 0, 0, 0, 78, 699
"/opt/projects/swiftkube/vendor/golang.org/x/sys/unix/ztypes_linux_amd64.go", "Go", 636, 0, 0, 0, 0, 0, 78, 714
"/opt/projects/swiftkube/vendor/golang.org/x/sys/unix/ztypes_linux_arm.go", "Go", 616, 0, 0, 0, 0, 0, 78, 694
"/opt/projects/swiftkube/vendor/golang.org/x/sys/unix/ztypes_linux_arm64.go", "Go", 615, 0, 0, 0, 0, 0, 78, 693
"/opt/projects/swiftkube/vendor/golang.org/x/sys/unix/ztypes_linux_loong64.go", "Go", 616, 0, 0, 0, 0, 0, 78, 694
"/opt/projects/swiftkube/vendor/golang.org/x/sys/unix/ztypes_linux_mips.go", "Go", 621, 0, 0, 0, 0, 0, 78, 699
"/opt/projects/swiftkube/vendor/golang.org/x/sys/unix/ztypes_linux_mips64.go", "Go", 618, 0, 0, 0, 0, 0, 78, 696
"/opt/projects/swiftkube/vendor/golang.org/x/sys/unix/ztypes_linux_mips64le.go", "Go", 618, 0, 0, 0, 0, 0, 78, 696
"/opt/projects/swiftkube/vendor/golang.org/x/sys/unix/ztypes_linux_mipsle.go", "Go", 621, 0, 0, 0, 0, 0, 78, 699
"/opt/projects/swiftkube/vendor/golang.org/x/sys/unix/ztypes_linux_ppc.go", "Go", 629, 0, 0, 0, 0, 0, 78, 707
"/opt/projects/swiftkube/vendor/golang.org/x/sys/unix/ztypes_linux_ppc64.go", "Go", 624, 0, 0, 0, 0, 0, 78, 702
"/opt/projects/swiftkube/vendor/golang.org/x/sys/unix/ztypes_linux_ppc64le.go", "Go", 624, 0, 0, 0, 0, 0, 78, 702
"/opt/projects/swiftkube/vendor/golang.org/x/sys/unix/ztypes_linux_riscv64.go", "Go", 643, 0, 0, 0, 0, 0, 78, 721
"/opt/projects/swiftkube/vendor/golang.org/x/sys/unix/ztypes_linux_s390x.go", "Go", 635, 0, 0, 0, 0, 0, 81, 716
"/opt/projects/swiftkube/vendor/golang.org/x/sys/unix/ztypes_linux_sparc64.go", "Go", 619, 0, 0, 0, 0, 0, 78, 697
"/opt/projects/swiftkube/vendor/golang.org/x/sys/unix/ztypes_netbsd_386.go", "Go", 521, 0, 0, 0, 0, 0, 66, 587
"/opt/projects/swiftkube/vendor/golang.org/x/sys/unix/ztypes_netbsd_amd64.go", "Go", 529, 0, 0, 0, 0, 0, 66, 595
"/opt/projects/swiftkube/vendor/golang.org/x/sys/unix/ztypes_netbsd_arm.go", "Go", 526, 0, 0, 0, 0, 0, 66, 592
"/opt/projects/swiftkube/vendor/golang.org/x/sys/unix/ztypes_netbsd_arm64.go", "Go", 529, 0, 0, 0, 0, 0, 66, 595
"/opt/projects/swiftkube/vendor/golang.org/x/sys/unix/ztypes_openbsd_386.go", "Go", 509, 0, 0, 0, 0, 0, 61, 570
"/opt/projects/swiftkube/vendor/golang.org/x/sys/unix/ztypes_openbsd_amd64.go", "Go", 509, 0, 0, 0, 0, 0, 61, 570
"/opt/projects/swiftkube/vendor/golang.org/x/sys/unix/ztypes_openbsd_arm.go", "Go", 516, 0, 0, 0, 0, 0, 61, 577
"/opt/projects/swiftkube/vendor/golang.org/x/sys/unix/ztypes_openbsd_arm64.go", "Go", 509, 0, 0, 0, 0, 0, 61, 570
"/opt/projects/swiftkube/vendor/golang.org/x/sys/unix/ztypes_openbsd_mips64.go", "Go", 509, 0, 0, 0, 0, 0, 61, 570
"/opt/projects/swiftkube/vendor/golang.org/x/sys/unix/ztypes_openbsd_ppc64.go", "Go", 510, 0, 0, 0, 0, 0, 62, 572
"/opt/projects/swiftkube/vendor/golang.org/x/sys/unix/ztypes_openbsd_riscv64.go", "Go", 510, 0, 0, 0, 0, 0, 62, 572
"/opt/projects/swiftkube/vendor/golang.org/x/sys/unix/ztypes_solaris_amd64.go", "Go", 451, 0, 0, 0, 0, 0, 67, 518
"/opt/projects/swiftkube/vendor/golang.org/x/sys/unix/ztypes_zos_s390x.go", "Go", 368, 0, 0, 0, 0, 0, 48, 416
"/opt/projects/swiftkube/vendor/golang.org/x/sys/windows/aliases.go", "Go", 9, 0, 0, 0, 0, 0, 5, 14
"/opt/projects/swiftkube/vendor/golang.org/x/sys/windows/dll_windows.go", "Go", 371, 0, 0, 0, 0, 0, 46, 417
"/opt/projects/swiftkube/vendor/golang.org/x/sys/windows/env_windows.go", "Go", 45, 0, 0, 0, 0, 0, 10, 55
"/opt/projects/swiftkube/vendor/golang.org/x/sys/windows/eventlog.go", "Go", 17, 0, 0, 0, 0, 0, 5, 22
"/opt/projects/swiftkube/vendor/golang.org/x/sys/windows/exec_windows.go", "Go", 170, 0, 0, 0, 0, 0, 14, 184
"/opt/projects/swiftkube/vendor/golang.org/x/sys/windows/memory_windows.go", "Go", 43, 0, 0, 0, 0, 0, 6, 49
"/opt/projects/swiftkube/vendor/golang.org/x/sys/windows/mksyscall.go", "Go", 7, 0, 0, 0, 0, 0, 4, 11
"/opt/projects/swiftkube/vendor/golang.org/x/sys/windows/race.go", "Go", 23, 0, 0, 0, 0, 0, 9, 32
"/opt/projects/swiftkube/vendor/golang.org/x/sys/windows/race0.go", "Go", 18, 0, 0, 0, 0, 0, 9, 27
"/opt/projects/swiftkube/vendor/golang.org/x/sys/windows/registry/key.go", "Go", 190, 0, 0, 0, 0, 0, 17, 207
"/opt/projects/swiftkube/vendor/golang.org/x/sys/windows/registry/mksyscall.go", "Go", 7, 0, 0, 0, 0, 0, 4, 11
"/opt/projects/swiftkube/vendor/golang.org/x/sys/windows/registry/syscall.go", "Go", 24, 0, 0, 0, 0, 0, 10, 34
"/opt/projects/swiftkube/vendor/golang.org/x/sys/windows/registry/value.go", "Go", 353, 0, 0, 0, 0, 0, 35, 388
"/opt/projects/swiftkube/vendor/golang.org/x/sys/windows/registry/zsyscall_windows.go", "Go", 100, 0, 0, 0, 0, 0, 18, 118
"/opt/projects/swiftkube/vendor/golang.org/x/sys/windows/security_windows.go", "Go", 1306, 0, 0, 0, 0, 0, 139, 1445
"/opt/projects/swiftkube/vendor/golang.org/x/sys/windows/service.go", "Go", 223, 0, 0, 0, 0, 0, 36, 259
"/opt/projects/swiftkube/vendor/golang.org/x/sys/windows/setupapi_windows.go", "Go", 1231, 0, 0, 0, 0, 0, 195, 1426
"/opt/projects/swiftkube/vendor/golang.org/x/sys/windows/str.go", "Go", 20, 0, 0, 0, 0, 0, 4, 24
"/opt/projects/swiftkube/vendor/golang.org/x/sys/windows/svc/security.go", "Go", 89, 0, 0, 0, 0, 0, 13, 102
"/opt/projects/swiftkube/vendor/golang.org/x/sys/windows/svc/service.go", "Go", 288, 0, 0, 0, 0, 0, 35, 323
"/opt/projects/swiftkube/vendor/golang.org/x/sys/windows/syscall.go", "Go", 91, 0, 0, 0, 0, 0, 15, 106
"/opt/projects/swiftkube/vendor/golang.org/x/sys/windows/syscall_windows.go", "Go", 1626, 0, 0, 0, 0, 0, 194, 1820
"/opt/projects/swiftkube/vendor/golang.org/x/sys/windows/types_windows.go", "Go", 3015, 0, 0, 0, 0, 0, 335, 3350
"/opt/projects/swiftkube/vendor/golang.org/x/sys/windows/types_windows_386.go", "Go", 31, 0, 0, 0, 0, 0, 5, 36
"/opt/projects/swiftkube/vendor/golang.org/x/sys/windows/types_windows_amd64.go", "Go", 30, 0, 0, 0, 0, 0, 5, 35
"/opt/projects/swiftkube/vendor/golang.org/x/sys/windows/types_windows_arm.go", "Go", 31, 0, 0, 0, 0, 0, 5, 36
"/opt/projects/swiftkube/vendor/golang.org/x/sys/windows/types_windows_arm64.go", "Go", 30, 0, 0, 0, 0, 0, 5, 35
"/opt/projects/swiftkube/vendor/golang.org/x/sys/windows/zerrors_windows.go", "Go", 9465, 0, 0, 0, 0, 0, 4, 9469
"/opt/projects/swiftkube/vendor/golang.org/x/sys/windows/zknownfolderids_windows.go", "Go", 146, 0, 0, 0, 0, 0, 4, 150
"/opt/projects/swiftkube/vendor/golang.org/x/sys/windows/zsyscall_windows.go", "Go", 3874, 0, 0, 0, 0, 0, 468, 4342
"/opt/projects/swiftkube/vendor/golang.org/x/term/term.go", "Go", 52, 0, 0, 0, 0, 0, 9, 61
"/opt/projects/swiftkube/vendor/golang.org/x/term/term_plan9.go", "Go", 32, 0, 0, 0, 0, 0, 11, 43
"/opt/projects/swiftkube/vendor/golang.org/x/term/term_unix.go", "Go", 73, 0, 0, 0, 0, 0, 20, 93
"/opt/projects/swiftkube/vendor/golang.org/x/term/term_unix_bsd.go", "Go", 9, 0, 0, 0, 0, 0, 5, 14
"/opt/projects/swiftkube/vendor/golang.org/x/term/term_unix_other.go", "Go", 9, 0, 0, 0, 0, 0, 5, 14
"/opt/projects/swiftkube/vendor/golang.org/x/term/term_unsupported.go", "Go", 29, 0, 0, 0, 0, 0, 11, 40
"/opt/projects/swiftkube/vendor/golang.org/x/term/term_windows.go", "Go", 65, 0, 0, 0, 0, 0, 15, 80
"/opt/projects/swiftkube/vendor/golang.org/x/term/terminal.go", "Go", 873, 0, 0, 0, 0, 0, 114, 987
"/opt/projects/swiftkube/vendor/golang.org/x/text/encoding/encoding.go", "Go", 291, 0, 0, 0, 0, 0, 45, 336
"/opt/projects/swiftkube/vendor/golang.org/x/text/encoding/internal/identifier/identifier.go", "Go", 70, 0, 0, 0, 0, 0, 12, 82
"/opt/projects/swiftkube/vendor/golang.org/x/text/encoding/internal/identifier/mib.go", "Go", 1368, 0, 0, 0, 0, 0, 260, 1628
"/opt/projects/swiftkube/vendor/golang.org/x/text/encoding/internal/internal.go", "Go", 59, 0, 0, 0, 0, 0, 17, 76
"/opt/projects/swiftkube/vendor/golang.org/x/text/encoding/unicode/override.go", "Go", 74, 0, 0, 0, 0, 0, 9, 83
"/opt/projects/swiftkube/vendor/golang.org/x/text/encoding/unicode/unicode.go", "Go", 455, 0, 0, 0, 0, 0, 58, 513
"/opt/projects/swiftkube/vendor/golang.org/x/text/feature/plural/common.go", "Go", 61, 0, 0, 0, 0, 0, 10, 71
"/opt/projects/swiftkube/vendor/golang.org/x/text/feature/plural/message.go", "Go", 225, 0, 0, 0, 0, 0, 20, 245
"/opt/projects/swiftkube/vendor/golang.org/x/text/feature/plural/plural.go", "Go", 222, 0, 0, 0, 0, 0, 41, 263
"/opt/projects/swiftkube/vendor/golang.org/x/text/feature/plural/tables.go", "Go", 539, 0, 0, 0, 0, 0, 14, 553
"/opt/projects/swiftkube/vendor/golang.org/x/text/internal/catmsg/catmsg.go", "Go", 387, 0, 0, 0, 0, 0, 31, 418
"/opt/projects/swiftkube/vendor/golang.org/x/text/internal/catmsg/codec.go", "Go", 359, 0, 0, 0, 0, 0, 49, 408
"/opt/projects/swiftkube/vendor/golang.org/x/text/internal/catmsg/varint.go", "Go", 54, 0, 0, 0, 0, 0, 9, 63
"/opt/projects/swiftkube/vendor/golang.org/x/text/internal/format/format.go", "Go", 33, 0, 0, 0, 0, 0, 9, 42
"/opt/projects/swiftkube/vendor/golang.org/x/text/internal/format/parser.go", "Go", 320, 0, 0, 0, 0, 0, 39, 359
"/opt/projects/swiftkube/vendor/golang.org/x/text/internal/internal.go", "Go", 40, 0, 0, 0, 0, 0, 10, 50
"/opt/projects/swiftkube/vendor/golang.org/x/text/internal/language/common.go", "Go", 11, 0, 0, 0, 0, 0, 6, 17
"/opt/projects/swiftkube/vendor/golang.org/x/text/internal/language/compact.go", "Go", 25, 0, 0, 0, 0, 0, 5, 30
"/opt/projects/swiftkube/vendor/golang.org/x/text/internal/language/compact/compact.go", "Go", 52, 0, 0, 0, 0, 0, 10, 62
"/opt/projects/swiftkube/vendor/golang.org/x/text/internal/language/compact/language.go", "Go", 237, 0, 0, 0, 0, 0, 24, 261
"/opt/projects/swiftkube/vendor/golang.org/x/text/internal/language/compact/parents.go", "Go", 117, 0, 0, 0, 0, 0, 4, 121
"/opt/projects/swiftkube/vendor/golang.org/x/text/internal/language/compact/tables.go", "Go", 1008, 0, 0, 0, 0, 0, 8, 1016
"/opt/projects/swiftkube/vendor/golang.org/x/text/internal/language/compact/tags.go", "Go", 87, 0, 0, 0, 0, 0, 5, 92
"/opt/projects/swiftkube/vendor/golang.org/x/text/internal/language/compose.go", "Go", 147, 0, 0, 0, 0, 0, 21, 168
"/opt/projects/swiftkube/vendor/golang.org/x/text/internal/language/coverage.go", "Go", 26, 0, 0, 0, 0, 0, 3, 29
"/opt/projects/swiftkube/vendor/golang.org/x/text/internal/language/language.go", "Go", 563, 0, 0, 0, 0, 0, 65, 628
"/opt/projects/swiftkube/vendor/golang.org/x/text/internal/language/lookup.go", "Go", 369, 0, 0, 0, 0, 0, 44, 413
"/opt/projects/swiftkube/vendor/golang.org/x/text/internal/language/match.go", "Go", 210, 0, 0, 0, 0, 0, 17, 227
"/opt/projects/swiftkube/vendor/golang.org/x/text/internal/language/parse.go", "Go", 567, 0, 0, 0, 0, 0, 42, 609
"/opt/projects/swiftkube/vendor/golang.org/x/text/internal/language/tables.go", "Go", 3444, 0, 0, 0, 0, 0, 51, 3495
"/opt/projects/swiftkube/vendor/golang.org/x/text/internal/language/tags.go", "Go", 42, 0, 0, 0, 0, 0, 7, 49
"/opt/projects/swiftkube/vendor/golang.org/x/text/internal/match.go", "Go", 60, 0, 0, 0, 0, 0, 8, 68
"/opt/projects/swiftkube/vendor/golang.org/x/text/internal/number/common.go", "Go", 44, 0, 0, 0, 0, 0, 12, 56
"/opt/projects/swiftkube/vendor/golang.org/x/text/internal/number/decimal.go", "Go", 464, 0, 0, 0, 0, 0, 37, 501
"/opt/projects/swiftkube/vendor/golang.org/x/text/internal/number/format.go", "Go", 489, 0, 0, 0, 0, 0, 47, 536
"/opt/projects/swiftkube/vendor/golang.org/x/text/internal/number/number.go", "Go", 138, 0, 0, 0, 0, 0, 15, 153
"/opt/projects/swiftkube/vendor/golang.org/x/text/internal/number/pattern.go", "Go", 433, 0, 0, 0, 0, 0, 53, 486
"/opt/projects/swiftkube/vendor/golang.org/x/text/internal/number/roundingmode_string.go", "Go", 24, 0, 0, 0, 0, 0, 7, 31
"/opt/projects/swiftkube/vendor/golang.org/x/text/internal/number/tables.go", "Go", 1204, 0, 0, 0, 0, 0, 16, 1220
"/opt/projects/swiftkube/vendor/golang.org/x/text/internal/stringset/set.go", "Go", 74, 0, 0, 0, 0, 0, 13, 87
"/opt/projects/swiftkube/vendor/golang.org/x/text/internal/tag/tag.go", "Go", 91, 0, 0, 0, 0, 0, 10, 101
"/opt/projects/swiftkube/vendor/golang.org/x/text/internal/utf8internal/utf8internal.go", "Go", 77, 0, 0, 0, 0, 0, 11, 88
"/opt/projects/swiftkube/vendor/golang.org/x/text/language/coverage.go", "Go", 163, 0, 0, 0, 0, 0, 25, 188
"/opt/projects/swiftkube/vendor/golang.org/x/text/language/doc.go", "Go", 96, 0, 0, 0, 0, 0, 3, 99
"/opt/projects/swiftkube/vendor/golang.org/x/text/language/language.go", "Go", 530, 0, 0, 0, 0, 0, 76, 606
"/opt/projects/swiftkube/vendor/golang.org/x/text/language/match.go", "Go", 687, 0, 0, 0, 0, 0, 49, 736
"/opt/projects/swiftkube/vendor/golang.org/x/text/language/parse.go", "Go", 228, 0, 0, 0, 0, 0, 29, 257
"/opt/projects/swiftkube/vendor/golang.org/x/text/language/tables.go", "Go", 288, 0, 0, 0, 0, 0, 11, 299
"/opt/projects/swiftkube/vendor/golang.org/x/text/language/tags.go", "Go", 134, 0, 0, 0, 0, 0, 12, 146
"/opt/projects/swiftkube/vendor/golang.org/x/text/message/catalog.go", "Go", 28, 0, 0, 0, 0, 0, 9, 37
"/opt/projects/swiftkube/vendor/golang.org/x/text/message/catalog/catalog.go", "Go", 334, 0, 0, 0, 0, 0, 32, 366
"/opt/projects/swiftkube/vendor/golang.org/x/text/message/catalog/dict.go", "Go", 109, 0, 0, 0, 0, 0, 21, 130
"/opt/projects/swiftkube/vendor/golang.org/x/text/message/catalog/go19.go", "Go", 11, 0, 0, 0, 0, 0, 6, 17
"/opt/projects/swiftkube/vendor/golang.org/x/text/message/catalog/gopre19.go", "Go", 19, 0, 0, 0, 0, 0, 6, 25
"/opt/projects/swiftkube/vendor/golang.org/x/text/message/doc.go", "Go", 98, 0, 0, 0, 0, 0, 2, 100
"/opt/projects/swiftkube/vendor/golang.org/x/text/message/format.go", "Go", 474, 0, 0, 0, 0, 0, 37, 511
"/opt/projects/swiftkube/vendor/golang.org/x/text/message/message.go", "Go", 163, 0, 0, 0, 0, 0, 31, 194
"/opt/projects/swiftkube/vendor/golang.org/x/text/message/print.go", "Go", 918, 0, 0, 0, 0, 0, 67, 985
"/opt/projects/swiftkube/vendor/golang.org/x/text/runes/cond.go", "Go", 173, 0, 0, 0, 0, 0, 15, 188
"/opt/projects/swiftkube/vendor/golang.org/x/text/runes/runes.go", "Go", 311, 0, 0, 0, 0, 0, 45, 356
"/opt/projects/swiftkube/vendor/golang.org/x/text/secure/bidirule/bidirule.go", "Go", 307, 0, 0, 0, 0, 0, 30, 337
"/opt/projects/swiftkube/vendor/golang.org/x/text/secure/bidirule/bidirule10.0.0.go", "Go", 9, 0, 0, 0, 0, 0, 4, 13
"/opt/projects/swiftkube/vendor/golang.org/x/text/secure/bidirule/bidirule9.0.0.go", "Go", 12, 0, 0, 0, 0, 0, 4, 16
"/opt/projects/swiftkube/vendor/golang.org/x/text/transform/transform.go", "Go", 639, 0, 0, 0, 0, 0, 71, 710
"/opt/projects/swiftkube/vendor/golang.org/x/text/unicode/bidi/bidi.go", "Go", 312, 0, 0, 0, 0, 0, 48, 360
"/opt/projects/swiftkube/vendor/golang.org/x/text/unicode/bidi/bracket.go", "Go", 300, 0, 0, 0, 0, 0, 36, 336
"/opt/projects/swiftkube/vendor/golang.org/x/text/unicode/bidi/core.go", "Go", 945, 0, 0, 0, 0, 0, 127, 1072
"/opt/projects/swiftkube/vendor/golang.org/x/text/unicode/bidi/prop.go", "Go", 192, 0, 0, 0, 0, 0, 15, 207
"/opt/projects/swiftkube/vendor/golang.org/x/text/unicode/bidi/tables10.0.0.go", "Go", 1802, 0, 0, 0, 0, 0, 15, 1817
"/opt/projects/swiftkube/vendor/golang.org/x/text/unicode/bidi/tables11.0.0.go", "Go", 1874, 0, 0, 0, 0, 0, 15, 1889
"/opt/projects/swiftkube/vendor/golang.org/x/text/unicode/bidi/tables12.0.0.go", "Go", 1910, 0, 0, 0, 0, 0, 15, 1925
"/opt/projects/swiftkube/vendor/golang.org/x/text/unicode/bidi/tables13.0.0.go", "Go", 1942, 0, 0, 0, 0, 0, 15, 1957
"/opt/projects/swiftkube/vendor/golang.org/x/text/unicode/bidi/tables15.0.0.go", "Go", 2029, 0, 0, 0, 0, 0, 15, 2044
"/opt/projects/swiftkube/vendor/golang.org/x/text/unicode/bidi/tables9.0.0.go", "Go", 1768, 0, 0, 0, 0, 0, 15, 1783
"/opt/projects/swiftkube/vendor/golang.org/x/text/unicode/bidi/trieval.go", "Go", 40, 0, 0, 0, 0, 0, 9, 49
"/opt/projects/swiftkube/vendor/golang.org/x/text/unicode/norm/composition.go", "Go", 463, 0, 0, 0, 0, 0, 50, 513
"/opt/projects/swiftkube/vendor/golang.org/x/text/unicode/norm/forminfo.go", "Go", 247, 0, 0, 0, 0, 0, 33, 280
"/opt/projects/swiftkube/vendor/golang.org/x/text/unicode/norm/input.go", "Go", 94, 0, 0, 0, 0, 0, 16, 110
"/opt/projects/swiftkube/vendor/golang.org/x/text/unicode/norm/iter.go", "Go", 432, 0, 0, 0, 0, 0, 27, 459
"/opt/projects/swiftkube/vendor/golang.org/x/text/unicode/norm/normalize.go", "Go", 575, 0, 0, 0, 0, 0, 36, 611
"/opt/projects/swiftkube/vendor/golang.org/x/text/unicode/norm/readwriter.go", "Go", 113, 0, 0, 0, 0, 0, 13, 126
"/opt/projects/swiftkube/vendor/golang.org/x/text/unicode/norm/tables10.0.0.go", "Go", 7626, 0, 0, 0, 0, 0, 33, 7659
"/opt/projects/swiftkube/vendor/golang.org/x/text/unicode/norm/tables11.0.0.go", "Go", 7662, 0, 0, 0, 0, 0, 33, 7695
"/opt/projects/swiftkube/vendor/golang.org/x/text/unicode/norm/tables12.0.0.go", "Go", 7679, 0, 0, 0, 0, 0, 33, 7712
"/opt/projects/swiftkube/vendor/golang.org/x/text/unicode/norm/tables13.0.0.go", "Go", 7729, 0, 0, 0, 0, 0, 33, 7762
"/opt/projects/swiftkube/vendor/golang.org/x/text/unicode/norm/tables15.0.0.go", "Go", 7876, 0, 0, 0, 0, 0, 33, 7909
"/opt/projects/swiftkube/vendor/golang.org/x/text/unicode/norm/tables9.0.0.go", "Go", 7606, 0, 0, 0, 0, 0, 33, 7639
"/opt/projects/swiftkube/vendor/golang.org/x/text/unicode/norm/transform.go", "Go", 78, 0, 0, 0, 0, 0, 11, 89
"/opt/projects/swiftkube/vendor/golang.org/x/text/unicode/norm/trie.go", "Go", 47, 0, 0, 0, 0, 0, 8, 55
"/opt/projects/swiftkube/vendor/golang.org/x/text/width/kind_string.go", "Go", 22, 0, 0, 0, 0, 0, 7, 29
"/opt/projects/swiftkube/vendor/golang.org/x/text/width/tables10.0.0.go", "Go", 1315, 0, 0, 0, 0, 0, 15, 1330
"/opt/projects/swiftkube/vendor/golang.org/x/text/width/tables11.0.0.go", "Go", 1327, 0, 0, 0, 0, 0, 15, 1342
"/opt/projects/swiftkube/vendor/golang.org/x/text/width/tables12.0.0.go", "Go", 1347, 0, 0, 0, 0, 0, 15, 1362
"/opt/projects/swiftkube/vendor/golang.org/x/text/width/tables13.0.0.go", "Go", 1348, 0, 0, 0, 0, 0, 15, 1363
"/opt/projects/swiftkube/vendor/golang.org/x/text/width/tables15.0.0.go", "Go", 1354, 0, 0, 0, 0, 0, 15, 1369
"/opt/projects/swiftkube/vendor/golang.org/x/text/width/tables9.0.0.go", "Go", 1283, 0, 0, 0, 0, 0, 15, 1298
"/opt/projects/swiftkube/vendor/golang.org/x/text/width/transform.go", "Go", 227, 0, 0, 0, 0, 0, 13, 240
"/opt/projects/swiftkube/vendor/golang.org/x/text/width/trieval.go", "Go", 24, 0, 0, 0, 0, 0, 7, 31
"/opt/projects/swiftkube/vendor/golang.org/x/text/width/width.go", "Go", 170, 0, 0, 0, 0, 0, 37, 207
"/opt/projects/swiftkube/vendor/golang.org/x/time/rate/rate.go", "Go", 377, 0, 0, 0, 0, 0, 52, 429
"/opt/projects/swiftkube/vendor/golang.org/x/time/rate/sometimes.go", "Go", 62, 0, 0, 0, 0, 0, 6, 68
"/opt/projects/swiftkube/vendor/golang.org/x/tools/cmd/stringer/stringer.go", "Go", 611, 0, 0, 0, 0, 0, 47, 658
"/opt/projects/swiftkube/vendor/golang.org/x/tools/go/ast/astutil/enclosing.go", "Go", 549, 0, 0, 0, 0, 0, 88, 637
"/opt/projects/swiftkube/vendor/golang.org/x/tools/go/ast/astutil/imports.go", "Go", 436, 0, 0, 0, 0, 0, 50, 486
"/opt/projects/swiftkube/vendor/golang.org/x/tools/go/ast/astutil/rewrite.go", "Go", 404, 0, 0, 0, 0, 0, 85, 489
"/opt/projects/swiftkube/vendor/golang.org/x/tools/go/ast/astutil/util.go", "Go", 15, 0, 0, 0, 0, 0, 4, 19
"/opt/projects/swiftkube/vendor/golang.org/x/tools/go/gcexportdata/gcexportdata.go", "Go", 171, 0, 0, 0, 0, 0, 17, 188
"/opt/projects/swiftkube/vendor/golang.org/x/tools/go/gcexportdata/importer.go", "Go", 65, 0, 0, 0, 0, 0, 11, 76
"/opt/projects/swiftkube/vendor/golang.org/x/tools/go/internal/packagesdriver/sizes.go", "Go", 44, 0, 0, 0, 0, 0, 6, 50
"/opt/projects/swiftkube/vendor/golang.org/x/tools/go/packages/doc.go", "Go", 184, 0, 0, 0, 0, 0, 37, 221
"/opt/projects/swiftkube/vendor/golang.org/x/tools/go/packages/external.go", "Go", 92, 0, 0, 0, 0, 0, 10, 102
"/opt/projects/swiftkube/vendor/golang.org/x/tools/go/packages/golist.go", "Go", 1080, 0, 0, 0, 0, 0, 94, 1174
"/opt/projects/swiftkube/vendor/golang.org/x/tools/go/packages/golist_overlay.go", "Go", 545, 0, 0, 0, 0, 0, 31, 576
"/opt/projects/swiftkube/vendor/golang.org/x/tools/go/packages/loadmode_string.go", "Go", 52, 0, 0, 0, 0, 0, 6, 58
"/opt/projects/swiftkube/vendor/golang.org/x/tools/go/packages/packages.go", "Go", 1176, 0, 0, 0, 0, 0, 151, 1327
"/opt/projects/swiftkube/vendor/golang.org/x/tools/go/packages/visit.go", "Go", 53, 0, 0, 0, 0, 0, 7, 60
"/opt/projects/swiftkube/vendor/golang.org/x/tools/go/types/objectpath/objectpath.go", "Go", 695, 0, 0, 0, 0, 0, 68, 763
"/opt/projects/swiftkube/vendor/golang.org/x/tools/imports/forward.go", "Go", 67, 0, 0, 0, 0, 0, 11, 78
"/opt/projects/swiftkube/vendor/golang.org/x/tools/internal/event/core/event.go", "Go", 71, 0, 0, 0, 0, 0, 15, 86
"/opt/projects/swiftkube/vendor/golang.org/x/tools/internal/event/core/export.go", "Go", 61, 0, 0, 0, 0, 0, 10, 71
"/opt/projects/swiftkube/vendor/golang.org/x/tools/internal/event/core/fast.go", "Go", 68, 0, 0, 0, 0, 0, 10, 78
"/opt/projects/swiftkube/vendor/golang.org/x/tools/internal/event/doc.go", "Go", 6, 0, 0, 0, 0, 0, 2, 8
"/opt/projects/swiftkube/vendor/golang.org/x/tools/internal/event/event.go", "Go", 109, 0, 0, 0, 0, 0, 19, 128
"/opt/projects/swiftkube/vendor/golang.org/x/tools/internal/event/keys/keys.go", "Go", 444, 0, 0, 0, 0, 0, 121, 565
"/opt/projects/swiftkube/vendor/golang.org/x/tools/internal/event/keys/standard.go", "Go", 20, 0, 0, 0, 0, 0, 3, 23
"/opt/projects/swiftkube/vendor/golang.org/x/tools/internal/event/label/label.go", "Go", 183, 0, 0, 0, 0, 0, 33, 216
"/opt/projects/swiftkube/vendor/golang.org/x/tools/internal/fastwalk/fastwalk.go", "Go", 178, 0, 0, 0, 0, 0, 19, 197
"/opt/projects/swiftkube/vendor/golang.org/x/tools/internal/fastwalk/fastwalk_darwin.go", "Go", 109, 0, 0, 0, 0, 0, 11, 120
"/opt/projects/swiftkube/vendor/golang.org/x/tools/internal/fastwalk/fastwalk_dirent_fileno.go", "Go", 10, 0, 0, 0, 0, 0, 5, 15
"/opt/projects/swiftkube/vendor/golang.org/x/tools/internal/fastwalk/fastwalk_dirent_ino.go", "Go", 11, 0, 0, 0, 0, 0, 5, 16
"/opt/projects/swiftkube/vendor/golang.org/x/tools/internal/fastwalk/fastwalk_dirent_namlen_bsd.go", "Go", 10, 0, 0, 0, 0, 0, 5, 15
"/opt/projects/swiftkube/vendor/golang.org/x/tools/internal/fastwalk/fastwalk_dirent_namlen_linux.go", "Go", 25, 0, 0, 0, 0, 0, 5, 30
"/opt/projects/swiftkube/vendor/golang.org/x/tools/internal/fastwalk/fastwalk_portable.go", "Go", 34, 0, 0, 0, 0, 0, 5, 39
"/opt/projects/swiftkube/vendor/golang.org/x/tools/internal/fastwalk/fastwalk_unix.go", "Go", 141, 0, 0, 0, 0, 0, 13, 154
"/opt/projects/swiftkube/vendor/golang.org/x/tools/internal/gcimporter/bexport.go", "Go", 743, 0, 0, 0, 0, 0, 110, 853
"/opt/projects/swiftkube/vendor/golang.org/x/tools/internal/gcimporter/bimport.go", "Go", 915, 0, 0, 0, 0, 0, 139, 1054
"/opt/projects/swiftkube/vendor/golang.org/x/tools/internal/gcimporter/exportdata.go", "Go", 87, 0, 0, 0, 0, 0, 13, 100
"/opt/projects/swiftkube/vendor/golang.org/x/tools/internal/gcimporter/gcimporter.go", "Go", 241, 0, 0, 0, 0, 0, 37, 278
"/opt/projects/swiftkube/vendor/golang.org/x/tools/internal/gcimporter/iexport.go", "Go", 1028, 0, 0, 0, 0, 0, 153, 1181
"/opt/projects/swiftkube/vendor/golang.org/x/tools/internal/gcimporter/iimport.go", "Go", 859, 0, 0, 0, 0, 0, 140, 999
"/opt/projects/swiftkube/vendor/golang.org/x/tools/internal/gcimporter/newInterface10.go", "Go", 18, 0, 0, 0, 0, 0, 5, 23
"/opt/projects/swiftkube/vendor/golang.org/x/tools/internal/gcimporter/newInterface11.go", "Go", 10, 0, 0, 0, 0, 0, 5, 15
"/opt/projects/swiftkube/vendor/golang.org/x/tools/internal/gcimporter/support_go117.go", "Go", 11, 0, 0, 0, 0, 0, 6, 17
"/opt/projects/swiftkube/vendor/golang.org/x/tools/internal/gcimporter/support_go118.go", "Go", 30, 0, 0, 0, 0, 0, 8, 38
"/opt/projects/swiftkube/vendor/golang.org/x/tools/internal/gcimporter/unified_no.go", "Go", 7, 0, 0, 0, 0, 0, 4, 11
"/opt/projects/swiftkube/vendor/golang.org/x/tools/internal/gcimporter/unified_yes.go", "Go", 7, 0, 0, 0, 0, 0, 4, 11
"/opt/projects/swiftkube/vendor/golang.org/x/tools/internal/gcimporter/ureader_no.go", "Go", 15, 0, 0, 0, 0, 0, 5, 20
"/opt/projects/swiftkube/vendor/golang.org/x/tools/internal/gcimporter/ureader_yes.go", "Go", 580, 0, 0, 0, 0, 0, 140, 720
"/opt/projects/swiftkube/vendor/golang.org/x/tools/internal/gocommand/invoke.go", "Go", 308, 0, 0, 0, 0, 0, 49, 357
"/opt/projects/swiftkube/vendor/golang.org/x/tools/internal/gocommand/vendor.go", "Go", 100, 0, 0, 0, 0, 0, 10, 110
"/opt/projects/swiftkube/vendor/golang.org/x/tools/internal/gocommand/version.go", "Go", 76, 0, 0, 0, 0, 0, 6, 82
"/opt/projects/swiftkube/vendor/golang.org/x/tools/internal/gopathwalk/walk.go", "Go", 232, 0, 0, 0, 0, 0, 23, 255
"/opt/projects/swiftkube/vendor/golang.org/x/tools/internal/imports/fix.go", "Go", 1579, 0, 0, 0, 0, 0, 160, 1739
"/opt/projects/swiftkube/vendor/golang.org/x/tools/internal/imports/imports.go", "Go", 309, 0, 0, 0, 0, 0, 43, 352
"/opt/projects/swiftkube/vendor/golang.org/x/tools/internal/imports/mod.go", "Go", 654, 0, 0, 0, 0, 0, 63, 717
"/opt/projects/swiftkube/vendor/golang.org/x/tools/internal/imports/mod_cache.go", "Go", 206, 0, 0, 0, 0, 0, 31, 237
"/opt/projects/swiftkube/vendor/golang.org/x/tools/internal/imports/sortimports.go", "Go", 264, 0, 0, 0, 0, 0, 34, 298
"/opt/projects/swiftkube/vendor/golang.org/x/tools/internal/imports/zstdlib.go", "Go", 11112, 0, 0, 0, 0, 0, 4, 11116
"/opt/projects/swiftkube/vendor/golang.org/x/tools/internal/packagesinternal/packages.go", "Go", 22, 0, 0, 0, 0, 0, 9, 31
"/opt/projects/swiftkube/vendor/golang.org/x/tools/internal/pkgbits/codes.go", "Go", 62, 0, 0, 0, 0, 0, 16, 78
"/opt/projects/swiftkube/vendor/golang.org/x/tools/internal/pkgbits/decoder.go", "Go", 438, 0, 0, 0, 0, 0, 80, 518
"/opt/projects/swiftkube/vendor/golang.org/x/tools/internal/pkgbits/doc.go", "Go", 31, 0, 0, 0, 0, 0, 2, 33
"/opt/projects/swiftkube/vendor/golang.org/x/tools/internal/pkgbits/encoder.go", "Go", 329, 0, 0, 0, 0, 0, 55, 384
"/opt/projects/swiftkube/vendor/golang.org/x/tools/internal/pkgbits/flags.go", "Go", 7, 0, 0, 0, 0, 0, 3, 10
"/opt/projects/swiftkube/vendor/golang.org/x/tools/internal/pkgbits/frames_go1.go", "Go", 15, 0, 0, 0, 0, 0, 7, 22
"/opt/projects/swiftkube/vendor/golang.org/x/tools/internal/pkgbits/frames_go17.go", "Go", 23, 0, 0, 0, 0, 0, 6, 29
"/opt/projects/swiftkube/vendor/golang.org/x/tools/internal/pkgbits/reloc.go", "Go", 35, 0, 0, 0, 0, 0, 8, 43
"/opt/projects/swiftkube/vendor/golang.org/x/tools/internal/pkgbits/support.go", "Go", 13, 0, 0, 0, 0, 0, 5, 18
"/opt/projects/swiftkube/vendor/golang.org/x/tools/internal/pkgbits/sync.go", "Go", 97, 0, 0, 0, 0, 0, 17, 114
"/opt/projects/swiftkube/vendor/golang.org/x/tools/internal/pkgbits/syncmarker_string.go", "Go", 83, 0, 0, 0, 0, 0, 7, 90
"/opt/projects/swiftkube/vendor/golang.org/x/tools/internal/tokeninternal/tokeninternal.go", "Go", 135, 0, 0, 0, 0, 0, 17, 152
"/opt/projects/swiftkube/vendor/golang.org/x/tools/internal/typeparams/common.go", "Go", 163, 0, 0, 0, 0, 0, 16, 179
"/opt/projects/swiftkube/vendor/golang.org/x/tools/internal/typeparams/coretype.go", "Go", 115, 0, 0, 0, 0, 0, 8, 123
"/opt/projects/swiftkube/vendor/golang.org/x/tools/internal/typeparams/enabled_go117.go", "Go", 9, 0, 0, 0, 0, 0, 4, 13
"/opt/projects/swiftkube/vendor/golang.org/x/tools/internal/typeparams/enabled_go118.go", "Go", 11, 0, 0, 0, 0, 0, 5, 16
"/opt/projects/swiftkube/vendor/golang.org/x/tools/internal/typeparams/normalize.go", "Go", 201, 0, 0, 0, 0, 0, 18, 219
"/opt/projects/swiftkube/vendor/golang.org/x/tools/internal/typeparams/termlist.go", "Go", 146, 0, 0, 0, 0, 0, 18, 164
"/opt/projects/swiftkube/vendor/golang.org/x/tools/internal/typeparams/typeparams_go117.go", "Go", 159, 0, 0, 0, 0, 0, 39, 198
"/opt/projects/swiftkube/vendor/golang.org/x/tools/internal/typeparams/typeparams_go118.go", "Go", 119, 0, 0, 0, 0, 0, 33, 152
"/opt/projects/swiftkube/vendor/golang.org/x/tools/internal/typeparams/typeterm.go", "Go", 151, 0, 0, 0, 0, 0, 20, 171
"/opt/projects/swiftkube/vendor/golang.org/x/tools/internal/typesinternal/errorcode.go", "Go", 1368, 0, 0, 0, 0, 0, 193, 1561
"/opt/projects/swiftkube/vendor/golang.org/x/tools/internal/typesinternal/errorcode_string.go", "Go", 173, 0, 0, 0, 0, 0, 7, 180
"/opt/projects/swiftkube/vendor/golang.org/x/tools/internal/typesinternal/types.go", "Go", 51, 0, 0, 0, 0, 0, 11, 62
"/opt/projects/swiftkube/vendor/golang.org/x/tools/internal/typesinternal/types_118.go", "Go", 15, 0, 0, 0, 0, 0, 5, 20
"/opt/projects/swiftkube/vendor/google.golang.org/api/compute/v0.alpha/compute-gen.go", "Go", 222031, 0, 0, 0, 0, 0, 18606, 240637
"/opt/projects/swiftkube/vendor/google.golang.org/api/compute/v0.beta/compute-gen.go", "Go", 197231, 0, 0, 0, 0, 0, 16381, 213612
"/opt/projects/swiftkube/vendor/google.golang.org/api/compute/v1/compute-gen.go", "Go", 183083, 0, 0, 0, 0, 0, 15340, 198423
"/opt/projects/swiftkube/vendor/google.golang.org/api/container/v1/container-gen.go", "Go", 16303, 0, 0, 0, 0, 0, 1710, 18013
"/opt/projects/swiftkube/vendor/google.golang.org/api/googleapi/googleapi.go", "Go", 419, 0, 0, 0, 0, 0, 63, 482
"/opt/projects/swiftkube/vendor/google.golang.org/api/googleapi/transport/apikey.go", "Go", 39, 0, 0, 0, 0, 0, 6, 45
"/opt/projects/swiftkube/vendor/google.golang.org/api/googleapi/types.go", "Go", 173, 0, 0, 0, 0, 0, 30, 203
"/opt/projects/swiftkube/vendor/google.golang.org/api/internal/cert/default_cert.go", "Go", 51, 0, 0, 0, 0, 0, 8, 59
"/opt/projects/swiftkube/vendor/google.golang.org/api/internal/cert/enterprise_cert.go", "Go", 47, 0, 0, 0, 0, 0, 8, 55
"/opt/projects/swiftkube/vendor/google.golang.org/api/internal/cert/secureconnect_cert.go", "Go", 111, 0, 0, 0, 0, 0, 13, 124
"/opt/projects/swiftkube/vendor/google.golang.org/api/internal/conn_pool.go", "Go", 24, 0, 0, 0, 0, 0, 7, 31
"/opt/projects/swiftkube/vendor/google.golang.org/api/internal/creds.go", "Go", 203, 0, 0, 0, 0, 0, 21, 224
"/opt/projects/swiftkube/vendor/google.golang.org/api/internal/dca.go", "Go", 131, 0, 0, 0, 0, 0, 14, 145
"/opt/projects/swiftkube/vendor/google.golang.org/api/internal/gensupport/buffer.go", "Go", 66, 0, 0, 0, 0, 0, 14, 80
"/opt/projects/swiftkube/vendor/google.golang.org/api/internal/gensupport/doc.go", "Go", 9, 0, 0, 0, 0, 0, 2, 11
"/opt/projects/swiftkube/vendor/google.golang.org/api/internal/gensupport/error.go", "Go", 20, 0, 0, 0, 0, 0, 5, 25
"/opt/projects/swiftkube/vendor/google.golang.org/api/internal/gensupport/json.go", "Go", 208, 0, 0, 0, 0, 0, 29, 237
"/opt/projects/swiftkube/vendor/google.golang.org/api/internal/gensupport/jsonfloat.go", "Go", 43, 0, 0, 0, 0, 0, 5, 48
"/opt/projects/swiftkube/vendor/google.golang.org/api/internal/gensupport/media.go", "Go", 288, 0, 0, 0, 0, 0, 25, 313
"/opt/projects/swiftkube/vendor/google.golang.org/api/internal/gensupport/params.go", "Go", 48, 0, 0, 0, 0, 0, 10, 58
"/opt/projects/swiftkube/vendor/google.golang.org/api/internal/gensupport/resumable.go", "Go", 228, 0, 0, 0, 0, 0, 37, 265
"/opt/projects/swiftkube/vendor/google.golang.org/api/internal/gensupport/retry.go", "Go", 109, 0, 0, 0, 0, 0, 13, 122
"/opt/projects/swiftkube/vendor/google.golang.org/api/internal/gensupport/retryable_linux.go", "Go", 12, 0, 0, 0, 0, 0, 5, 17
"/opt/projects/swiftkube/vendor/google.golang.org/api/internal/gensupport/send.go", "Go", 159, 0, 0, 0, 0, 0, 22, 181
"/opt/projects/swiftkube/vendor/google.golang.org/api/internal/gensupport/version.go", "Go", 45, 0, 0, 0, 0, 0, 9, 54
"/opt/projects/swiftkube/vendor/google.golang.org/api/internal/impersonate/impersonate.go", "Go", 113, 0, 0, 0, 0, 0, 16, 129
"/opt/projects/swiftkube/vendor/google.golang.org/api/internal/settings.go", "Go", 133, 0, 0, 0, 0, 0, 10, 143
"/opt/projects/swiftkube/vendor/google.golang.org/api/internal/third_party/uritemplates/uritemplates.go", "Go", 229, 0, 0, 0, 0, 0, 20, 249
"/opt/projects/swiftkube/vendor/google.golang.org/api/internal/third_party/uritemplates/utils.go", "Go", 15, 0, 0, 0, 0, 0, 3, 18
"/opt/projects/swiftkube/vendor/google.golang.org/api/internal/version.go", "Go", 6, 0, 0, 0, 0, 0, 3, 9
"/opt/projects/swiftkube/vendor/google.golang.org/api/option/internaloption/internaloption.go", "Go", 112, 0, 0, 0, 0, 0, 32, 144
"/opt/projects/swiftkube/vendor/google.golang.org/api/option/option.go", "Go", 282, 0, 0, 0, 0, 0, 64, 346
"/opt/projects/swiftkube/vendor/google.golang.org/api/tpu/v1/tpu-gen.go", "Go", 3407, 0, 0, 0, 0, 0, 341, 3748
"/opt/projects/swiftkube/vendor/google.golang.org/api/transport/http/dial.go", "Go", 207, 0, 0, 0, 0, 0, 23, 230
"/opt/projects/swiftkube/vendor/google.golang.org/api/transport/http/dial_appengine.go", "Go", 16, 0, 0, 0, 0, 0, 6, 22
"/opt/projects/swiftkube/vendor/google.golang.org/api/transport/http/internal/propagation/http.go", "Go", 74, 0, 0, 0, 0, 0, 14, 88
"/opt/projects/swiftkube/vendor/google.golang.org/appengine/appengine.go", "Go", 116, 0, 0, 0, 0, 0, 20, 136
"/opt/projects/swiftkube/vendor/google.golang.org/appengine/appengine_vm.go", "Go", 15, 0, 0, 0, 0, 0, 6, 21
"/opt/projects/swiftkube/vendor/google.golang.org/appengine/errors.go", "Go", 39, 0, 0, 0, 0, 0, 8, 47
"/opt/projects/swiftkube/vendor/google.golang.org/appengine/identity.go", "Go", 120, 0, 0, 0, 0, 0, 23, 143
"/opt/projects/swiftkube/vendor/google.golang.org/appengine/internal/api.go", "Go", 599, 0, 0, 0, 0, 0, 80, 679
"/opt/projects/swiftkube/vendor/google.golang.org/appengine/internal/api_classic.go", "Go", 142, 0, 0, 0, 0, 0, 28, 170
"/opt/projects/swiftkube/vendor/google.golang.org/appengine/internal/api_common.go", "Go", 102, 0, 0, 0, 0, 0, 22, 124
"/opt/projects/swiftkube/vendor/google.golang.org/appengine/internal/app_id.go", "Go", 24, 0, 0, 0, 0, 0, 5, 29
"/opt/projects/swiftkube/vendor/google.golang.org/appengine/internal/app_identity/app_identity_service.pb.go", "Go", 550, 0, 0, 0, 0, 0, 62, 612
"/opt/projects/swiftkube/vendor/google.golang.org/appengine/internal/app_identity/app_identity_service.proto", "Protocol Buffers", 0, 0, 51, 0, 0, 0, 14, 65
"/opt/projects/swiftkube/vendor/google.golang.org/appengine/internal/base/api_base.pb.go", "Go", 274, 0, 0, 0, 0, 0, 35, 309
"/opt/projects/swiftkube/vendor/google.golang.org/appengine/internal/base/api_base.proto", "Protocol Buffers", 0, 0, 23, 0, 0, 1, 10, 34
"/opt/projects/swiftkube/vendor/google.golang.org/appengine/internal/datastore/datastore_v3.pb.go", "Go", 3906, 0, 0, 0, 0, 0, 462, 4368
"/opt/projects/swiftkube/vendor/google.golang.org/appengine/internal/datastore/datastore_v3.proto", "Protocol Buffers", 0, 0, 403, 0, 0, 0, 149, 552
"/opt/projects/swiftkube/vendor/google.golang.org/appengine/internal/identity.go", "Go", 45, 0, 0, 0, 0, 0, 11, 56
"/opt/projects/swiftkube/vendor/google.golang.org/appengine/internal/identity_classic.go", "Go", 51, 0, 0, 0, 0, 0, 11, 62
"/opt/projects/swiftkube/vendor/google.golang.org/appengine/internal/identity_flex.go", "Go", 8, 0, 0, 0, 0, 0, 4, 12
"/opt/projects/swiftkube/vendor/google.golang.org/appengine/internal/identity_vm.go", "Go", 114, 0, 0, 0, 0, 0, 21, 135
"/opt/projects/swiftkube/vendor/google.golang.org/appengine/internal/internal.go", "Go", 94, 0, 0, 0, 0, 0, 17, 111
"/opt/projects/swiftkube/vendor/google.golang.org/appengine/internal/log/log_service.pb.go", "Go", 1169, 0, 0, 0, 0, 0, 145, 1314
"/opt/projects/swiftkube/vendor/google.golang.org/appengine/internal/log/log_service.proto", "Protocol Buffers", 0, 0, 124, 0, 0, 0, 27, 151
"/opt/projects/swiftkube/vendor/google.golang.org/appengine/internal/main.go", "Go", 12, 0, 0, 0, 0, 0, 5, 17
"/opt/projects/swiftkube/vendor/google.golang.org/appengine/internal/main_common.go", "Go", 6, 0, 0, 0, 0, 0, 2, 8
"/opt/projects/swiftkube/vendor/google.golang.org/appengine/internal/main_vm.go", "Go", 61, 0, 0, 0, 0, 0, 9, 70
"/opt/projects/swiftkube/vendor/google.golang.org/appengine/internal/metadata.go", "Go", 53, 0, 0, 0, 0, 0, 8, 61
"/opt/projects/swiftkube/vendor/google.golang.org/appengine/internal/modules/modules_service.pb.go", "Go", 705, 0, 0, 0, 0, 0, 82, 787
"/opt/projects/swiftkube/vendor/google.golang.org/appengine/internal/modules/modules_service.proto", "Protocol Buffers", 0, 0, 61, 0, 0, 0, 20, 81
"/opt/projects/swiftkube/vendor/google.golang.org/appengine/internal/net.go", "Go", 47, 0, 0, 0, 0, 0, 10, 57
"/opt/projects/swiftkube/vendor/google.golang.org/appengine/internal/remote_api/remote_api.pb.go", "Go", 325, 0, 0, 0, 0, 0, 37, 362
"/opt/projects/swiftkube/vendor/google.golang.org/appengine/internal/remote_api/remote_api.proto", "Protocol Buffers", 0, 0, 39, 0, 0, 0, 6, 45
"/opt/projects/swiftkube/vendor/google.golang.org/appengine/internal/transaction.go", "Go", 98, 0, 0, 0, 0, 0, 18, 116
"/opt/projects/swiftkube/vendor/google.golang.org/appengine/internal/urlfetch/urlfetch_service.pb.go", "Go", 474, 0, 0, 0, 0, 0, 54, 528
"/opt/projects/swiftkube/vendor/google.golang.org/appengine/internal/urlfetch/urlfetch_service.proto", "Protocol Buffers", 0, 0, 55, 0, 0, 0, 10, 65
"/opt/projects/swiftkube/vendor/google.golang.org/appengine/namespace.go", "Go", 19, 0, 0, 0, 0, 0, 7, 26
"/opt/projects/swiftkube/vendor/google.golang.org/appengine/timeout.go", "Go", 17, 0, 0, 0, 0, 0, 4, 21
"/opt/projects/swiftkube/vendor/google.golang.org/appengine/urlfetch/urlfetch.go", "Go", 184, 0, 0, 0, 0, 0, 27, 211
"/opt/projects/swiftkube/vendor/google.golang.org/genproto/googleapis/api/annotations/annotations.pb.go", "Go", 108, 0, 0, 0, 0, 0, 12, 120
"/opt/projects/swiftkube/vendor/google.golang.org/genproto/googleapis/api/annotations/client.pb.go", "Go", 1613, 0, 0, 0, 0, 0, 168, 1781
"/opt/projects/swiftkube/vendor/google.golang.org/genproto/googleapis/api/annotations/field_behavior.pb.go", "Go", 228, 0, 0, 0, 0, 0, 23, 251
"/opt/projects/swiftkube/vendor/google.golang.org/genproto/googleapis/api/annotations/http.pb.go", "Go", 722, 0, 0, 0, 0, 0, 61, 783
"/opt/projects/swiftkube/vendor/google.golang.org/genproto/googleapis/api/annotations/resource.pb.go", "Go", 599, 0, 0, 0, 0, 0, 57, 656
"/opt/projects/swiftkube/vendor/google.golang.org/genproto/googleapis/api/annotations/routing.pb.go", "Go", 663, 0, 0, 0, 0, 0, 31, 694
"/opt/projects/swiftkube/vendor/google.golang.org/genproto/googleapis/api/expr/v1alpha1/checked.pb.go", "Go", 1483, 0, 0, 0, 0, 0, 182, 1665
"/opt/projects/swiftkube/vendor/google.golang.org/genproto/googleapis/api/expr/v1alpha1/eval.pb.go", "Go", 517, 0, 0, 0, 0, 0, 64, 581
"/opt/projects/swiftkube/vendor/google.golang.org/genproto/googleapis/api/expr/v1alpha1/explain.pb.go", "Go", 246, 0, 0, 0, 0, 0, 30, 276
"/opt/projects/swiftkube/vendor/google.golang.org/genproto/googleapis/api/expr/v1alpha1/syntax.pb.go", "Go", 1532, 0, 0, 0, 0, 0, 189, 1721
"/opt/projects/swiftkube/vendor/google.golang.org/genproto/googleapis/api/expr/v1alpha1/value.pb.go", "Go", 631, 0, 0, 0, 0, 0, 91, 722
"/opt/projects/swiftkube/vendor/google.golang.org/genproto/googleapis/api/httpbody/httpbody.pb.go", "Go", 214, 0, 0, 0, 0, 0, 22, 236
"/opt/projects/swiftkube/vendor/google.golang.org/genproto/googleapis/api/launch_stage.pb.go", "Go", 183, 0, 0, 0, 0, 0, 21, 204
"/opt/projects/swiftkube/vendor/google.golang.org/genproto/googleapis/api/tidyfix.go", "Go", 20, 0, 0, 0, 0, 0, 4, 24
"/opt/projects/swiftkube/vendor/google.golang.org/genproto/googleapis/rpc/code/code.pb.go", "Go", 316, 0, 0, 0, 0, 0, 21, 337
"/opt/projects/swiftkube/vendor/google.golang.org/genproto/googleapis/rpc/errdetails/error_details.pb.go", "Go", 1178, 0, 0, 0, 0, 0, 137, 1315
"/opt/projects/swiftkube/vendor/google.golang.org/genproto/googleapis/rpc/status/status.pb.go", "Go", 182, 0, 0, 0, 0, 0, 22, 204
"/opt/projects/swiftkube/vendor/google.golang.org/genproto/internal/doc.go", "Go", 16, 0, 0, 0, 0, 0, 2, 18
"/opt/projects/swiftkube/vendor/google.golang.org/genproto/protobuf/field_mask/field_mask.go", "Go", 19, 0, 0, 0, 0, 0, 5, 24
"/opt/projects/swiftkube/vendor/google.golang.org/grpc/attributes/attributes.go", "Go", 95, 0, 0, 0, 0, 0, 7, 102
"/opt/projects/swiftkube/vendor/google.golang.org/grpc/backoff.go", "Go", 54, 0, 0, 0, 0, 0, 8, 62
"/opt/projects/swiftkube/vendor/google.golang.org/grpc/backoff/backoff.go", "Go", 48, 0, 0, 0, 0, 0, 5, 53
"/opt/projects/swiftkube/vendor/google.golang.org/grpc/balancer/balancer.go", "Go", 371, 0, 0, 0, 0, 0, 34, 405
"/opt/projects/swiftkube/vendor/google.golang.org/grpc/balancer/base/balancer.go", "Go", 226, 0, 0, 0, 0, 0, 29, 255
"/opt/projects/swiftkube/vendor/google.golang.org/grpc/balancer/base/base.go", "Go", 64, 0, 0, 0, 0, 0, 8, 72
"/opt/projects/swiftkube/vendor/google.golang.org/grpc/balancer/conn_state_evaluator.go", "Go", 69, 0, 0, 0, 0, 0, 6, 75
"/opt/projects/swiftkube/vendor/google.golang.org/grpc/balancer/grpclb/state/state.go", "Go", 44, 0, 0, 0, 0, 0, 8, 52
"/opt/projects/swiftkube/vendor/google.golang.org/grpc/balancer/roundrobin/roundrobin.go", "Go", 69, 0, 0, 0, 0, 0, 13, 82
"/opt/projects/swiftkube/vendor/google.golang.org/grpc/balancer_conn_wrappers.go", "Go", 430, 0, 0, 0, 0, 0, 52, 482
"/opt/projects/swiftkube/vendor/google.golang.org/grpc/binarylog/grpc_binarylog_v1/binarylog.pb.go", "Go", 1051, 0, 0, 0, 0, 0, 133, 1184
"/opt/projects/swiftkube/vendor/google.golang.org/grpc/call.go", "Go", 66, 0, 0, 0, 0, 0, 9, 75
"/opt/projects/swiftkube/vendor/google.golang.org/grpc/channelz/channelz.go", "Go", 33, 0, 0, 0, 0, 0, 4, 37
"/opt/projects/swiftkube/vendor/google.golang.org/grpc/clientconn.go", "Go", 1511, 0, 0, 0, 0, 0, 154, 1665
"/opt/projects/swiftkube/vendor/google.golang.org/grpc/codec.go", "Go", 45, 0, 0, 0, 0, 0, 6, 51
"/opt/projects/swiftkube/vendor/google.golang.org/grpc/codes/code_string.go", "Go", 105, 0, 0, 0, 0, 0, 7, 112
"/opt/projects/swiftkube/vendor/google.golang.org/grpc/codes/codes.go", "Go", 218, 0, 0, 0, 0, 0, 27, 245
"/opt/projects/swiftkube/vendor/google.golang.org/grpc/connectivity/connectivity.go", "Go", 85, 0, 0, 0, 0, 0, 10, 95
"/opt/projects/swiftkube/vendor/google.golang.org/grpc/credentials/credentials.go", "Go", 267, 0, 0, 0, 0, 0, 25, 292
"/opt/projects/swiftkube/vendor/google.golang.org/grpc/credentials/insecure/insecure.go", "Go", 81, 0, 0, 0, 0, 0, 18, 99
"/opt/projects/swiftkube/vendor/google.golang.org/grpc/credentials/tls.go", "Go", 217, 0, 0, 0, 0, 0, 20, 237
"/opt/projects/swiftkube/vendor/google.golang.org/grpc/dialoptions.go", "Go", 583, 0, 0, 0, 0, 0, 66, 649
"/opt/projects/swiftkube/vendor/google.golang.org/grpc/doc.go", "Go", 23, 0, 0, 0, 0, 0, 4, 27
"/opt/projects/swiftkube/vendor/google.golang.org/grpc/encoding/encoding.go", "Go", 123, 0, 0, 0, 0, 0, 13, 136
"/opt/projects/swiftkube/vendor/google.golang.org/grpc/encoding/gzip/gzip.go", "Go", 117, 0, 0, 0, 0, 0, 16, 133
"/opt/projects/swiftkube/vendor/google.golang.org/grpc/encoding/proto/proto.go", "Go", 49, 0, 0, 0, 0, 0, 10, 59
"/opt/projects/swiftkube/vendor/google.golang.org/grpc/grpclog/component.go", "Go", 94, 0, 0, 0, 0, 0, 24, 118
"/opt/projects/swiftkube/vendor/google.golang.org/grpc/grpclog/grpclog.go", "Go", 112, 0, 0, 0, 0, 0, 21, 133
"/opt/projects/swiftkube/vendor/google.golang.org/grpc/grpclog/logger.go", "Go", 72, 0, 0, 0, 0, 0, 16, 88
"/opt/projects/swiftkube/vendor/google.golang.org/grpc/grpclog/loggerv2.go", "Go", 226, 0, 0, 0, 0, 0, 33, 259
"/opt/projects/swiftkube/vendor/google.golang.org/grpc/health/grpc_health_v1/health.pb.go", "Go", 272, 0, 0, 0, 0, 0, 37, 309
"/opt/projects/swiftkube/vendor/google.golang.org/grpc/health/grpc_health_v1/health_grpc.pb.go", "Go", 198, 0, 0, 0, 0, 0, 26, 224
"/opt/projects/swiftkube/vendor/google.golang.org/grpc/interceptor.go", "Go", 93, 0, 0, 0, 0, 0, 12, 105
"/opt/projects/swiftkube/vendor/google.golang.org/grpc/internal/backoff/backoff.go", "Go", 66, 0, 0, 0, 0, 0, 8, 74
"/opt/projects/swiftkube/vendor/google.golang.org/grpc/internal/balancer/gracefulswitch/gracefulswitch.go", "Go", 352, 0, 0, 0, 0, 0, 33, 385
"/opt/projects/swiftkube/vendor/google.golang.org/grpc/internal/balancerload/load.go", "Go", 40, 0, 0, 0, 0, 0, 7, 47
"/opt/projects/swiftkube/vendor/google.golang.org/grpc/internal/binarylog/binarylog.go", "Go", 168, 0, 0, 0, 0, 0, 22, 190
"/opt/projects/swiftkube/vendor/google.golang.org/grpc/internal/binarylog/binarylog_testutil.go", "Go", 39, 0, 0, 0, 0, 0, 4, 43
"/opt/projects/swiftkube/vendor/google.golang.org/grpc/internal/binarylog/env_config.go", "Go", 193, 0, 0, 0, 0, 0, 16, 209
"/opt/projects/swiftkube/vendor/google.golang.org/grpc/internal/binarylog/method_logger.go", "Go", 399, 0, 0, 0, 0, 0, 38, 437
"/opt/projects/swiftkube/vendor/google.golang.org/grpc/internal/binarylog/sink.go", "Go", 152, 0, 0, 0, 0, 0, 19, 171
"/opt/projects/swiftkube/vendor/google.golang.org/grpc/internal/buffer/unbounded.go", "Go", 78, 0, 0, 0, 0, 0, 8, 86
"/opt/projects/swiftkube/vendor/google.golang.org/grpc/internal/channelz/funcs.go", "Go", 721, 0, 0, 0, 0, 0, 69, 790
"/opt/projects/swiftkube/vendor/google.golang.org/grpc/internal/channelz/id.go", "Go", 66, 0, 0, 0, 0, 0, 10, 76
"/opt/projects/swiftkube/vendor/google.golang.org/grpc/internal/channelz/logging.go", "Go", 68, 0, 0, 0, 0, 0, 12, 80
"/opt/projects/swiftkube/vendor/google.golang.org/grpc/internal/channelz/types.go", "Go", 643, 0, 0, 0, 0, 0, 80, 723
"/opt/projects/swiftkube/vendor/google.golang.org/grpc/internal/channelz/types_linux.go", "Go", 46, 0, 0, 0, 0, 0, 6, 52
"/opt/projects/swiftkube/vendor/google.golang.org/grpc/internal/channelz/types_nonlinux.go", "Go", 37, 0, 0, 0, 0, 0, 7, 44
"/opt/projects/swiftkube/vendor/google.golang.org/grpc/internal/channelz/util_linux.go", "Go", 34, 0, 0, 0, 0, 0, 4, 38
"/opt/projects/swiftkube/vendor/google.golang.org/grpc/internal/channelz/util_nonlinux.go", "Go", 24, 0, 0, 0, 0, 0, 4, 28
"/opt/projects/swiftkube/vendor/google.golang.org/grpc/internal/credentials/credentials.go", "Go", 41, 0, 0, 0, 0, 0, 9, 50
"/opt/projects/swiftkube/vendor/google.golang.org/grpc/internal/credentials/spiffe.go", "Go", 69, 0, 0, 0, 0, 0, 7, 76
"/opt/projects/swiftkube/vendor/google.golang.org/grpc/internal/credentials/syscallconn.go", "Go", 53, 0, 0, 0, 0, 0, 6, 59
"/opt/projects/swiftkube/vendor/google.golang.org/grpc/internal/credentials/util.go", "Go", 46, 0, 0, 0, 0, 0, 7, 53
"/opt/projects/swiftkube/vendor/google.golang.org/grpc/internal/envconfig/envconfig.go", "Go", 57, 0, 0, 0, 0, 0, 6, 63
"/opt/projects/swiftkube/vendor/google.golang.org/grpc/internal/envconfig/observability.go", "Go", 32, 0, 0, 0, 0, 0, 5, 37
"/opt/projects/swiftkube/vendor/google.golang.org/grpc/internal/envconfig/xds.go", "Go", 85, 0, 0, 0, 0, 0, 8, 93
"/opt/projects/swiftkube/vendor/google.golang.org/grpc/internal/grpclog/grpclog.go", "Go", 116, 0, 0, 0, 0, 0, 11, 127
"/opt/projects/swiftkube/vendor/google.golang.org/grpc/internal/grpclog/prefixLogger.go", "Go", 83, 0, 0, 0, 0, 0, 11, 94
"/opt/projects/swiftkube/vendor/google.golang.org/grpc/internal/grpcrand/grpcrand.go", "Go", 65, 0, 0, 0, 0, 0, 10, 75
"/opt/projects/swiftkube/vendor/google.golang.org/grpc/internal/grpcsync/event.go", "Go", 54, 0, 0, 0, 0, 0, 8, 62
"/opt/projects/swiftkube/vendor/google.golang.org/grpc/internal/grpcsync/oncefunc.go", "Go", 29, 0, 0, 0, 0, 0, 4, 33
"/opt/projects/swiftkube/vendor/google.golang.org/grpc/internal/grpcutil/compressor.go", "Go", 41, 0, 0, 0, 0, 0, 7, 48
"/opt/projects/swiftkube/vendor/google.golang.org/grpc/internal/grpcutil/encode_duration.go", "Go", 58, 0, 0, 0, 0, 0, 6, 64
"/opt/projects/swiftkube/vendor/google.golang.org/grpc/internal/grpcutil/grpcutil.go", "Go", 19, 0, 0, 0, 0, 0, 2, 21
"/opt/projects/swiftkube/vendor/google.golang.org/grpc/internal/grpcutil/metadata.go", "Go", 34, 0, 0, 0, 0, 0, 7, 41
"/opt/projects/swiftkube/vendor/google.golang.org/grpc/internal/grpcutil/method.go", "Go", 81, 0, 0, 0, 0, 0, 8, 89
"/opt/projects/swiftkube/vendor/google.golang.org/grpc/internal/grpcutil/regex.go", "Go", 28, 0, 0, 0, 0, 0, 4, 32
"/opt/projects/swiftkube/vendor/google.golang.org/grpc/internal/internal.go", "Go", 156, 0, 0, 0, 0, 0, 15, 171
"/opt/projects/swiftkube/vendor/google.golang.org/grpc/internal/metadata/metadata.go", "Go", 120, 0, 0, 0, 0, 0, 13, 133
"/opt/projects/swiftkube/vendor/google.golang.org/grpc/internal/pretty/pretty.go", "Go", 76, 0, 0, 0, 0, 0, 7, 83
"/opt/projects/swiftkube/vendor/google.golang.org/grpc/internal/resolver/config_selector.go", "Go", 151, 0, 0, 0, 0, 0, 17, 168
"/opt/projects/swiftkube/vendor/google.golang.org/grpc/internal/resolver/dns/dns_resolver.go", "Go", 413, 0, 0, 0, 0, 0, 46, 459
"/opt/projects/swiftkube/vendor/google.golang.org/grpc/internal/resolver/passthrough/passthrough.go", "Go", 52, 0, 0, 0, 0, 0, 13, 65
"/opt/projects/swiftkube/vendor/google.golang.org/grpc/internal/resolver/unix/unix.go", "Go", 62, 0, 0, 0, 0, 0, 13, 75
"/opt/projects/swiftkube/vendor/google.golang.org/grpc/internal/serviceconfig/serviceconfig.go", "Go", 163, 0, 0, 0, 0, 0, 18, 181
"/opt/projects/swiftkube/vendor/google.golang.org/grpc/internal/status/status.go", "Go", 155, 0, 0, 0, 0, 0, 22, 177
"/opt/projects/swiftkube/vendor/google.golang.org/grpc/internal/syscall/syscall_linux.go", "Go", 98, 0, 0, 0, 0, 0, 15, 113
"/opt/projects/swiftkube/vendor/google.golang.org/grpc/internal/syscall/syscall_nonlinux.go", "Go", 65, 0, 0, 0, 0, 0, 13, 78
"/opt/projects/swiftkube/vendor/google.golang.org/grpc/internal/transport/bdp_estimator.go", "Go", 132, 0, 0, 0, 0, 0, 10, 142
"/opt/projects/swiftkube/vendor/google.golang.org/grpc/internal/transport/controlbuf.go", "Go", 911, 0, 0, 0, 0, 0, 94, 1005
"/opt/projects/swiftkube/vendor/google.golang.org/grpc/internal/transport/defaults.go", "Go", 51, 0, 0, 0, 0, 0, 5, 56
"/opt/projects/swiftkube/vendor/google.golang.org/grpc/internal/transport/flowcontrol.go", "Go", 198, 0, 0, 0, 0, 0, 18, 216
"/opt/projects/swiftkube/vendor/google.golang.org/grpc/internal/transport/handler_server.go", "Go", 420, 0, 0, 0, 0, 0, 58, 478
"/opt/projects/swiftkube/vendor/google.golang.org/grpc/internal/transport/http2_client.go", "Go", 1687, 0, 0, 0, 0, 0, 109, 1796
"/opt/projects/swiftkube/vendor/google.golang.org/grpc/internal/transport/http2_server.go", "Go", 1376, 0, 0, 0, 0, 0, 89, 1465
"/opt/projects/swiftkube/vendor/google.golang.org/grpc/internal/transport/http_util.go", "Go", 400, 0, 0, 0, 0, 0, 35, 435
"/opt/projects/swiftkube/vendor/google.golang.org/grpc/internal/transport/networktype/networktype.go", "Go", 40, 0, 0, 0, 0, 0, 7, 47
"/opt/projects/swiftkube/vendor/google.golang.org/grpc/internal/transport/proxy.go", "Go", 126, 0, 0, 0, 0, 0, 17, 143
"/opt/projects/swiftkube/vendor/google.golang.org/grpc/internal/transport/transport.go", "Go", 734, 0, 0, 0, 0, 0, 109, 843
"/opt/projects/swiftkube/vendor/google.golang.org/grpc/internal/xds_handshake_cluster.go", "Go", 35, 0, 0, 0, 0, 0, 6, 41
"/opt/projects/swiftkube/vendor/google.golang.org/grpc/keepalive/keepalive.go", "Go", 80, 0, 0, 0, 0, 0, 6, 86
"/opt/projects/swiftkube/vendor/google.golang.org/grpc/metadata/metadata.go", "Go", 267, 0, 0, 0, 0, 0, 29, 296
"/opt/projects/swiftkube/vendor/google.golang.org/grpc/peer/peer.go", "Go", 44, 0, 0, 0, 0, 0, 8, 52
"/opt/projects/swiftkube/vendor/google.golang.org/grpc/picker_wrapper.go", "Go", 179, 0, 0, 0, 0, 0, 16, 195
"/opt/projects/swiftkube/vendor/google.golang.org/grpc/pickfirst.go", "Go", 160, 0, 0, 0, 0, 0, 24, 184
"/opt/projects/swiftkube/vendor/google.golang.org/grpc/preloader.go", "Go", 61, 0, 0, 0, 0, 0, 7, 68
"/opt/projects/swiftkube/vendor/google.golang.org/grpc/resolver/manual/manual.go", "Go", 84, 0, 0, 0, 0, 0, 13, 97
"/opt/projects/swiftkube/vendor/google.golang.org/grpc/resolver/map.go", "Go", 125, 0, 0, 0, 0, 0, 14, 139
"/opt/projects/swiftkube/vendor/google.golang.org/grpc/resolver/resolver.go", "Go", 290, 0, 0, 0, 0, 0, 31, 321
"/opt/projects/swiftkube/vendor/google.golang.org/grpc/resolver_conn_wrapper.go", "Go", 160, 0, 0, 0, 0, 0, 17, 177
"/opt/projects/swiftkube/vendor/google.golang.org/grpc/rpc_util.go", "Go", 853, 0, 0, 0, 0, 0, 101, 954
"/opt/projects/swiftkube/vendor/google.golang.org/grpc/server.go", "Go", 1896, 0, 0, 0, 0, 0, 167, 2063
"/opt/projects/swiftkube/vendor/google.golang.org/grpc/service_config.go", "Go", 371, 0, 0, 0, 0, 0, 36, 407
"/opt/projects/swiftkube/vendor/google.golang.org/grpc/serviceconfig/serviceconfig.go", "Go", 40, 0, 0, 0, 0, 0, 5, 45
"/opt/projects/swiftkube/vendor/google.golang.org/grpc/stats/handlers.go", "Go", 57, 0, 0, 0, 0, 0, 7, 64
"/opt/projects/swiftkube/vendor/google.golang.org/grpc/stats/stats.go", "Go", 284, 0, 0, 0, 0, 0, 50, 334
"/opt/projects/swiftkube/vendor/google.golang.org/grpc/status/status.go", "Go", 120, 0, 0, 0, 0, 0, 16, 136
"/opt/projects/swiftkube/vendor/google.golang.org/grpc/stream.go", "Go", 1635, 0, 0, 0, 0, 0, 129, 1764
"/opt/projects/swiftkube/vendor/google.golang.org/grpc/tap/tap.go", "Go", 52, 0, 0, 0, 0, 0, 5, 57
"/opt/projects/swiftkube/vendor/google.golang.org/grpc/trace.go", "Go", 105, 0, 0, 0, 0, 0, 19, 124
"/opt/projects/swiftkube/vendor/google.golang.org/grpc/version.go", "Go", 20, 0, 0, 0, 0, 0, 3, 23
"/opt/projects/swiftkube/vendor/google.golang.org/protobuf/encoding/protojson/decode.go", "Go", 578, 0, 0, 0, 0, 0, 88, 666
"/opt/projects/swiftkube/vendor/google.golang.org/protobuf/encoding/protojson/doc.go", "Go", 10, 0, 0, 0, 0, 0, 2, 12
"/opt/projects/swiftkube/vendor/google.golang.org/protobuf/encoding/protojson/encode.go", "Go", 293, 0, 0, 0, 0, 0, 51, 344
"/opt/projects/swiftkube/vendor/google.golang.org/protobuf/encoding/protojson/well_known_types.go", "Go", 796, 0, 0, 0, 0, 0, 100, 896
"/opt/projects/swiftkube/vendor/google.golang.org/protobuf/encoding/prototext/decode.go", "Go", 686, 0, 0, 0, 0, 0, 85, 771
"/opt/projects/swiftkube/vendor/google.golang.org/protobuf/encoding/prototext/doc.go", "Go", 6, 0, 0, 0, 0, 0, 2, 8
"/opt/projects/swiftkube/vendor/google.golang.org/protobuf/encoding/prototext/encode.go", "Go", 320, 0, 0, 0, 0, 0, 51, 371
"/opt/projects/swiftkube/vendor/google.golang.org/protobuf/encoding/protowire/wire.go", "Go", 496, 0, 0, 0, 0, 0, 52, 548
"/opt/projects/swiftkube/vendor/google.golang.org/protobuf/internal/descfmt/stringer.go", "Go", 299, 0, 0, 0, 0, 0, 20, 319
"/opt/projects/swiftkube/vendor/google.golang.org/protobuf/internal/descopts/options.go", "Go", 26, 0, 0, 0, 0, 0, 4, 30
"/opt/projects/swiftkube/vendor/google.golang.org/protobuf/internal/detrand/rand.go", "Go", 61, 0, 0, 0, 0, 0, 9, 70
"/opt/projects/swiftkube/vendor/google.golang.org/protobuf/internal/encoding/defval/default.go", "Go", 202, 0, 0, 0, 0, 0, 12, 214
"/opt/projects/swiftkube/vendor/google.golang.org/protobuf/internal/encoding/json/decode.go", "Go", 287, 0, 0, 0, 0, 0, 54, 341
"/opt/projects/swiftkube/vendor/google.golang.org/protobuf/internal/encoding/json/decode_number.go", "Go", 221, 0, 0, 0, 0, 0, 34, 255
"/opt/projects/swiftkube/vendor/google.golang.org/protobuf/internal/encoding/json/decode_string.go", "Go", 85, 0, 0, 0, 0, 0, 7, 92
"/opt/projects/swiftkube/vendor/google.golang.org/protobuf/internal/encoding/json/decode_token.go", "Go", 174, 0, 0, 0, 0, 0, 19, 193
"/opt/projects/swiftkube/vendor/google.golang.org/protobuf/internal/encoding/json/encode.go", "Go", 246, 0, 0, 0, 0, 0, 31, 277
"/opt/projects/swiftkube/vendor/google.golang.org/protobuf/internal/encoding/messageset/messageset.go", "Go", 228, 0, 0, 0, 0, 0, 15, 243
"/opt/projects/swiftkube/vendor/google.golang.org/protobuf/internal/encoding/tag/tag.go", "Go", 200, 0, 0, 0, 0, 0, 8, 208
"/opt/projects/swiftkube/vendor/google.golang.org/protobuf/internal/encoding/text/decode.go", "Go", 610, 0, 0, 0, 0, 0, 77, 687
"/opt/projects/swiftkube/vendor/google.golang.org/protobuf/internal/encoding/text/decode_number.go", "Go", 191, 0, 0, 0, 0, 0, 21, 212
"/opt/projects/swiftkube/vendor/google.golang.org/protobuf/internal/encoding/text/decode_string.go", "Go", 153, 0, 0, 0, 0, 0, 9, 162
"/opt/projects/swiftkube/vendor/google.golang.org/protobuf/internal/encoding/text/decode_token.go", "Go", 338, 0, 0, 0, 0, 0, 36, 374
"/opt/projects/swiftkube/vendor/google.golang.org/protobuf/internal/encoding/text/doc.go", "Go", 28, 0, 0, 0, 0, 0, 2, 30
"/opt/projects/swiftkube/vendor/google.golang.org/protobuf/internal/encoding/text/encode.go", "Go", 239, 0, 0, 0, 0, 0, 32, 271
"/opt/projects/swiftkube/vendor/google.golang.org/protobuf/internal/errors/errors.go", "Go", 72, 0, 0, 0, 0, 0, 18, 90
"/opt/projects/swiftkube/vendor/google.golang.org/protobuf/internal/errors/is_go112.go", "Go", 34, 0, 0, 0, 0, 0, 7, 41
"/opt/projects/swiftkube/vendor/google.golang.org/protobuf/internal/errors/is_go113.go", "Go", 9, 0, 0, 0, 0, 0, 5, 14
"/opt/projects/swiftkube/vendor/google.golang.org/protobuf/internal/filedesc/build.go", "Go", 141, 0, 0, 0, 0, 0, 17, 158
"/opt/projects/swiftkube/vendor/google.golang.org/protobuf/internal/filedesc/desc.go", "Go", 589, 0, 0, 0, 0, 0, 45, 634
"/opt/projects/swiftkube/vendor/google.golang.org/protobuf/internal/filedesc/desc_init.go", "Go", 440, 0, 0, 0, 0, 0, 32, 472
"/opt/projects/swiftkube/vendor/google.golang.org/protobuf/internal/filedesc/desc_lazy.go", "Go", 665, 0, 0, 0, 0, 0, 40, 705
"/opt/projects/swiftkube/vendor/google.golang.org/protobuf/internal/filedesc/desc_list.go", "Go", 424, 0, 0, 0, 0, 0, 34, 458
"/opt/projects/swiftkube/vendor/google.golang.org/protobuf/internal/filedesc/desc_list_gen.go", "Go", 336, 0, 0, 0, 0, 0, 21, 357
"/opt/projects/swiftkube/vendor/google.golang.org/protobuf/internal/filedesc/placeholder.go", "Go", 97, 0, 0, 0, 0, 0, 13, 110
"/opt/projects/swiftkube/vendor/google.golang.org/protobuf/internal/filetype/build.go", "Go", 267, 0, 0, 0, 0, 0, 30, 297
"/opt/projects/swiftkube/vendor/google.golang.org/protobuf/internal/flags/flags.go", "Go", 21, 0, 0, 0, 0, 0, 4, 25
"/opt/projects/swiftkube/vendor/google.golang.org/protobuf/internal/flags/proto_legacy_disable.go", "Go", 7, 0, 0, 0, 0, 0, 4, 11
"/opt/projects/swiftkube/vendor/google.golang.org/protobuf/internal/flags/proto_legacy_enable.go", "Go", 7, 0, 0, 0, 0, 0, 4, 11
"/opt/projects/swiftkube/vendor/google.golang.org/protobuf/internal/genid/any_gen.go", "Go", 26, 0, 0, 0, 0, 0, 9, 35
"/opt/projects/swiftkube/vendor/google.golang.org/protobuf/internal/genid/api_gen.go", "Go", 90, 0, 0, 0, 0, 0, 17, 107
"/opt/projects/swiftkube/vendor/google.golang.org/protobuf/internal/genid/descriptor_gen.go", "Go", 750, 0, 0, 0, 0, 0, 122, 872
"/opt/projects/swiftkube/vendor/google.golang.org/protobuf/internal/genid/doc.go", "Go", 8, 0, 0, 0, 0, 0, 4, 12
"/opt/projects/swiftkube/vendor/google.golang.org/protobuf/internal/genid/duration_gen.go", "Go", 26, 0, 0, 0, 0, 0, 9, 35
"/opt/projects/swiftkube/vendor/google.golang.org/protobuf/internal/genid/empty_gen.go", "Go", 14, 0, 0, 0, 0, 0, 6, 20
"/opt/projects/swiftkube/vendor/google.golang.org/protobuf/internal/genid/field_mask_gen.go", "Go", 23, 0, 0, 0, 0, 0, 9, 32
"/opt/projects/swiftkube/vendor/google.golang.org/protobuf/internal/genid/goname.go", "Go", 18, 0, 0, 0, 0, 0, 8, 26
"/opt/projects/swiftkube/vendor/google.golang.org/protobuf/internal/genid/map_entry.go", "Go", 12, 0, 0, 0, 0, 0, 5, 17
"/opt/projects/swiftkube/vendor/google.golang.org/protobuf/internal/genid/source_context_gen.go", "Go", 23, 0, 0, 0, 0, 0, 9, 32
"/opt/projects/swiftkube/vendor/google.golang.org/protobuf/internal/genid/struct_gen.go", "Go", 93, 0, 0, 0, 0, 0, 24, 117
"/opt/projects/swiftkube/vendor/google.golang.org/protobuf/internal/genid/timestamp_gen.go", "Go", 26, 0, 0, 0, 0, 0, 9, 35
"/opt/projects/swiftkube/vendor/google.golang.org/protobuf/internal/genid/type_gen.go", "Go", 157, 0, 0, 0, 0, 0, 28, 185
"/opt/projects/swiftkube/vendor/google.golang.org/protobuf/internal/genid/wrappers.go", "Go", 10, 0, 0, 0, 0, 0, 4, 14
"/opt/projects/swiftkube/vendor/google.golang.org/protobuf/internal/genid/wrappers_gen.go", "Go", 135, 0, 0, 0, 0, 0, 41, 176
"/opt/projects/swiftkube/vendor/google.golang.org/protobuf/internal/impl/api_export.go", "Go", 157, 0, 0, 0, 0, 0, 21, 178
"/opt/projects/swiftkube/vendor/google.golang.org/protobuf/internal/impl/checkinit.go", "Go", 132, 0, 0, 0, 0, 0, 10, 142
"/opt/projects/swiftkube/vendor/google.golang.org/protobuf/internal/impl/codec_extension.go", "Go", 203, 0, 0, 0, 0, 0, 21, 224
"/opt/projects/swiftkube/vendor/google.golang.org/protobuf/internal/impl/codec_field.go", "Go", 771, 0, 0, 0, 0, 0, 60, 831
"/opt/projects/swiftkube/vendor/google.golang.org/protobuf/internal/impl/codec_gen.go", "Go", 5171, 0, 0, 0, 0, 0, 467, 5638
"/opt/projects/swiftkube/vendor/google.golang.org/protobuf/internal/impl/codec_map.go", "Go", 370, 0, 0, 0, 0, 0, 19, 389
"/opt/projects/swiftkube/vendor/google.golang.org/protobuf/internal/impl/codec_map_go111.go", "Go", 30, 0, 0, 0, 0, 0, 9, 39
"/opt/projects/swiftkube/vendor/google.golang.org/protobuf/internal/impl/codec_map_go112.go", "Go", 8, 0, 0, 0, 0, 0, 5, 13
"/opt/projects/swiftkube/vendor/google.golang.org/protobuf/internal/impl/codec_message.go", "Go", 202, 0, 0, 0, 0, 0, 16, 218
"/opt/projects/swiftkube/vendor/google.golang.org/protobuf/internal/impl/codec_messageset.go", "Go", 109, 0, 0, 0, 0, 0, 15, 124
"/opt/projects/swiftkube/vendor/google.golang.org/protobuf/internal/impl/codec_reflect.go", "Go", 184, 0, 0, 0, 0, 0, 27, 211
"/opt/projects/swiftkube/vendor/google.golang.org/protobuf/internal/impl/codec_tables.go", "Go", 550, 0, 0, 0, 0, 0, 8, 558
"/opt/projects/swiftkube/vendor/google.golang.org/protobuf/internal/impl/codec_unsafe.go", "Go", 14, 0, 0, 0, 0, 0, 5, 19
"/opt/projects/swiftkube/vendor/google.golang.org/protobuf/internal/impl/convert.go", "Go", 446, 0, 0, 0, 0, 0, 50, 496
"/opt/projects/swiftkube/vendor/google.golang.org/protobuf/internal/impl/convert_list.go", "Go", 121, 0, 0, 0, 0, 0, 21, 142
"/opt/projects/swiftkube/vendor/google.golang.org/protobuf/internal/impl/convert_map.go", "Go", 108, 0, 0, 0, 0, 0, 14, 122
"/opt/projects/swiftkube/vendor/google.golang.org/protobuf/internal/impl/decode.go", "Go", 268, 0, 0, 0, 0, 0, 18, 286
"/opt/projects/swiftkube/vendor/google.golang.org/protobuf/internal/impl/encode.go", "Go", 187, 0, 0, 0, 0, 0, 15, 202
"/opt/projects/swiftkube/vendor/google.golang.org/protobuf/internal/impl/enum.go", "Go", 16, 0, 0, 0, 0, 0, 6, 22
"/opt/projects/swiftkube/vendor/google.golang.org/protobuf/internal/impl/extension.go", "Go", 136, 0, 0, 0, 0, 0, 21, 157
"/opt/projects/swiftkube/vendor/google.golang.org/protobuf/internal/impl/legacy_enum.go", "Go", 192, 0, 0, 0, 0, 0, 27, 219
"/opt/projects/swiftkube/vendor/google.golang.org/protobuf/internal/impl/legacy_export.go", "Go", 81, 0, 0, 0, 0, 0, 12, 93
"/opt/projects/swiftkube/vendor/google.golang.org/protobuf/internal/impl/legacy_extension.go", "Go", 158, 0, 0, 0, 0, 0, 19, 177
"/opt/projects/swiftkube/vendor/google.golang.org/protobuf/internal/impl/legacy_file.go", "Go", 71, 0, 0, 0, 0, 0, 11, 82
"/opt/projects/swiftkube/vendor/google.golang.org/protobuf/internal/impl/legacy_message.go", "Go", 511, 0, 0, 0, 0, 0, 53, 564
"/opt/projects/swiftkube/vendor/google.golang.org/protobuf/internal/impl/merge.go", "Go", 158, 0, 0, 0, 0, 0, 19, 177
"/opt/projects/swiftkube/vendor/google.golang.org/protobuf/internal/impl/merge_gen.go", "Go", 174, 0, 0, 0, 0, 0, 36, 210
"/opt/projects/swiftkube/vendor/google.golang.org/protobuf/internal/impl/message.go", "Go", 250, 0, 0, 0, 0, 0, 30, 280
"/opt/projects/swiftkube/vendor/google.golang.org/protobuf/internal/impl/message_reflect.go", "Go", 431, 0, 0, 0, 0, 0, 33, 464
"/opt/projects/swiftkube/vendor/google.golang.org/protobuf/internal/impl/message_reflect_field.go", "Go", 519, 0, 0, 0, 0, 0, 25, 544
"/opt/projects/swiftkube/vendor/google.golang.org/protobuf/internal/impl/message_reflect_gen.go", "Go", 240, 0, 0, 0, 0, 0, 10, 250
"/opt/projects/swiftkube/vendor/google.golang.org/protobuf/internal/impl/pointer_reflect.go", "Go", 153, 0, 0, 0, 0, 0, 27, 180
"/opt/projects/swiftkube/vendor/google.golang.org/protobuf/internal/impl/pointer_unsafe.go", "Go", 148, 0, 0, 0, 0, 0, 28, 176
"/opt/projects/swiftkube/vendor/google.golang.org/protobuf/internal/impl/validate.go", "Go", 557, 0, 0, 0, 0, 0, 20, 577
"/opt/projects/swiftkube/vendor/google.golang.org/protobuf/internal/impl/weak.go", "Go", 63, 0, 0, 0, 0, 0, 12, 75
"/opt/projects/swiftkube/vendor/google.golang.org/protobuf/internal/order/order.go", "Go", 78, 0, 0, 0, 0, 0, 12, 90
"/opt/projects/swiftkube/vendor/google.golang.org/protobuf/internal/order/range.go", "Go", 98, 0, 0, 0, 0, 0, 18, 116
"/opt/projects/swiftkube/vendor/google.golang.org/protobuf/internal/pragma/pragma.go", "Go", 23, 0, 0, 0, 0, 0, 7, 30
"/opt/projects/swiftkube/vendor/google.golang.org/protobuf/internal/set/ints.go", "Go", 52, 0, 0, 0, 0, 0, 7, 59
"/opt/projects/swiftkube/vendor/google.golang.org/protobuf/internal/strs/strings.go", "Go", 182, 0, 0, 0, 0, 0, 15, 197
"/opt/projects/swiftkube/vendor/google.golang.org/protobuf/internal/strs/strings_pure.go", "Go", 20, 0, 0, 0, 0, 0, 9, 29
"/opt/projects/swiftkube/vendor/google.golang.org/protobuf/internal/strs/strings_unsafe.go", "Go", 82, 0, 0, 0, 0, 0, 14, 96
"/opt/projects/swiftkube/vendor/google.golang.org/protobuf/internal/version/version.go", "Go", 74, 0, 0, 0, 0, 0, 6, 80
"/opt/projects/swiftkube/vendor/google.golang.org/protobuf/proto/checkinit.go", "Go", 65, 0, 0, 0, 0, 0, 7, 72
"/opt/projects/swiftkube/vendor/google.golang.org/protobuf/proto/decode.go", "Go", 274, 0, 0, 0, 0, 0, 21, 295
"/opt/projects/swiftkube/vendor/google.golang.org/protobuf/proto/decode_gen.go", "Go", 596, 0, 0, 0, 0, 0, 8, 604
"/opt/projects/swiftkube/vendor/google.golang.org/protobuf/proto/doc.go", "Go", 85, 0, 0, 0, 0, 0, 2, 87
"/opt/projects/swiftkube/vendor/google.golang.org/protobuf/proto/encode.go", "Go", 296, 0, 0, 0, 0, 0, 27, 323
"/opt/projects/swiftkube/vendor/google.golang.org/protobuf/proto/encode_gen.go", "Go", 91, 0, 0, 0, 0, 0, 7, 98
"/opt/projects/swiftkube/vendor/google.golang.org/protobuf/proto/equal.go", "Go", 53, 0, 0, 0, 0, 0, 5, 58
"/opt/projects/swiftkube/vendor/google.golang.org/protobuf/proto/extension.go", "Go", 79, 0, 0, 0, 0, 0, 14, 93
"/opt/projects/swiftkube/vendor/google.golang.org/protobuf/proto/merge.go", "Go", 125, 0, 0, 0, 0, 0, 15, 140
"/opt/projects/swiftkube/vendor/google.golang.org/protobuf/proto/messageset.go", "Go", 86, 0, 0, 0, 0, 0, 8, 94
"/opt/projects/swiftkube/vendor/google.golang.org/protobuf/proto/proto.go", "Go", 37, 0, 0, 0, 0, 0, 7, 44
"/opt/projects/swiftkube/vendor/google.golang.org/protobuf/proto/proto_methods.go", "Go", 15, 0, 0, 0, 0, 0, 6, 21
"/opt/projects/swiftkube/vendor/google.golang.org/protobuf/proto/proto_reflect.go", "Go", 15, 0, 0, 0, 0, 0, 6, 21
"/opt/projects/swiftkube/vendor/google.golang.org/protobuf/proto/reset.go", "Go", 35, 0, 0, 0, 0, 0, 9, 44
"/opt/projects/swiftkube/vendor/google.golang.org/protobuf/proto/size.go", "Go", 86, 0, 0, 0, 0, 0, 12, 98
"/opt/projects/swiftkube/vendor/google.golang.org/protobuf/proto/size_gen.go", "Go", 51, 0, 0, 0, 0, 0, 5, 56
"/opt/projects/swiftkube/vendor/google.golang.org/protobuf/proto/wrappers.go", "Go", 20, 0, 0, 0, 0, 0, 10, 30
"/opt/projects/swiftkube/vendor/google.golang.org/protobuf/reflect/protodesc/desc.go", "Go", 256, 0, 0, 0, 0, 0, 21, 277
"/opt/projects/swiftkube/vendor/google.golang.org/protobuf/reflect/protodesc/desc_init.go", "Go", 232, 0, 0, 0, 0, 0, 17, 249
"/opt/projects/swiftkube/vendor/google.golang.org/protobuf/reflect/protodesc/desc_resolve.go", "Go", 263, 0, 0, 0, 0, 0, 24, 287
"/opt/projects/swiftkube/vendor/google.golang.org/protobuf/reflect/protodesc/desc_validate.go", "Go", 357, 0, 0, 0, 0, 0, 18, 375
"/opt/projects/swiftkube/vendor/google.golang.org/protobuf/reflect/protodesc/proto.go", "Go", 238, 0, 0, 0, 0, 0, 15, 253
"/opt/projects/swiftkube/vendor/google.golang.org/protobuf/reflect/protoreflect/methods.go", "Go", 75, 0, 0, 0, 0, 0, 4, 79
"/opt/projects/swiftkube/vendor/google.golang.org/protobuf/reflect/protoreflect/proto.go", "Go", 467, 0, 0, 0, 0, 0, 42, 509
"/opt/projects/swiftkube/vendor/google.golang.org/protobuf/reflect/protoreflect/source.go", "Go", 113, 0, 0, 0, 0, 0, 17, 130
"/opt/projects/swiftkube/vendor/google.golang.org/protobuf/reflect/protoreflect/source_gen.go", "Go", 449, 0, 0, 0, 0, 0, 27, 476
"/opt/projects/swiftkube/vendor/google.golang.org/protobuf/reflect/protoreflect/type.go", "Go", 565, 0, 0, 0, 0, 0, 102, 667
"/opt/projects/swiftkube/vendor/google.golang.org/protobuf/reflect/protoreflect/value.go", "Go", 245, 0, 0, 0, 0, 0, 41, 286
"/opt/projects/swiftkube/vendor/google.golang.org/protobuf/reflect/protoreflect/value_equal.go", "Go", 155, 0, 0, 0, 0, 0, 14, 169
"/opt/projects/swiftkube/vendor/google.golang.org/protobuf/reflect/protoreflect/value_pure.go", "Go", 51, 0, 0, 0, 0, 0, 10, 61
"/opt/projects/swiftkube/vendor/google.golang.org/protobuf/reflect/protoreflect/value_union.go", "Go", 397, 0, 0, 0, 0, 0, 42, 439
"/opt/projects/swiftkube/vendor/google.golang.org/protobuf/reflect/protoreflect/value_unsafe.go", "Go", 86, 0, 0, 0, 0, 0, 14, 100
"/opt/projects/swiftkube/vendor/google.golang.org/protobuf/reflect/protoregistry/registry.go", "Go", 819, 0, 0, 0, 0, 0, 64, 883
"/opt/projects/swiftkube/vendor/google.golang.org/protobuf/runtime/protoiface/legacy.go", "Go", 12, 0, 0, 0, 0, 0, 4, 16
"/opt/projects/swiftkube/vendor/google.golang.org/protobuf/runtime/protoiface/methods.go", "Go", 129, 0, 0, 0, 0, 0, 40, 169
"/opt/projects/swiftkube/vendor/google.golang.org/protobuf/runtime/protoimpl/impl.go", "Go", 36, 0, 0, 0, 0, 0, 9, 45
"/opt/projects/swiftkube/vendor/google.golang.org/protobuf/runtime/protoimpl/version.go", "Go", 53, 0, 0, 0, 0, 0, 8, 61
"/opt/projects/swiftkube/vendor/google.golang.org/protobuf/types/descriptorpb/descriptor.pb.go", "Go", 3920, 0, 0, 0, 0, 0, 431, 4351
"/opt/projects/swiftkube/vendor/google.golang.org/protobuf/types/dynamicpb/dynamic.go", "Go", 649, 0, 0, 0, 0, 0, 69, 718
"/opt/projects/swiftkube/vendor/google.golang.org/protobuf/types/known/anypb/any.pb.go", "Go", 468, 0, 0, 0, 0, 0, 28, 496
"/opt/projects/swiftkube/vendor/google.golang.org/protobuf/types/known/durationpb/duration.pb.go", "Go", 350, 0, 0, 0, 0, 0, 25, 375
"/opt/projects/swiftkube/vendor/google.golang.org/protobuf/types/known/emptypb/empty.pb.go", "Go", 151, 0, 0, 0, 0, 0, 16, 167
"/opt/projects/swiftkube/vendor/google.golang.org/protobuf/types/known/fieldmaskpb/field_mask.pb.go", "Go", 553, 0, 0, 0, 0, 0, 36, 589
"/opt/projects/swiftkube/vendor/google.golang.org/protobuf/types/known/structpb/struct.pb.go", "Go", 731, 0, 0, 0, 0, 0, 80, 811
"/opt/projects/swiftkube/vendor/google.golang.org/protobuf/types/known/timestamppb/timestamp.pb.go", "Go", 358, 0, 0, 0, 0, 0, 26, 384
"/opt/projects/swiftkube/vendor/google.golang.org/protobuf/types/known/wrapperspb/wrappers.pb.go", "Go", 670, 0, 0, 0, 0, 0, 91, 761
"/opt/projects/swiftkube/vendor/gopkg.in/gcfg.v1/doc.go", "Go", 145, 0, 0, 0, 0, 0, 1, 146
"/opt/projects/swiftkube/vendor/gopkg.in/gcfg.v1/errors.go", "Go", 47, 0, 0, 0, 0, 0, 11, 58
"/opt/projects/swiftkube/vendor/gopkg.in/gcfg.v1/read.go", "Go", 244, 0, 0, 0, 0, 0, 14, 258
"/opt/projects/swiftkube/vendor/gopkg.in/gcfg.v1/scanner/errors.go", "Go", 106, 0, 0, 0, 0, 0, 16, 122
"/opt/projects/swiftkube/vendor/gopkg.in/gcfg.v1/scanner/scanner.go", "Go", 307, 0, 0, 0, 0, 0, 36, 343
"/opt/projects/swiftkube/vendor/gopkg.in/gcfg.v1/set.go", "Go", 307, 0, 0, 0, 0, 0, 23, 330
"/opt/projects/swiftkube/vendor/gopkg.in/gcfg.v1/token/position.go", "Go", 391, 0, 0, 0, 0, 0, 45, 436
"/opt/projects/swiftkube/vendor/gopkg.in/gcfg.v1/token/serialize.go", "Go", 47, 0, 0, 0, 0, 0, 10, 57
"/opt/projects/swiftkube/vendor/gopkg.in/gcfg.v1/token/token.go", "Go", 69, 0, 0, 0, 0, 0, 15, 84
"/opt/projects/swiftkube/vendor/gopkg.in/gcfg.v1/types/bool.go", "Go", 20, 0, 0, 0, 0, 0, 4, 24
"/opt/projects/swiftkube/vendor/gopkg.in/gcfg.v1/types/doc.go", "Go", 4, 0, 0, 0, 0, 0, 1, 5
"/opt/projects/swiftkube/vendor/gopkg.in/gcfg.v1/types/enum.go", "Go", 40, 0, 0, 0, 0, 0, 5, 45
"/opt/projects/swiftkube/vendor/gopkg.in/gcfg.v1/types/int.go", "Go", 78, 0, 0, 0, 0, 0, 9, 87
"/opt/projects/swiftkube/vendor/gopkg.in/gcfg.v1/types/scan.go", "Go", 21, 0, 0, 0, 0, 0, 3, 24
"/opt/projects/swiftkube/vendor/gopkg.in/inf.v0/dec.go", "Go", 563, 0, 0, 0, 0, 0, 53, 616
"/opt/projects/swiftkube/vendor/gopkg.in/inf.v0/rounder.go", "Go", 132, 0, 0, 0, 0, 0, 14, 146
"/opt/projects/swiftkube/vendor/gopkg.in/natefinch/lumberjack.v2/chown.go", "Go", 8, 0, 0, 0, 0, 0, 4, 12
"/opt/projects/swiftkube/vendor/gopkg.in/natefinch/lumberjack.v2/chown_linux.go", "Go", 16, 0, 0, 0, 0, 0, 4, 20
"/opt/projects/swiftkube/vendor/gopkg.in/natefinch/lumberjack.v2/lumberjack.go", "Go", 472, 0, 0, 0, 0, 0, 70, 542
"/opt/projects/swiftkube/vendor/gopkg.in/warnings.v0/warnings.go", "Go", 183, 0, 0, 0, 0, 0, 12, 195
"/opt/projects/swiftkube/vendor/gopkg.in/yaml.v2/apic.go", "Go", 708, 0, 0, 0, 0, 0, 37, 745
"/opt/projects/swiftkube/vendor/gopkg.in/yaml.v2/decode.go", "Go", 760, 0, 0, 0, 0, 0, 56, 816
"/opt/projects/swiftkube/vendor/gopkg.in/yaml.v2/emitterc.go", "Go", 1549, 0, 0, 0, 0, 0, 137, 1686
"/opt/projects/swiftkube/vendor/gopkg.in/yaml.v2/encode.go", "Go", 362, 0, 0, 0, 0, 0, 29, 391
"/opt/projects/swiftkube/vendor/gopkg.in/yaml.v2/parserc.go", "Go", 996, 0, 0, 0, 0, 0, 100, 1096
"/opt/projects/swiftkube/vendor/gopkg.in/yaml.v2/readerc.go", "Go", 366, 0, 0, 0, 0, 0, 47, 413
"/opt/projects/swiftkube/vendor/gopkg.in/yaml.v2/resolve.go", "Go", 235, 0, 0, 0, 0, 0, 24, 259
"/opt/projects/swiftkube/vendor/gopkg.in/yaml.v2/scannerc.go", "Go", 2413, 0, 0, 0, 0, 0, 299, 2712
"/opt/projects/swiftkube/vendor/gopkg.in/yaml.v2/sorter.go", "Go", 108, 0, 0, 0, 0, 0, 6, 114
"/opt/projects/swiftkube/vendor/gopkg.in/yaml.v2/writerc.go", "Go", 22, 0, 0, 0, 0, 0, 5, 27
"/opt/projects/swiftkube/vendor/gopkg.in/yaml.v2/yaml.go", "Go", 434, 0, 0, 0, 0, 0, 45, 479
"/opt/projects/swiftkube/vendor/gopkg.in/yaml.v2/yamlh.go", "Go", 590, 0, 0, 0, 0, 0, 150, 740
"/opt/projects/swiftkube/vendor/gopkg.in/yaml.v2/yamlprivateh.go", "Go", 149, 0, 0, 0, 0, 0, 25, 174
"/opt/projects/swiftkube/vendor/gopkg.in/yaml.v3/apic.go", "Go", 711, 0, 0, 0, 0, 0, 37, 748
"/opt/projects/swiftkube/vendor/gopkg.in/yaml.v3/decode.go", "Go", 933, 0, 0, 0, 0, 0, 68, 1001
"/opt/projects/swiftkube/vendor/gopkg.in/yaml.v3/emitterc.go", "Go", 1867, 0, 0, 0, 0, 0, 154, 2021
"/opt/projects/swiftkube/vendor/gopkg.in/yaml.v3/encode.go", "Go", 535, 0, 0, 0, 0, 0, 43, 578
"/opt/projects/swiftkube/vendor/gopkg.in/yaml.v3/parserc.go", "Go", 1149, 0, 0, 0, 0, 0, 110, 1259
"/opt/projects/swiftkube/vendor/gopkg.in/yaml.v3/readerc.go", "Go", 387, 0, 0, 0, 0, 0, 48, 435
"/opt/projects/swiftkube/vendor/gopkg.in/yaml.v3/resolve.go", "Go", 299, 0, 0, 0, 0, 0, 28, 327
"/opt/projects/swiftkube/vendor/gopkg.in/yaml.v3/scannerc.go", "Go", 2710, 0, 0, 0, 0, 0, 329, 3039
"/opt/projects/swiftkube/vendor/gopkg.in/yaml.v3/sorter.go", "Go", 128, 0, 0, 0, 0, 0, 7, 135
"/opt/projects/swiftkube/vendor/gopkg.in/yaml.v3/writerc.go", "Go", 43, 0, 0, 0, 0, 0, 6, 49
"/opt/projects/swiftkube/vendor/gopkg.in/yaml.v3/yaml.go", "Go", 630, 0, 0, 0, 0, 0, 69, 699
"/opt/projects/swiftkube/vendor/gopkg.in/yaml.v3/yamlh.go", "Go", 646, 0, 0, 0, 0, 0, 162, 808
"/opt/projects/swiftkube/vendor/gopkg.in/yaml.v3/yamlprivateh.go", "Go", 173, 0, 0, 0, 0, 0, 26, 199
"/opt/projects/swiftkube/vendor/k8s.io/api/admission/v1/doc.go", "Go", 17, 0, 0, 0, 0, 0, 7, 24
"/opt/projects/swiftkube/vendor/k8s.io/api/admission/v1/generated.pb.go", "Go", 1745, 0, 0, 0, 0, 0, 39, 1784
"/opt/projects/swiftkube/vendor/k8s.io/api/admission/v1/generated.proto", "Protocol Buffers", 0, 0, 49, 0, 0, 84, 35, 168
"/opt/projects/swiftkube/vendor/k8s.io/api/admission/v1/register.go", "Go", 43, 0, 0, 0, 0, 0, 11, 54
"/opt/projects/swiftkube/vendor/k8s.io/api/admission/v1/types.go", "Go", 148, 0, 0, 0, 0, 0, 22, 170
"/opt/projects/swiftkube/vendor/k8s.io/api/admission/v1/types_swagger_doc_generated.go", "Go", 66, 0, 0, 0, 0, 0, 13, 79
"/opt/projects/swiftkube/vendor/k8s.io/api/admission/v1/zz_generated.deepcopy.go", "Go", 128, 0, 0, 0, 0, 0, 15, 143
"/opt/projects/swiftkube/vendor/k8s.io/api/admission/v1beta1/doc.go", "Go", 18, 0, 0, 0, 0, 0, 7, 25
"/opt/projects/swiftkube/vendor/k8s.io/api/admission/v1beta1/generated.pb.go", "Go", 1745, 0, 0, 0, 0, 0, 39, 1784
"/opt/projects/swiftkube/vendor/k8s.io/api/admission/v1beta1/generated.proto", "Protocol Buffers", 0, 0, 49, 0, 0, 84, 35, 168
"/opt/projects/swiftkube/vendor/k8s.io/api/admission/v1beta1/register.go", "Go", 43, 0, 0, 0, 0, 0, 11, 54
"/opt/projects/swiftkube/vendor/k8s.io/api/admission/v1beta1/types.go", "Go", 153, 0, 0, 0, 0, 0, 22, 175
"/opt/projects/swiftkube/vendor/k8s.io/api/admission/v1beta1/types_swagger_doc_generated.go", "Go", 66, 0, 0, 0, 0, 0, 13, 79
"/opt/projects/swiftkube/vendor/k8s.io/api/admission/v1beta1/zz_generated.deepcopy.go", "Go", 128, 0, 0, 0, 0, 0, 15, 143
"/opt/projects/swiftkube/vendor/k8s.io/api/admission/v1beta1/zz_generated.prerelease-lifecycle.go", "Go", 39, 0, 0, 0, 0, 0, 12, 51
"/opt/projects/swiftkube/vendor/k8s.io/api/admissionregistration/v1/doc.go", "Go", 21, 0, 0, 0, 0, 0, 6, 27
"/opt/projects/swiftkube/vendor/k8s.io/api/admissionregistration/v1/generated.pb.go", "Go", 3645, 0, 0, 0, 0, 0, 94, 3739
"/opt/projects/swiftkube/vendor/k8s.io/api/admissionregistration/v1/generated.proto", "Protocol Buffers", 0, 0, 86, 0, 0, 414, 57, 557
"/opt/projects/swiftkube/vendor/k8s.io/api/admissionregistration/v1/register.go", "Go", 46, 0, 0, 0, 0, 0, 11, 57
"/opt/projects/swiftkube/vendor/k8s.io/api/admissionregistration/v1/types.go", "Go", 577, 0, 0, 0, 0, 0, 62, 639
"/opt/projects/swiftkube/vendor/k8s.io/api/admissionregistration/v1/types_swagger_doc_generated.go", "Go", 135, 0, 0, 0, 0, 0, 29, 164
"/opt/projects/swiftkube/vendor/k8s.io/api/admissionregistration/v1/zz_generated.deepcopy.go", "Go", 390, 0, 0, 0, 0, 0, 34, 424
"/opt/projects/swiftkube/vendor/k8s.io/api/admissionregistration/v1alpha1/doc.go", "Go", 18, 0, 0, 0, 0, 0, 6, 24
"/opt/projects/swiftkube/vendor/k8s.io/api/admissionregistration/v1alpha1/generated.pb.go", "Go", 4499, 0, 0, 0, 0, 0, 136, 4635
"/opt/projects/swiftkube/vendor/k8s.io/api/admissionregistration/v1alpha1/generated.proto", "Protocol Buffers", 0, 0, 102, 0, 0, 448, 60, 610
"/opt/projects/swiftkube/vendor/k8s.io/api/admissionregistration/v1alpha1/register.go", "Go", 46, 0, 0, 0, 0, 0, 11, 57
"/opt/projects/swiftkube/vendor/k8s.io/api/admissionregistration/v1alpha1/types.go", "Go", 610, 0, 0, 0, 0, 0, 56, 666
"/opt/projects/swiftkube/vendor/k8s.io/api/admissionregistration/v1alpha1/types_swagger_doc_generated.go", "Go", 166, 0, 0, 0, 0, 0, 39, 205
"/opt/projects/swiftkube/vendor/k8s.io/api/admissionregistration/v1alpha1/zz_generated.deepcopy.go", "Go", 430, 0, 0, 0, 0, 0, 46, 476
"/opt/projects/swiftkube/vendor/k8s.io/api/admissionregistration/v1beta1/doc.go", "Go", 22, 0, 0, 0, 0, 0, 6, 28
"/opt/projects/swiftkube/vendor/k8s.io/api/admissionregistration/v1beta1/generated.pb.go", "Go", 7248, 0, 0, 0, 0, 0, 192, 7440
"/opt/projects/swiftkube/vendor/k8s.io/api/admissionregistration/v1beta1/generated.proto", "Protocol Buffers", 0, 0, 156, 0, 0, 811, 98, 1065
"/opt/projects/swiftkube/vendor/k8s.io/api/admissionregistration/v1beta1/register.go", "Go", 50, 0, 0, 0, 0, 0, 11, 61
"/opt/projects/swiftkube/vendor/k8s.io/api/admissionregistration/v1beta1/types.go", "Go", 1100, 0, 0, 0, 0, 0, 97, 1197
"/opt/projects/swiftkube/vendor/k8s.io/api/admissionregistration/v1beta1/types_swagger_doc_generated.go", "Go", 260, 0, 0, 0, 0, 0, 57, 317
"/opt/projects/swiftkube/vendor/k8s.io/api/admissionregistration/v1beta1/zz_generated.deepcopy.go", "Go", 733, 0, 0, 0, 0, 0, 66, 799
"/opt/projects/swiftkube/vendor/k8s.io/api/admissionregistration/v1beta1/zz_generated.prerelease-lifecycle.go", "Go", 159, 0, 0, 0, 0, 0, 36, 195
"/opt/projects/swiftkube/vendor/k8s.io/api/apidiscovery/v2beta1/doc.go", "Go", 18, 0, 0, 0, 0, 0, 7, 25
"/opt/projects/swiftkube/vendor/k8s.io/api/apidiscovery/v2beta1/generated.pb.go", "Go", 1693, 0, 0, 0, 0, 0, 52, 1745
"/opt/projects/swiftkube/vendor/k8s.io/api/apidiscovery/v2beta1/generated.proto", "Protocol Buffers", 0, 0, 47, 0, 0, 80, 30, 157
"/opt/projects/swiftkube/vendor/k8s.io/api/apidiscovery/v2beta1/register.go", "Go", 45, 0, 0, 0, 0, 0, 12, 57
"/opt/projects/swiftkube/vendor/k8s.io/api/apidiscovery/v2beta1/types.go", "Go", 147, 0, 0, 0, 0, 0, 17, 164
"/opt/projects/swiftkube/vendor/k8s.io/api/apidiscovery/v2beta1/zz_generated.deepcopy.go", "Go", 171, 0, 0, 0, 0, 0, 20, 191
"/opt/projects/swiftkube/vendor/k8s.io/api/apidiscovery/v2beta1/zz_generated.prerelease-lifecycle.go", "Go", 46, 0, 0, 0, 0, 0, 13, 59
"/opt/projects/swiftkube/vendor/k8s.io/api/apiserverinternal/v1alpha1/doc.go", "Go", 19, 0, 0, 0, 0, 0, 7, 26
"/opt/projects/swiftkube/vendor/k8s.io/api/apiserverinternal/v1alpha1/generated.pb.go", "Go", 1692, 0, 0, 0, 0, 0, 59, 1751
"/opt/projects/swiftkube/vendor/k8s.io/api/apiserverinternal/v1alpha1/generated.proto", "Protocol Buffers", 0, 0, 48, 0, 0, 52, 30, 130
"/opt/projects/swiftkube/vendor/k8s.io/api/apiserverinternal/v1alpha1/register.go", "Go", 38, 0, 0, 0, 0, 0, 11, 49
"/opt/projects/swiftkube/vendor/k8s.io/api/apiserverinternal/v1alpha1/types.go", "Go", 112, 0, 0, 0, 0, 0, 24, 136
"/opt/projects/swiftkube/vendor/k8s.io/api/apiserverinternal/v1alpha1/types_swagger_doc_generated.go", "Go", 78, 0, 0, 0, 0, 0, 19, 97
"/opt/projects/swiftkube/vendor/k8s.io/api/apiserverinternal/v1alpha1/zz_generated.deepcopy.go", "Go", 160, 0, 0, 0, 0, 0, 22, 182
"/opt/projects/swiftkube/vendor/k8s.io/api/apps/v1/doc.go", "Go", 16, 0, 0, 0, 0, 0, 6, 22
"/opt/projects/swiftkube/vendor/k8s.io/api/apps/v1/generated.pb.go", "Go", 8545, 0, 0, 0, 0, 0, 228, 8773
"/opt/projects/swiftkube/vendor/k8s.io/api/apps/v1/generated.proto", "Protocol Buffers", 0, 0, 203, 0, 0, 469, 134, 806
"/opt/projects/swiftkube/vendor/k8s.io/api/apps/v1/register.go", "Go", 50, 0, 0, 0, 0, 0, 11, 61
"/opt/projects/swiftkube/vendor/k8s.io/api/apps/v1/types.go", "Go", 813, 0, 0, 0, 0, 0, 143, 956
"/opt/projects/swiftkube/vendor/k8s.io/api/apps/v1/types_swagger_doc_generated.go", "Go", 327, 0, 0, 0, 0, 0, 67, 394
"/opt/projects/swiftkube/vendor/k8s.io/api/apps/v1/zz_generated.deepcopy.go", "Go", 748, 0, 0, 0, 0, 0, 78, 826
"/opt/projects/swiftkube/vendor/k8s.io/api/apps/v1beta1/doc.go", "Go", 17, 0, 0, 0, 0, 0, 6, 23
"/opt/projects/swiftkube/vendor/k8s.io/api/apps/v1beta1/generated.pb.go", "Go", 6570, 0, 0, 0, 0, 0, 179, 6749
"/opt/projects/swiftkube/vendor/k8s.io/api/apps/v1beta1/generated.proto", "Protocol Buffers", 0, 0, 152, 0, 0, 308, 97, 557
"/opt/projects/swiftkube/vendor/k8s.io/api/apps/v1beta1/register.go", "Go", 48, 0, 0, 0, 0, 0, 11, 59
"/opt/projects/swiftkube/vendor/k8s.io/api/apps/v1beta1/types.go", "Go", 588, 0, 0, 0, 0, 0, 100, 688
"/opt/projects/swiftkube/vendor/k8s.io/api/apps/v1beta1/types_swagger_doc_generated.go", "Go", 245, 0, 0, 0, 0, 0, 53, 298
"/opt/projects/swiftkube/vendor/k8s.io/api/apps/v1beta1/zz_generated.deepcopy.go", "Go", 581, 0, 0, 0, 0, 0, 62, 643
"/opt/projects/swiftkube/vendor/k8s.io/api/apps/v1beta1/zz_generated.prerelease-lifecycle.go", "Go", 179, 0, 0, 0, 0, 0, 40, 219
"/opt/projects/swiftkube/vendor/k8s.io/api/apps/v1beta2/doc.go", "Go", 17, 0, 0, 0, 0, 0, 6, 23
"/opt/projects/swiftkube/vendor/k8s.io/api/apps/v1beta2/generated.pb.go", "Go", 9290, 0, 0, 0, 0, 0, 249, 9539
"/opt/projects/swiftkube/vendor/k8s.io/api/apps/v1beta2/generated.proto", "Protocol Buffers", 0, 0, 216, 0, 0, 491, 141, 848
"/opt/projects/swiftkube/vendor/k8s.io/api/apps/v1beta2/register.go", "Go", 51, 0, 0, 0, 0, 0, 11, 62
"/opt/projects/swiftkube/vendor/k8s.io/api/apps/v1beta2/types.go", "Go", 883, 0, 0, 0, 0, 0, 150, 1033
"/opt/projects/swiftkube/vendor/k8s.io/api/apps/v1beta2/types_swagger_doc_generated.go", "Go", 349, 0, 0, 0, 0, 0, 73, 422
"/opt/projects/swiftkube/vendor/k8s.io/api/apps/v1beta2/zz_generated.deepcopy.go", "Go", 808, 0, 0, 0, 0, 0, 85, 893
"/opt/projects/swiftkube/vendor/k8s.io/api/apps/v1beta2/zz_generated.prerelease-lifecycle.go", "Go", 239, 0, 0, 0, 0, 0, 52, 291
"/opt/projects/swiftkube/vendor/k8s.io/api/authentication/v1/doc.go", "Go", 17, 0, 0, 0, 0, 0, 6, 23
"/opt/projects/swiftkube/vendor/k8s.io/api/authentication/v1/generated.pb.go", "Go", 2841, 0, 0, 0, 0, 0, 95, 2936
"/opt/projects/swiftkube/vendor/k8s.io/api/authentication/v1/generated.proto", "Protocol Buffers", 0, 0, 69, 0, 0, 99, 41, 209
"/opt/projects/swiftkube/vendor/k8s.io/api/authentication/v1/register.go", "Go", 43, 0, 0, 0, 0, 0, 11, 54
"/opt/projects/swiftkube/vendor/k8s.io/api/authentication/v1/types.go", "Go", 192, 0, 0, 0, 0, 0, 33, 225
"/opt/projects/swiftkube/vendor/k8s.io/api/authentication/v1/types_swagger_doc_generated.go", "Go", 112, 0, 0, 0, 0, 0, 27, 139
"/opt/projects/swiftkube/vendor/k8s.io/api/authentication/v1/zz_generated.deepcopy.go", "Go", 257, 0, 0, 0, 0, 0, 33, 290
"/opt/projects/swiftkube/vendor/k8s.io/api/authentication/v1alpha1/doc.go", "Go", 18, 0, 0, 0, 0, 0, 6, 24
"/opt/projects/swiftkube/vendor/k8s.io/api/authentication/v1alpha1/generated.pb.go", "Go", 537, 0, 0, 0, 0, 0, 31, 568
"/opt/projects/swiftkube/vendor/k8s.io/api/authentication/v1alpha1/generated.proto", "Protocol Buffers", 0, 0, 26, 0, 0, 12, 14, 52
"/opt/projects/swiftkube/vendor/k8s.io/api/authentication/v1alpha1/register.go", "Go", 41, 0, 0, 0, 0, 0, 11, 52
"/opt/projects/swiftkube/vendor/k8s.io/api/authentication/v1alpha1/types.go", "Go", 40, 0, 0, 0, 0, 0, 9, 49
"/opt/projects/swiftkube/vendor/k8s.io/api/authentication/v1alpha1/types_swagger_doc_generated.go", "Go", 39, 0, 0, 0, 0, 0, 11, 50
"/opt/projects/swiftkube/vendor/k8s.io/api/authentication/v1alpha1/zz_generated.deepcopy.go", "Go", 58, 0, 0, 0, 0, 0, 13, 71
"/opt/projects/swiftkube/vendor/k8s.io/api/authentication/v1alpha1/zz_generated.prerelease-lifecycle.go", "Go", 31, 0, 0, 0, 0, 0, 10, 41
"/opt/projects/swiftkube/vendor/k8s.io/api/authentication/v1beta1/doc.go", "Go", 18, 0, 0, 0, 0, 0, 6, 24
"/opt/projects/swiftkube/vendor/k8s.io/api/authentication/v1beta1/generated.pb.go", "Go", 1860, 0, 0, 0, 0, 0, 66, 1926
"/opt/projects/swiftkube/vendor/k8s.io/api/authentication/v1beta1/generated.proto", "Protocol Buffers", 0, 0, 50, 0, 0, 63, 29, 142
"/opt/projects/swiftkube/vendor/k8s.io/api/authentication/v1beta1/register.go", "Go", 42, 0, 0, 0, 0, 0, 11, 53
"/opt/projects/swiftkube/vendor/k8s.io/api/authentication/v1beta1/types.go", "Go", 124, 0, 0, 0, 0, 0, 19, 143
"/opt/projects/swiftkube/vendor/k8s.io/api/authentication/v1beta1/types_swagger_doc_generated.go", "Go", 76, 0, 0, 0, 0, 0, 19, 95
"/opt/projects/swiftkube/vendor/k8s.io/api/authentication/v1beta1/zz_generated.deepcopy.go", "Go", 174, 0, 0, 0, 0, 0, 24, 198
"/opt/projects/swiftkube/vendor/k8s.io/api/authentication/v1beta1/zz_generated.prerelease-lifecycle.go", "Go", 54, 0, 0, 0, 0, 0, 15, 69
"/opt/projects/swiftkube/vendor/k8s.io/api/authorization/v1/doc.go", "Go", 17, 0, 0, 0, 0, 0, 7, 24
"/opt/projects/swiftkube/vendor/k8s.io/api/authorization/v1/generated.pb.go", "Go", 3931, 0, 0, 0, 0, 0, 115, 4046
"/opt/projects/swiftkube/vendor/k8s.io/api/authorization/v1/generated.proto", "Protocol Buffers", 0, 0, 91, 0, 0, 134, 57, 282
"/opt/projects/swiftkube/vendor/k8s.io/api/authorization/v1/register.go", "Go", 44, 0, 0, 0, 0, 0, 12, 56
"/opt/projects/swiftkube/vendor/k8s.io/api/authorization/v1/types.go", "Go", 241, 0, 0, 0, 0, 0, 37, 278
"/opt/projects/swiftkube/vendor/k8s.io/api/authorization/v1/types_swagger_doc_generated.go", "Go", 146, 0, 0, 0, 0, 0, 33, 179
"/opt/projects/swiftkube/vendor/k8s.io/api/authorization/v1/zz_generated.deepcopy.go", "Go", 347, 0, 0, 0, 0, 0, 40, 387
"/opt/projects/swiftkube/vendor/k8s.io/api/authorization/v1beta1/doc.go", "Go", 18, 0, 0, 0, 0, 0, 7, 25
"/opt/projects/swiftkube/vendor/k8s.io/api/authorization/v1beta1/generated.pb.go", "Go", 3931, 0, 0, 0, 0, 0, 115, 4046
"/opt/projects/swiftkube/vendor/k8s.io/api/authorization/v1beta1/generated.proto", "Protocol Buffers", 0, 0, 91, 0, 0, 134, 57, 282
"/opt/projects/swiftkube/vendor/k8s.io/api/authorization/v1beta1/register.go", "Go", 44, 0, 0, 0, 0, 0, 12, 56
"/opt/projects/swiftkube/vendor/k8s.io/api/authorization/v1beta1/types.go", "Go", 253, 0, 0, 0, 0, 0, 37, 290
"/opt/projects/swiftkube/vendor/k8s.io/api/authorization/v1beta1/types_swagger_doc_generated.go", "Go", 146, 0, 0, 0, 0, 0, 33, 179
"/opt/projects/swiftkube/vendor/k8s.io/api/authorization/v1beta1/zz_generated.deepcopy.go", "Go", 347, 0, 0, 0, 0, 0, 40, 387
"/opt/projects/swiftkube/vendor/k8s.io/api/authorization/v1beta1/zz_generated.prerelease-lifecycle.go", "Go", 99, 0, 0, 0, 0, 0, 24, 123
"/opt/projects/swiftkube/vendor/k8s.io/api/autoscaling/v1/doc.go", "Go", 16, 0, 0, 0, 0, 0, 6, 22
"/opt/projects/swiftkube/vendor/k8s.io/api/autoscaling/v1/generated.pb.go", "Go", 6018, 0, 0, 0, 0, 0, 165, 6183
"/opt/projects/swiftkube/vendor/k8s.io/api/autoscaling/v1/generated.proto", "Protocol Buffers", 0, 0, 140, 0, 0, 267, 89, 496
"/opt/projects/swiftkube/vendor/k8s.io/api/autoscaling/v1/register.go", "Go", 43, 0, 0, 0, 0, 0, 11, 54
"/opt/projects/swiftkube/vendor/k8s.io/api/autoscaling/v1/types.go", "Go", 455, 0, 0, 0, 0, 0, 90, 545
"/opt/projects/swiftkube/vendor/k8s.io/api/autoscaling/v1/types_swagger_doc_generated.go", "Go", 228, 0, 0, 0, 0, 0, 49, 277
"/opt/projects/swiftkube/vendor/k8s.io/api/autoscaling/v1/zz_generated.deepcopy.go", "Go", 522, 0, 0, 0, 0, 0, 53, 575
"/opt/projects/swiftkube/vendor/k8s.io/api/autoscaling/v2/doc.go", "Go", 16, 0, 0, 0, 0, 0, 6, 22
"/opt/projects/swiftkube/vendor/k8s.io/api/autoscaling/v2/generated.pb.go", "Go", 6414, 0, 0, 0, 0, 0, 186, 6600
"/opt/projects/swiftkube/vendor/k8s.io/api/autoscaling/v2/generated.proto", "Protocol Buffers", 0, 0, 145, 0, 0, 272, 88, 505
"/opt/projects/swiftkube/vendor/k8s.io/api/autoscaling/v2/register.go", "Go", 40, 0, 0, 0, 0, 0, 11, 51
"/opt/projects/swiftkube/vendor/k8s.io/api/autoscaling/v2/types.go", "Go", 492, 0, 0, 0, 0, 0, 95, 587
"/opt/projects/swiftkube/vendor/k8s.io/api/autoscaling/v2/types_swagger_doc_generated.go", "Go", 245, 0, 0, 0, 0, 0, 55, 300
"/opt/projects/swiftkube/vendor/k8s.io/api/autoscaling/v2/zz_generated.deepcopy.go", "Go", 553, 0, 0, 0, 0, 0, 58, 611
"/opt/projects/swiftkube/vendor/k8s.io/api/autoscaling/v2beta1/doc.go", "Go", 17, 0, 0, 0, 0, 0, 6, 23
"/opt/projects/swiftkube/vendor/k8s.io/api/autoscaling/v2beta1/generated.pb.go", "Go", 5572, 0, 0, 0, 0, 0, 144, 5716
"/opt/projects/swiftkube/vendor/k8s.io/api/autoscaling/v2beta1/generated.proto", "Protocol Buffers", 0, 0, 129, 0, 0, 264, 84, 477
"/opt/projects/swiftkube/vendor/k8s.io/api/autoscaling/v2beta1/register.go", "Go", 42, 0, 0, 0, 0, 0, 11, 53
"/opt/projects/swiftkube/vendor/k8s.io/api/autoscaling/v2beta1/types.go", "Go", 443, 0, 0, 0, 0, 0, 46, 489
"/opt/projects/swiftkube/vendor/k8s.io/api/autoscaling/v2beta1/types_swagger_doc_generated.go", "Go", 205, 0, 0, 0, 0, 0, 43, 248
"/opt/projects/swiftkube/vendor/k8s.io/api/autoscaling/v2beta1/zz_generated.deepcopy.go", "Go", 480, 0, 0, 0, 0, 0, 46, 526
"/opt/projects/swiftkube/vendor/k8s.io/api/autoscaling/v2beta1/zz_generated.prerelease-lifecycle.go", "Go", 59, 0, 0, 0, 0, 0, 16, 75
"/opt/projects/swiftkube/vendor/k8s.io/api/autoscaling/v2beta2/doc.go", "Go", 17, 0, 0, 0, 0, 0, 6, 23
"/opt/projects/swiftkube/vendor/k8s.io/api/autoscaling/v2beta2/generated.pb.go", "Go", 6414, 0, 0, 0, 0, 0, 186, 6600
"/opt/projects/swiftkube/vendor/k8s.io/api/autoscaling/v2beta2/generated.proto", "Protocol Buffers", 0, 0, 145, 0, 0, 262, 88, 495
"/opt/projects/swiftkube/vendor/k8s.io/api/autoscaling/v2beta2/register.go", "Go", 40, 0, 0, 0, 0, 0, 11, 51
"/opt/projects/swiftkube/vendor/k8s.io/api/autoscaling/v2beta2/types.go", "Go", 487, 0, 0, 0, 0, 0, 93, 580
"/opt/projects/swiftkube/vendor/k8s.io/api/autoscaling/v2beta2/types_swagger_doc_generated.go", "Go", 243, 0, 0, 0, 0, 0, 55, 298
"/opt/projects/swiftkube/vendor/k8s.io/api/autoscaling/v2beta2/zz_generated.deepcopy.go", "Go", 553, 0, 0, 0, 0, 0, 58, 611
"/opt/projects/swiftkube/vendor/k8s.io/api/autoscaling/v2beta2/zz_generated.prerelease-lifecycle.go", "Go", 54, 0, 0, 0, 0, 0, 15, 69
"/opt/projects/swiftkube/vendor/k8s.io/api/batch/v1/doc.go", "Go", 16, 0, 0, 0, 0, 0, 6, 22
"/opt/projects/swiftkube/vendor/k8s.io/api/batch/v1/generated.pb.go", "Go", 4768, 0, 0, 0, 0, 0, 123, 4891
"/opt/projects/swiftkube/vendor/k8s.io/api/batch/v1/generated.proto", "Protocol Buffers", 0, 0, 114, 0, 0, 361, 76, 551
"/opt/projects/swiftkube/vendor/k8s.io/api/batch/v1/register.go", "Go", 44, 0, 0, 0, 0, 0, 11, 55
"/opt/projects/swiftkube/vendor/k8s.io/api/batch/v1/types.go", "Go", 598, 0, 0, 0, 0, 0, 95, 693
"/opt/projects/swiftkube/vendor/k8s.io/api/batch/v1/types_swagger_doc_generated.go", "Go", 179, 0, 0, 0, 0, 0, 37, 216
"/opt/projects/swiftkube/vendor/k8s.io/api/batch/v1/zz_generated.deepcopy.go", "Go", 467, 0, 0, 0, 0, 0, 42, 509
"/opt/projects/swiftkube/vendor/k8s.io/api/batch/v1beta1/doc.go", "Go", 17, 0, 0, 0, 0, 0, 6, 23
"/opt/projects/swiftkube/vendor/k8s.io/api/batch/v1beta1/generated.pb.go", "Go", 1561, 0, 0, 0, 0, 0, 52, 1613
"/opt/projects/swiftkube/vendor/k8s.io/api/batch/v1beta1/generated.proto", "Protocol Buffers", 0, 0, 48, 0, 0, 66, 29, 143
"/opt/projects/swiftkube/vendor/k8s.io/api/batch/v1beta1/register.go", "Go", 42, 0, 0, 0, 0, 0, 11, 53
"/opt/projects/swiftkube/vendor/k8s.io/api/batch/v1beta1/types.go", "Go", 137, 0, 0, 0, 0, 0, 32, 169
"/opt/projects/swiftkube/vendor/k8s.io/api/batch/v1beta1/types_swagger_doc_generated.go", "Go", 72, 0, 0, 0, 0, 0, 17, 89
"/opt/projects/swiftkube/vendor/k8s.io/api/batch/v1beta1/zz_generated.deepcopy.go", "Go", 158, 0, 0, 0, 0, 0, 20, 178
"/opt/projects/swiftkube/vendor/k8s.io/api/batch/v1beta1/zz_generated.prerelease-lifecycle.go", "Go", 59, 0, 0, 0, 0, 0, 16, 75
"/opt/projects/swiftkube/vendor/k8s.io/api/certificates/v1/doc.go", "Go", 17, 0, 0, 0, 0, 0, 7, 24
"/opt/projects/swiftkube/vendor/k8s.io/api/certificates/v1/generated.pb.go", "Go", 1996, 0, 0, 0, 0, 0, 60, 2056
"/opt/projects/swiftkube/vendor/k8s.io/api/certificates/v1/generated.proto", "Protocol Buffers", 0, 0, 53, 0, 0, 162, 34, 249
"/opt/projects/swiftkube/vendor/k8s.io/api/certificates/v1/register.go", "Go", 47, 0, 0, 0, 0, 0, 15, 62
"/opt/projects/swiftkube/vendor/k8s.io/api/certificates/v1/types.go", "Go", 280, 0, 0, 0, 0, 0, 31, 311
"/opt/projects/swiftkube/vendor/k8s.io/api/certificates/v1/types_swagger_doc_generated.go", "Go", 73, 0, 0, 0, 0, 0, 17, 90
"/opt/projects/swiftkube/vendor/k8s.io/api/certificates/v1/zz_generated.deepcopy.go", "Go", 183, 0, 0, 0, 0, 0, 22, 205
"/opt/projects/swiftkube/vendor/k8s.io/api/certificates/v1alpha1/doc.go", "Go", 18, 0, 0, 0, 0, 0, 7, 25
"/opt/projects/swiftkube/vendor/k8s.io/api/certificates/v1alpha1/generated.pb.go", "Go", 794, 0, 0, 0, 0, 0, 38, 832
"/opt/projects/swiftkube/vendor/k8s.io/api/certificates/v1alpha1/generated.proto", "Protocol Buffers", 0, 0, 30, 0, 0, 57, 17, 104
"/opt/projects/swiftkube/vendor/k8s.io/api/certificates/v1alpha1/register.go", "Go", 47, 0, 0, 0, 0, 0, 15, 62
"/opt/projects/swiftkube/vendor/k8s.io/api/certificates/v1alpha1/types.go", "Go", 91, 0, 0, 0, 0, 0, 16, 107
"/opt/projects/swiftkube/vendor/k8s.io/api/certificates/v1alpha1/types_swagger_doc_generated.go", "Go", 48, 0, 0, 0, 0, 0, 13, 61
"/opt/projects/swiftkube/vendor/k8s.io/api/certificates/v1alpha1/zz_generated.deepcopy.go", "Go", 87, 0, 0, 0, 0, 0, 16, 103
"/opt/projects/swiftkube/vendor/k8s.io/api/certificates/v1alpha1/zz_generated.prerelease-lifecycle.go", "Go", 46, 0, 0, 0, 0, 0, 13, 59
"/opt/projects/swiftkube/vendor/k8s.io/api/certificates/v1beta1/doc.go", "Go", 18, 0, 0, 0, 0, 0, 7, 25
"/opt/projects/swiftkube/vendor/k8s.io/api/certificates/v1beta1/generated.pb.go", "Go", 2002, 0, 0, 0, 0, 0, 60, 2062
"/opt/projects/swiftkube/vendor/k8s.io/api/certificates/v1beta1/generated.proto", "Protocol Buffers", 0, 0, 53, 0, 0, 115, 34, 202
"/opt/projects/swiftkube/vendor/k8s.io/api/certificates/v1beta1/register.go", "Go", 47, 0, 0, 0, 0, 0, 13, 60
"/opt/projects/swiftkube/vendor/k8s.io/api/certificates/v1beta1/types.go", "Go", 233, 0, 0, 0, 0, 0, 32, 265
"/opt/projects/swiftkube/vendor/k8s.io/api/certificates/v1beta1/types_swagger_doc_generated.go", "Go", 64, 0, 0, 0, 0, 0, 15, 79
"/opt/projects/swiftkube/vendor/k8s.io/api/certificates/v1beta1/zz_generated.deepcopy.go", "Go", 188, 0, 0, 0, 0, 0, 22, 210
"/opt/projects/swiftkube/vendor/k8s.io/api/certificates/v1beta1/zz_generated.prerelease-lifecycle.go", "Go", 59, 0, 0, 0, 0, 0, 16, 75
"/opt/projects/swiftkube/vendor/k8s.io/api/coordination/v1/doc.go", "Go", 17, 0, 0, 0, 0, 0, 7, 24
"/opt/projects/swiftkube/vendor/k8s.io/api/coordination/v1/generated.pb.go", "Go", 930, 0, 0, 0, 0, 0, 38, 968
"/opt/projects/swiftkube/vendor/k8s.io/api/coordination/v1/generated.proto", "Protocol Buffers", 0, 0, 33, 0, 0, 28, 20, 81
"/opt/projects/swiftkube/vendor/k8s.io/api/coordination/v1/register.go", "Go", 42, 0, 0, 0, 0, 0, 12, 54
"/opt/projects/swiftkube/vendor/k8s.io/api/coordination/v1/types.go", "Go", 62, 0, 0, 0, 0, 0, 13, 75
"/opt/projects/swiftkube/vendor/k8s.io/api/coordination/v1/types_swagger_doc_generated.go", "Go", 51, 0, 0, 0, 0, 0, 13, 64
"/opt/projects/swiftkube/vendor/k8s.io/api/coordination/v1/zz_generated.deepcopy.go", "Go", 110, 0, 0, 0, 0, 0, 16, 126
"/opt/projects/swiftkube/vendor/k8s.io/api/coordination/v1beta1/doc.go", "Go", 18, 0, 0, 0, 0, 0, 7, 25
"/opt/projects/swiftkube/vendor/k8s.io/api/coordination/v1beta1/generated.pb.go", "Go", 930, 0, 0, 0, 0, 0, 38, 968
"/opt/projects/swiftkube/vendor/k8s.io/api/coordination/v1beta1/generated.proto", "Protocol Buffers", 0, 0, 33, 0, 0, 28, 20, 81
"/opt/projects/swiftkube/vendor/k8s.io/api/coordination/v1beta1/register.go", "Go", 42, 0, 0, 0, 0, 0, 12, 54
"/opt/projects/swiftkube/vendor/k8s.io/api/coordination/v1beta1/types.go", "Go", 68, 0, 0, 0, 0, 0, 13, 81
"/opt/projects/swiftkube/vendor/k8s.io/api/coordination/v1beta1/types_swagger_doc_generated.go", "Go", 51, 0, 0, 0, 0, 0, 13, 64
"/opt/projects/swiftkube/vendor/k8s.io/api/coordination/v1beta1/zz_generated.deepcopy.go", "Go", 110, 0, 0, 0, 0, 0, 16, 126
"/opt/projects/swiftkube/vendor/k8s.io/api/coordination/v1beta1/zz_generated.prerelease-lifecycle.go", "Go", 59, 0, 0, 0, 0, 0, 16, 75
"/opt/projects/swiftkube/vendor/k8s.io/api/core/v1/annotation_key_constants.go", "Go", 131, 0, 0, 0, 0, 0, 32, 163
"/opt/projects/swiftkube/vendor/k8s.io/api/core/v1/doc.go", "Go", 17, 0, 0, 0, 0, 0, 6, 23
"/opt/projects/swiftkube/vendor/k8s.io/api/core/v1/generated.pb.go", "Go", 69526, 0, 0, 0, 0, 0, 1544, 71070
"/opt/projects/swiftkube/vendor/k8s.io/api/core/v1/generated.proto", "Protocol Buffers", 0, 0, 1358, 0, 0, 3918, 913, 6189
"/opt/projects/swiftkube/vendor/k8s.io/api/core/v1/lifecycle.go", "Go", 29, 0, 0, 0, 0, 0, 9, 38
"/opt/projects/swiftkube/vendor/k8s.io/api/core/v1/objectreference.go", "Go", 25, 0, 0, 0, 0, 0, 9, 34
"/opt/projects/swiftkube/vendor/k8s.io/api/core/v1/register.go", "Go", 87, 0, 0, 0, 0, 0, 13, 100
"/opt/projects/swiftkube/vendor/k8s.io/api/core/v1/resource.go", "Go", 47, 0, 0, 0, 0, 0, 13, 60
"/opt/projects/swiftkube/vendor/k8s.io/api/core/v1/taint.go", "Go", 32, 0, 0, 0, 0, 0, 8, 40
"/opt/projects/swiftkube/vendor/k8s.io/api/core/v1/toleration.go", "Go", 49, 0, 0, 0, 0, 0, 9, 58
"/opt/projects/swiftkube/vendor/k8s.io/api/core/v1/types.go", "Go", 6416, 0, 0, 0, 0, 0, 641, 7057
"/opt/projects/swiftkube/vendor/k8s.io/api/core/v1/types_swagger_doc_generated.go", "Go", 2206, 0, 0, 0, 0, 0, 441, 2647
"/opt/projects/swiftkube/vendor/k8s.io/api/core/v1/well_known_labels.go", "Go", 58, 0, 0, 0, 0, 0, 17, 75
"/opt/projects/swiftkube/vendor/k8s.io/api/core/v1/well_known_taints.go", "Go", 40, 0, 0, 0, 0, 0, 13, 53
"/opt/projects/swiftkube/vendor/k8s.io/api/core/v1/zz_generated.deepcopy.go", "Go", 5781, 0, 0, 0, 0, 0, 491, 6272
"/opt/projects/swiftkube/vendor/k8s.io/api/discovery/v1/doc.go", "Go", 17, 0, 0, 0, 0, 0, 6, 23
"/opt/projects/swiftkube/vendor/k8s.io/api/discovery/v1/generated.pb.go", "Go", 2186, 0, 0, 0, 0, 0, 66, 2252
"/opt/projects/swiftkube/vendor/k8s.io/api/discovery/v1/generated.proto", "Protocol Buffers", 0, 0, 56, 0, 0, 116, 34, 206
"/opt/projects/swiftkube/vendor/k8s.io/api/discovery/v1/register.go", "Go", 45, 0, 0, 0, 0, 0, 12, 57
"/opt/projects/swiftkube/vendor/k8s.io/api/discovery/v1/types.go", "Go", 184, 0, 0, 0, 0, 0, 37, 221
"/opt/projects/swiftkube/vendor/k8s.io/api/discovery/v1/types_swagger_doc_generated.go", "Go", 89, 0, 0, 0, 0, 0, 21, 110
"/opt/projects/swiftkube/vendor/k8s.io/api/discovery/v1/well_known_labels.go", "Go", 27, 0, 0, 0, 0, 0, 6, 33
"/opt/projects/swiftkube/vendor/k8s.io/api/discovery/v1/zz_generated.deepcopy.go", "Go", 235, 0, 0, 0, 0, 0, 24, 259
"/opt/projects/swiftkube/vendor/k8s.io/api/discovery/v1beta1/doc.go", "Go", 18, 0, 0, 0, 0, 0, 6, 24
"/opt/projects/swiftkube/vendor/k8s.io/api/discovery/v1beta1/generated.pb.go", "Go", 2140, 0, 0, 0, 0, 0, 66, 2206
"/opt/projects/swiftkube/vendor/k8s.io/api/discovery/v1beta1/generated.proto", "Protocol Buffers", 0, 0, 55, 0, 0, 110, 33, 198
"/opt/projects/swiftkube/vendor/k8s.io/api/discovery/v1beta1/register.go", "Go", 45, 0, 0, 0, 0, 0, 12, 57
"/opt/projects/swiftkube/vendor/k8s.io/api/discovery/v1beta1/types.go", "Go", 184, 0, 0, 0, 0, 0, 36, 220
"/opt/projects/swiftkube/vendor/k8s.io/api/discovery/v1beta1/types_swagger_doc_generated.go", "Go", 88, 0, 0, 0, 0, 0, 21, 109
"/opt/projects/swiftkube/vendor/k8s.io/api/discovery/v1beta1/well_known_labels.go", "Go", 27, 0, 0, 0, 0, 0, 6, 33
"/opt/projects/swiftkube/vendor/k8s.io/api/discovery/v1beta1/zz_generated.deepcopy.go", "Go", 230, 0, 0, 0, 0, 0, 24, 254
"/opt/projects/swiftkube/vendor/k8s.io/api/discovery/v1beta1/zz_generated.prerelease-lifecycle.go", "Go", 59, 0, 0, 0, 0, 0, 16, 75
"/opt/projects/swiftkube/vendor/k8s.io/api/events/v1/doc.go", "Go", 17, 0, 0, 0, 0, 0, 7, 24
"/opt/projects/swiftkube/vendor/k8s.io/api/events/v1/generated.pb.go", "Go", 1360, 0, 0, 0, 0, 0, 38, 1398
"/opt/projects/swiftkube/vendor/k8s.io/api/events/v1/generated.proto", "Protocol Buffers", 0, 0, 44, 0, 0, 55, 30, 129
"/opt/projects/swiftkube/vendor/k8s.io/api/events/v1/register.go", "Go", 42, 0, 0, 0, 0, 0, 12, 54
"/opt/projects/swiftkube/vendor/k8s.io/api/events/v1/types.go", "Go", 100, 0, 0, 0, 0, 0, 24, 124
"/opt/projects/swiftkube/vendor/k8s.io/api/events/v1/types_swagger_doc_generated.go", "Go", 61, 0, 0, 0, 0, 0, 13, 74
"/opt/projects/swiftkube/vendor/k8s.io/api/events/v1/zz_generated.deepcopy.go", "Go", 103, 0, 0, 0, 0, 0, 16, 119
"/opt/projects/swiftkube/vendor/k8s.io/api/events/v1beta1/doc.go", "Go", 18, 0, 0, 0, 0, 0, 7, 25
"/opt/projects/swiftkube/vendor/k8s.io/api/events/v1beta1/generated.pb.go", "Go", 1360, 0, 0, 0, 0, 0, 38, 1398
"/opt/projects/swiftkube/vendor/k8s.io/api/events/v1beta1/generated.proto", "Protocol Buffers", 0, 0, 44, 0, 0, 57, 30, 131
"/opt/projects/swiftkube/vendor/k8s.io/api/events/v1beta1/register.go", "Go", 42, 0, 0, 0, 0, 0, 12, 54
"/opt/projects/swiftkube/vendor/k8s.io/api/events/v1beta1/types.go", "Go", 107, 0, 0, 0, 0, 0, 25, 132
"/opt/projects/swiftkube/vendor/k8s.io/api/events/v1beta1/types_swagger_doc_generated.go", "Go", 61, 0, 0, 0, 0, 0, 13, 74
"/opt/projects/swiftkube/vendor/k8s.io/api/events/v1beta1/zz_generated.deepcopy.go", "Go", 103, 0, 0, 0, 0, 0, 16, 119
"/opt/projects/swiftkube/vendor/k8s.io/api/events/v1beta1/zz_generated.prerelease-lifecycle.go", "Go", 46, 0, 0, 0, 0, 0, 13, 59
"/opt/projects/swiftkube/vendor/k8s.io/api/extensions/v1beta1/doc.go", "Go", 17, 0, 0, 0, 0, 0, 6, 23
"/opt/projects/swiftkube/vendor/k8s.io/api/extensions/v1beta1/generated.pb.go", "Go", 11697, 0, 0, 0, 0, 0, 333, 12030
"/opt/projects/swiftkube/vendor/k8s.io/api/extensions/v1beta1/generated.proto", "Protocol Buffers", 0, 0, 252, 0, 0, 627, 153, 1032
"/opt/projects/swiftkube/vendor/k8s.io/api/extensions/v1beta1/register.go", "Go", 53, 0, 0, 0, 0, 0, 11, 64
"/opt/projects/swiftkube/vendor/k8s.io/api/extensions/v1beta1/types.go", "Go", 1062, 0, 0, 0, 0, 0, 166, 1228
"/opt/projects/swiftkube/vendor/k8s.io/api/extensions/v1beta1/types_swagger_doc_generated.go", "Go", 435, 0, 0, 0, 0, 0, 97, 532
"/opt/projects/swiftkube/vendor/k8s.io/api/extensions/v1beta1/zz_generated.deepcopy.go", "Go", 1092, 0, 0, 0, 0, 0, 110, 1202
"/opt/projects/swiftkube/vendor/k8s.io/api/extensions/v1beta1/zz_generated.prerelease-lifecycle.go", "Go", 249, 0, 0, 0, 0, 0, 54, 303
"/opt/projects/swiftkube/vendor/k8s.io/api/flowcontrol/v1alpha1/doc.go", "Go", 19, 0, 0, 0, 0, 0, 7, 26
"/opt/projects/swiftkube/vendor/k8s.io/api/flowcontrol/v1alpha1/generated.pb.go", "Go", 5487, 0, 0, 0, 0, 0, 178, 5665
"/opt/projects/swiftkube/vendor/k8s.io/api/flowcontrol/v1alpha1/generated.proto", "Protocol Buffers", 0, 0, 124, 0, 0, 317, 71, 512
"/opt/projects/swiftkube/vendor/k8s.io/api/flowcontrol/v1alpha1/register.go", "Go", 47, 0, 0, 0, 0, 0, 12, 59
"/opt/projects/swiftkube/vendor/k8s.io/api/flowcontrol/v1alpha1/types.go", "Go", 554, 0, 0, 0, 0, 0, 68, 622
"/opt/projects/swiftkube/vendor/k8s.io/api/flowcontrol/v1alpha1/types_swagger_doc_generated.go", "Go", 222, 0, 0, 0, 0, 0, 53, 275
"/opt/projects/swiftkube/vendor/k8s.io/api/flowcontrol/v1alpha1/zz_generated.deepcopy.go", "Go", 526, 0, 0, 0, 0, 0, 58, 584
"/opt/projects/swiftkube/vendor/k8s.io/api/flowcontrol/v1alpha1/zz_generated.prerelease-lifecycle.go", "Go", 99, 0, 0, 0, 0, 0, 24, 123
"/opt/projects/swiftkube/vendor/k8s.io/api/flowcontrol/v1beta1/doc.go", "Go", 19, 0, 0, 0, 0, 0, 7, 26
"/opt/projects/swiftkube/vendor/k8s.io/api/flowcontrol/v1beta1/generated.pb.go", "Go", 5486, 0, 0, 0, 0, 0, 178, 5664
"/opt/projects/swiftkube/vendor/k8s.io/api/flowcontrol/v1beta1/generated.proto", "Protocol Buffers", 0, 0, 124, 0, 0, 317, 71, 512
"/opt/projects/swiftkube/vendor/k8s.io/api/flowcontrol/v1beta1/register.go", "Go", 47, 0, 0, 0, 0, 0, 12, 59
"/opt/projects/swiftkube/vendor/k8s.io/api/flowcontrol/v1beta1/types.go", "Go", 591, 0, 0, 0, 0, 0, 69, 660
"/opt/projects/swiftkube/vendor/k8s.io/api/flowcontrol/v1beta1/types_swagger_doc_generated.go", "Go", 222, 0, 0, 0, 0, 0, 53, 275
"/opt/projects/swiftkube/vendor/k8s.io/api/flowcontrol/v1beta1/zz_generated.deepcopy.go", "Go", 526, 0, 0, 0, 0, 0, 58, 584
"/opt/projects/swiftkube/vendor/k8s.io/api/flowcontrol/v1beta1/zz_generated.prerelease-lifecycle.go", "Go", 99, 0, 0, 0, 0, 0, 24, 123
"/opt/projects/swiftkube/vendor/k8s.io/api/flowcontrol/v1beta2/doc.go", "Go", 19, 0, 0, 0, 0, 0, 7, 26
"/opt/projects/swiftkube/vendor/k8s.io/api/flowcontrol/v1beta2/generated.pb.go", "Go", 5487, 0, 0, 0, 0, 0, 178, 5665
"/opt/projects/swiftkube/vendor/k8s.io/api/flowcontrol/v1beta2/generated.proto", "Protocol Buffers", 0, 0, 124, 0, 0, 317, 71, 512
"/opt/projects/swiftkube/vendor/k8s.io/api/flowcontrol/v1beta2/register.go", "Go", 47, 0, 0, 0, 0, 0, 12, 59
"/opt/projects/swiftkube/vendor/k8s.io/api/flowcontrol/v1beta2/types.go", "Go", 591, 0, 0, 0, 0, 0, 69, 660
"/opt/projects/swiftkube/vendor/k8s.io/api/flowcontrol/v1beta2/types_swagger_doc_generated.go", "Go", 222, 0, 0, 0, 0, 0, 53, 275
"/opt/projects/swiftkube/vendor/k8s.io/api/flowcontrol/v1beta2/zz_generated.deepcopy.go", "Go", 526, 0, 0, 0, 0, 0, 58, 584
"/opt/projects/swiftkube/vendor/k8s.io/api/flowcontrol/v1beta2/zz_generated.prerelease-lifecycle.go", "Go", 99, 0, 0, 0, 0, 0, 24, 123
"/opt/projects/swiftkube/vendor/k8s.io/api/flowcontrol/v1beta3/doc.go", "Go", 19, 0, 0, 0, 0, 0, 7, 26
"/opt/projects/swiftkube/vendor/k8s.io/api/flowcontrol/v1beta3/generated.pb.go", "Go", 5486, 0, 0, 0, 0, 0, 178, 5664
"/opt/projects/swiftkube/vendor/k8s.io/api/flowcontrol/v1beta3/generated.proto", "Protocol Buffers", 0, 0, 124, 0, 0, 321, 71, 516
"/opt/projects/swiftkube/vendor/k8s.io/api/flowcontrol/v1beta3/register.go", "Go", 47, 0, 0, 0, 0, 0, 12, 59
"/opt/projects/swiftkube/vendor/k8s.io/api/flowcontrol/v1beta3/types.go", "Go", 591, 0, 0, 0, 0, 0, 69, 660
"/opt/projects/swiftkube/vendor/k8s.io/api/flowcontrol/v1beta3/types_swagger_doc_generated.go", "Go", 222, 0, 0, 0, 0, 0, 53, 275
"/opt/projects/swiftkube/vendor/k8s.io/api/flowcontrol/v1beta3/zz_generated.deepcopy.go", "Go", 526, 0, 0, 0, 0, 0, 58, 584
"/opt/projects/swiftkube/vendor/k8s.io/api/flowcontrol/v1beta3/zz_generated.prerelease-lifecycle.go", "Go", 76, 0, 0, 0, 0, 0, 19, 95
"/opt/projects/swiftkube/vendor/k8s.io/api/imagepolicy/v1alpha1/doc.go", "Go", 17, 0, 0, 0, 0, 0, 7, 24
"/opt/projects/swiftkube/vendor/k8s.io/api/imagepolicy/v1alpha1/generated.pb.go", "Go", 1331, 0, 0, 0, 0, 0, 45, 1376
"/opt/projects/swiftkube/vendor/k8s.io/api/imagepolicy/v1alpha1/generated.proto", "Protocol Buffers", 0, 0, 36, 0, 0, 32, 21, 89
"/opt/projects/swiftkube/vendor/k8s.io/api/imagepolicy/v1alpha1/register.go", "Go", 41, 0, 0, 0, 0, 0, 11, 52
"/opt/projects/swiftkube/vendor/k8s.io/api/imagepolicy/v1alpha1/types.go", "Go", 70, 0, 0, 0, 0, 0, 13, 83
"/opt/projects/swiftkube/vendor/k8s.io/api/imagepolicy/v1alpha1/types_swagger_doc_generated.go", "Go", 58, 0, 0, 0, 0, 0, 15, 73
"/opt/projects/swiftkube/vendor/k8s.io/api/imagepolicy/v1alpha1/zz_generated.deepcopy.go", "Go", 105, 0, 0, 0, 0, 0, 17, 122
"/opt/projects/swiftkube/vendor/k8s.io/api/networking/v1/doc.go", "Go", 17, 0, 0, 0, 0, 0, 6, 23
"/opt/projects/swiftkube/vendor/k8s.io/api/networking/v1/generated.pb.go", "Go", 6332, 0, 0, 0, 0, 0, 207, 6539
"/opt/projects/swiftkube/vendor/k8s.io/api/networking/v1/generated.proto", "Protocol Buffers", 0, 0, 137, 0, 0, 336, 74, 547
"/opt/projects/swiftkube/vendor/k8s.io/api/networking/v1/register.go", "Go", 46, 0, 0, 0, 0, 0, 12, 58
"/opt/projects/swiftkube/vendor/k8s.io/api/networking/v1/types.go", "Go", 534, 0, 0, 0, 0, 0, 88, 622
"/opt/projects/swiftkube/vendor/k8s.io/api/networking/v1/types_swagger_doc_generated.go", "Go", 247, 0, 0, 0, 0, 0, 61, 308
"/opt/projects/swiftkube/vendor/k8s.io/api/networking/v1/well_known_annotations.go", "Go", 20, 0, 0, 0, 0, 0, 6, 26
"/opt/projects/swiftkube/vendor/k8s.io/api/networking/v1/zz_generated.deepcopy.go", "Go", 661, 0, 0, 0, 0, 0, 68, 729
"/opt/projects/swiftkube/vendor/k8s.io/api/networking/v1alpha1/doc.go", "Go", 18, 0, 0, 0, 0, 0, 6, 24
"/opt/projects/swiftkube/vendor/k8s.io/api/networking/v1alpha1/generated.pb.go", "Go", 1792, 0, 0, 0, 0, 0, 67, 1859
"/opt/projects/swiftkube/vendor/k8s.io/api/networking/v1alpha1/generated.proto", "Protocol Buffers", 0, 0, 51, 0, 0, 76, 29, 156
"/opt/projects/swiftkube/vendor/k8s.io/api/networking/v1alpha1/register.go", "Go", 50, 0, 0, 0, 0, 0, 13, 63
"/opt/projects/swiftkube/vendor/k8s.io/api/networking/v1alpha1/types.go", "Go", 140, 0, 0, 0, 0, 0, 24, 164
"/opt/projects/swiftkube/vendor/k8s.io/api/networking/v1alpha1/types_swagger_doc_generated.go", "Go", 84, 0, 0, 0, 0, 0, 21, 105
"/opt/projects/swiftkube/vendor/k8s.io/api/networking/v1alpha1/well_known_labels.go", "Go", 27, 0, 0, 0, 0, 0, 7, 34
"/opt/projects/swiftkube/vendor/k8s.io/api/networking/v1alpha1/zz_generated.deepcopy.go", "Go", 180, 0, 0, 0, 0, 0, 26, 206
"/opt/projects/swiftkube/vendor/k8s.io/api/networking/v1alpha1/zz_generated.prerelease-lifecycle.go", "Go", 76, 0, 0, 0, 0, 0, 19, 95
"/opt/projects/swiftkube/vendor/k8s.io/api/networking/v1beta1/doc.go", "Go", 18, 0, 0, 0, 0, 0, 6, 24
"/opt/projects/swiftkube/vendor/k8s.io/api/networking/v1beta1/generated.pb.go", "Go", 4030, 0, 0, 0, 0, 0, 136, 4166
"/opt/projects/swiftkube/vendor/k8s.io/api/networking/v1beta1/generated.proto", "Protocol Buffers", 0, 0, 94, 0, 0, 204, 51, 349
"/opt/projects/swiftkube/vendor/k8s.io/api/networking/v1beta1/register.go", "Go", 47, 0, 0, 0, 0, 0, 12, 59
"/opt/projects/swiftkube/vendor/k8s.io/api/networking/v1beta1/types.go", "Go", 360, 0, 0, 0, 0, 0, 59, 419
"/opt/projects/swiftkube/vendor/k8s.io/api/networking/v1beta1/types_swagger_doc_generated.go", "Go", 164, 0, 0, 0, 0, 0, 41, 205
"/opt/projects/swiftkube/vendor/k8s.io/api/networking/v1beta1/well_known_annotations.go", "Go", 26, 0, 0, 0, 0, 0, 7, 33
"/opt/projects/swiftkube/vendor/k8s.io/api/networking/v1beta1/zz_generated.deepcopy.go", "Go", 405, 0, 0, 0, 0, 0, 46, 451
"/opt/projects/swiftkube/vendor/k8s.io/api/networking/v1beta1/zz_generated.prerelease-lifecycle.go", "Go", 99, 0, 0, 0, 0, 0, 24, 123
"/opt/projects/swiftkube/vendor/k8s.io/api/node/v1/doc.go", "Go", 17, 0, 0, 0, 0, 0, 7, 24
"/opt/projects/swiftkube/vendor/k8s.io/api/node/v1/generated.pb.go", "Go", 1356, 0, 0, 0, 0, 0, 45, 1401
"/opt/projects/swiftkube/vendor/k8s.io/api/node/v1/generated.proto", "Protocol Buffers", 0, 0, 37, 0, 0, 52, 20, 109
"/opt/projects/swiftkube/vendor/k8s.io/api/node/v1/register.go", "Go", 41, 0, 0, 0, 0, 0, 12, 53
"/opt/projects/swiftkube/vendor/k8s.io/api/node/v1/types.go", "Go", 90, 0, 0, 0, 0, 0, 19, 109
"/opt/projects/swiftkube/vendor/k8s.io/api/node/v1/types_swagger_doc_generated.go", "Go", 57, 0, 0, 0, 0, 0, 15, 72
"/opt/projects/swiftkube/vendor/k8s.io/api/node/v1/zz_generated.deepcopy.go", "Go", 132, 0, 0, 0, 0, 0, 18, 150
"/opt/projects/swiftkube/vendor/k8s.io/api/node/v1alpha1/doc.go", "Go", 17, 0, 0, 0, 0, 0, 7, 24
"/opt/projects/swiftkube/vendor/k8s.io/api/node/v1alpha1/generated.pb.go", "Go", 1517, 0, 0, 0, 0, 0, 52, 1569
"/opt/projects/swiftkube/vendor/k8s.io/api/node/v1alpha1/generated.proto", "Protocol Buffers", 0, 0, 40, 0, 0, 58, 21, 119
"/opt/projects/swiftkube/vendor/k8s.io/api/node/v1alpha1/register.go", "Go", 41, 0, 0, 0, 0, 0, 12, 53
"/opt/projects/swiftkube/vendor/k8s.io/api/node/v1alpha1/types.go", "Go", 99, 0, 0, 0, 0, 0, 20, 119
"/opt/projects/swiftkube/vendor/k8s.io/api/node/v1alpha1/types_swagger_doc_generated.go", "Go", 64, 0, 0, 0, 0, 0, 17, 81
"/opt/projects/swiftkube/vendor/k8s.io/api/node/v1alpha1/zz_generated.deepcopy.go", "Go", 147, 0, 0, 0, 0, 0, 20, 167
"/opt/projects/swiftkube/vendor/k8s.io/api/node/v1beta1/doc.go", "Go", 18, 0, 0, 0, 0, 0, 7, 25
"/opt/projects/swiftkube/vendor/k8s.io/api/node/v1beta1/generated.pb.go", "Go", 1356, 0, 0, 0, 0, 0, 45, 1401
"/opt/projects/swiftkube/vendor/k8s.io/api/node/v1beta1/generated.proto", "Protocol Buffers", 0, 0, 37, 0, 0, 52, 20, 109
"/opt/projects/swiftkube/vendor/k8s.io/api/node/v1beta1/register.go", "Go", 41, 0, 0, 0, 0, 0, 12, 53
"/opt/projects/swiftkube/vendor/k8s.io/api/node/v1beta1/types.go", "Go", 94, 0, 0, 0, 0, 0, 19, 113
"/opt/projects/swiftkube/vendor/k8s.io/api/node/v1beta1/types_swagger_doc_generated.go", "Go", 57, 0, 0, 0, 0, 0, 15, 72
"/opt/projects/swiftkube/vendor/k8s.io/api/node/v1beta1/zz_generated.deepcopy.go", "Go", 132, 0, 0, 0, 0, 0, 18, 150
"/opt/projects/swiftkube/vendor/k8s.io/api/node/v1beta1/zz_generated.prerelease-lifecycle.go", "Go", 46, 0, 0, 0, 0, 0, 13, 59
"/opt/projects/swiftkube/vendor/k8s.io/api/policy/v1/doc.go", "Go", 19, 0, 0, 0, 0, 0, 6, 25
"/opt/projects/swiftkube/vendor/k8s.io/api/policy/v1/generated.pb.go", "Go", 1677, 0, 0, 0, 0, 0, 53, 1730
"/opt/projects/swiftkube/vendor/k8s.io/api/policy/v1/generated.proto", "Protocol Buffers", 0, 0, 47, 0, 0, 104, 29, 180
"/opt/projects/swiftkube/vendor/k8s.io/api/policy/v1/register.go", "Go", 42, 0, 0, 0, 0, 0, 11, 53
"/opt/projects/swiftkube/vendor/k8s.io/api/policy/v1/types.go", "Go", 189, 0, 0, 0, 0, 0, 32, 221
"/opt/projects/swiftkube/vendor/k8s.io/api/policy/v1/types_swagger_doc_generated.go", "Go", 72, 0, 0, 0, 0, 0, 17, 89
"/opt/projects/swiftkube/vendor/k8s.io/api/policy/v1/zz_generated.deepcopy.go", "Go", 166, 0, 0, 0, 0, 0, 21, 187
"/opt/projects/swiftkube/vendor/k8s.io/api/policy/v1beta1/doc.go", "Go", 20, 0, 0, 0, 0, 0, 6, 26
"/opt/projects/swiftkube/vendor/k8s.io/api/policy/v1beta1/generated.pb.go", "Go", 5463, 0, 0, 0, 0, 0, 151, 5614
"/opt/projects/swiftkube/vendor/k8s.io/api/policy/v1beta1/generated.proto", "Protocol Buffers", 0, 0, 124, 0, 0, 256, 77, 457
"/opt/projects/swiftkube/vendor/k8s.io/api/policy/v1beta1/register.go", "Go", 46, 0, 0, 0, 0, 0, 11, 57
"/opt/projects/swiftkube/vendor/k8s.io/api/policy/v1beta1/types.go", "Go", 535, 0, 0, 0, 0, 0, 66, 601
"/opt/projects/swiftkube/vendor/k8s.io/api/policy/v1beta1/types_swagger_doc_generated.go", "Go", 204, 0, 0, 0, 0, 0, 45, 249
"/opt/projects/swiftkube/vendor/k8s.io/api/policy/v1beta1/zz_generated.deepcopy.go", "Go", 503, 0, 0, 0, 0, 0, 51, 554
"/opt/projects/swiftkube/vendor/k8s.io/api/policy/v1beta1/zz_generated.prerelease-lifecycle.go", "Go", 104, 0, 0, 0, 0, 0, 25, 129
"/opt/projects/swiftkube/vendor/k8s.io/api/rbac/v1/doc.go", "Go", 17, 0, 0, 0, 0, 0, 7, 24
"/opt/projects/swiftkube/vendor/k8s.io/api/rbac/v1/generated.pb.go", "Go", 3130, 0, 0, 0, 0, 0, 101, 3231
"/opt/projects/swiftkube/vendor/k8s.io/api/rbac/v1/generated.proto", "Protocol Buffers", 0, 0, 74, 0, 0, 87, 43, 204
"/opt/projects/swiftkube/vendor/k8s.io/api/rbac/v1/register.go", "Go", 47, 0, 0, 0, 0, 0, 12, 59
"/opt/projects/swiftkube/vendor/k8s.io/api/rbac/v1/types.go", "Go", 198, 0, 0, 0, 0, 0, 44, 242
"/opt/projects/swiftkube/vendor/k8s.io/api/rbac/v1/types_swagger_doc_generated.go", "Go", 128, 0, 0, 0, 0, 0, 31, 159
"/opt/projects/swiftkube/vendor/k8s.io/api/rbac/v1/zz_generated.deepcopy.go", "Go", 351, 0, 0, 0, 0, 0, 40, 391
"/opt/projects/swiftkube/vendor/k8s.io/api/rbac/v1alpha1/doc.go", "Go", 17, 0, 0, 0, 0, 0, 7, 24
"/opt/projects/swiftkube/vendor/k8s.io/api/rbac/v1alpha1/generated.pb.go", "Go", 3132, 0, 0, 0, 0, 0, 101, 3233
"/opt/projects/swiftkube/vendor/k8s.io/api/rbac/v1alpha1/generated.proto", "Protocol Buffers", 0, 0, 74, 0, 0, 92, 43, 209
"/opt/projects/swiftkube/vendor/k8s.io/api/rbac/v1alpha1/register.go", "Go", 47, 0, 0, 0, 0, 0, 12, 59
"/opt/projects/swiftkube/vendor/k8s.io/api/rbac/v1alpha1/types.go", "Go", 203, 0, 0, 0, 0, 0, 44, 247
"/opt/projects/swiftkube/vendor/k8s.io/api/rbac/v1alpha1/types_swagger_doc_generated.go", "Go", 128, 0, 0, 0, 0, 0, 31, 159
"/opt/projects/swiftkube/vendor/k8s.io/api/rbac/v1alpha1/zz_generated.deepcopy.go", "Go", 351, 0, 0, 0, 0, 0, 40, 391
"/opt/projects/swiftkube/vendor/k8s.io/api/rbac/v1beta1/doc.go", "Go", 18, 0, 0, 0, 0, 0, 7, 25
"/opt/projects/swiftkube/vendor/k8s.io/api/rbac/v1beta1/generated.pb.go", "Go", 3130, 0, 0, 0, 0, 0, 101, 3231
"/opt/projects/swiftkube/vendor/k8s.io/api/rbac/v1beta1/generated.proto", "Protocol Buffers", 0, 0, 74, 0, 0, 92, 43, 209
"/opt/projects/swiftkube/vendor/k8s.io/api/rbac/v1beta1/register.go", "Go", 47, 0, 0, 0, 0, 0, 12, 59
"/opt/projects/swiftkube/vendor/k8s.io/api/rbac/v1beta1/types.go", "Go", 235, 0, 0, 0, 0, 0, 43, 278
"/opt/projects/swiftkube/vendor/k8s.io/api/rbac/v1beta1/types_swagger_doc_generated.go", "Go", 128, 0, 0, 0, 0, 0, 31, 159
"/opt/projects/swiftkube/vendor/k8s.io/api/rbac/v1beta1/zz_generated.deepcopy.go", "Go", 351, 0, 0, 0, 0, 0, 40, 391
"/opt/projects/swiftkube/vendor/k8s.io/api/rbac/v1beta1/zz_generated.prerelease-lifecycle.go", "Go", 179, 0, 0, 0, 0, 0, 40, 219
"/opt/projects/swiftkube/vendor/k8s.io/api/resource/v1alpha2/doc.go", "Go", 18, 0, 0, 0, 0, 0, 7, 25
"/opt/projects/swiftkube/vendor/k8s.io/api/resource/v1alpha2/generated.pb.go", "Go", 4667, 0, 0, 0, 0, 0, 151, 4818
"/opt/projects/swiftkube/vendor/k8s.io/api/resource/v1alpha2/generated.proto", "Protocol Buffers", 0, 0, 107, 0, 0, 233, 61, 401
"/opt/projects/swiftkube/vendor/k8s.io/api/resource/v1alpha2/register.go", "Go", 51, 0, 0, 0, 0, 0, 13, 64
"/opt/projects/swiftkube/vendor/k8s.io/api/resource/v1alpha2/types.go", "Go", 399, 0, 0, 0, 0, 0, 64, 463
"/opt/projects/swiftkube/vendor/k8s.io/api/resource/v1alpha2/types_swagger_doc_generated.go", "Go", 188, 0, 0, 0, 0, 0, 45, 233
"/opt/projects/swiftkube/vendor/k8s.io/api/resource/v1alpha2/zz_generated.deepcopy.go", "Go", 445, 0, 0, 0, 0, 0, 54, 499
"/opt/projects/swiftkube/vendor/k8s.io/api/scheduling/v1/doc.go", "Go", 17, 0, 0, 0, 0, 0, 7, 24
"/opt/projects/swiftkube/vendor/k8s.io/api/scheduling/v1/generated.pb.go", "Go", 698, 0, 0, 0, 0, 0, 32, 730
"/opt/projects/swiftkube/vendor/k8s.io/api/scheduling/v1/generated.proto", "Protocol Buffers", 0, 0, 30, 0, 0, 27, 18, 75
"/opt/projects/swiftkube/vendor/k8s.io/api/scheduling/v1/register.go", "Go", 44, 0, 0, 0, 0, 0, 12, 56
"/opt/projects/swiftkube/vendor/k8s.io/api/scheduling/v1/types.go", "Go", 59, 0, 0, 0, 0, 0, 15, 74
"/opt/projects/swiftkube/vendor/k8s.io/api/scheduling/v1/types_swagger_doc_generated.go", "Go", 43, 0, 0, 0, 0, 0, 11, 54
"/opt/projects/swiftkube/vendor/k8s.io/api/scheduling/v1/zz_generated.deepcopy.go", "Go", 78, 0, 0, 0, 0, 0, 14, 92
"/opt/projects/swiftkube/vendor/k8s.io/api/scheduling/v1alpha1/doc.go", "Go", 17, 0, 0, 0, 0, 0, 7, 24
"/opt/projects/swiftkube/vendor/k8s.io/api/scheduling/v1alpha1/generated.pb.go", "Go", 698, 0, 0, 0, 0, 0, 32, 730
"/opt/projects/swiftkube/vendor/k8s.io/api/scheduling/v1alpha1/generated.proto", "Protocol Buffers", 0, 0, 30, 0, 0, 28, 18, 76
"/opt/projects/swiftkube/vendor/k8s.io/api/scheduling/v1alpha1/register.go", "Go", 42, 0, 0, 0, 0, 0, 11, 53
"/opt/projects/swiftkube/vendor/k8s.io/api/scheduling/v1alpha1/types.go", "Go", 60, 0, 0, 0, 0, 0, 15, 75
"/opt/projects/swiftkube/vendor/k8s.io/api/scheduling/v1alpha1/types_swagger_doc_generated.go", "Go", 43, 0, 0, 0, 0, 0, 11, 54
"/opt/projects/swiftkube/vendor/k8s.io/api/scheduling/v1alpha1/zz_generated.deepcopy.go", "Go", 78, 0, 0, 0, 0, 0, 14, 92
"/opt/projects/swiftkube/vendor/k8s.io/api/scheduling/v1beta1/doc.go", "Go", 18, 0, 0, 0, 0, 0, 7, 25
"/opt/projects/swiftkube/vendor/k8s.io/api/scheduling/v1beta1/generated.pb.go", "Go", 699, 0, 0, 0, 0, 0, 32, 731
"/opt/projects/swiftkube/vendor/k8s.io/api/scheduling/v1beta1/generated.proto", "Protocol Buffers", 0, 0, 30, 0, 0, 28, 18, 76
"/opt/projects/swiftkube/vendor/k8s.io/api/scheduling/v1beta1/register.go", "Go", 42, 0, 0, 0, 0, 0, 11, 53
"/opt/projects/swiftkube/vendor/k8s.io/api/scheduling/v1beta1/types.go", "Go", 68, 0, 0, 0, 0, 0, 15, 83
"/opt/projects/swiftkube/vendor/k8s.io/api/scheduling/v1beta1/types_swagger_doc_generated.go", "Go", 43, 0, 0, 0, 0, 0, 11, 54
"/opt/projects/swiftkube/vendor/k8s.io/api/scheduling/v1beta1/zz_generated.deepcopy.go", "Go", 78, 0, 0, 0, 0, 0, 14, 92
"/opt/projects/swiftkube/vendor/k8s.io/api/scheduling/v1beta1/zz_generated.prerelease-lifecycle.go", "Go", 59, 0, 0, 0, 0, 0, 16, 75
"/opt/projects/swiftkube/vendor/k8s.io/api/storage/v1/doc.go", "Go", 17, 0, 0, 0, 0, 0, 6, 23
"/opt/projects/swiftkube/vendor/k8s.io/api/storage/v1/generated.pb.go", "Go", 5277, 0, 0, 0, 0, 0, 150, 5427
"/opt/projects/swiftkube/vendor/k8s.io/api/storage/v1/generated.proto", "Protocol Buffers", 0, 0, 115, 0, 0, 391, 68, 574
"/opt/projects/swiftkube/vendor/k8s.io/api/storage/v1/register.go", "Go", 50, 0, 0, 0, 0, 0, 16, 66
"/opt/projects/swiftkube/vendor/k8s.io/api/storage/v1/types.go", "Go", 594, 0, 0, 0, 0, 0, 93, 687
"/opt/projects/swiftkube/vendor/k8s.io/api/storage/v1/types_swagger_doc_generated.go", "Go", 194, 0, 0, 0, 0, 0, 45, 239
"/opt/projects/swiftkube/vendor/k8s.io/api/storage/v1/zz_generated.deepcopy.go", "Go", 563, 0, 0, 0, 0, 0, 56, 619
"/opt/projects/swiftkube/vendor/k8s.io/api/storage/v1alpha1/doc.go", "Go", 18, 0, 0, 0, 0, 0, 6, 24
"/opt/projects/swiftkube/vendor/k8s.io/api/storage/v1alpha1/generated.pb.go", "Go", 2327, 0, 0, 0, 0, 0, 73, 2400
"/opt/projects/swiftkube/vendor/k8s.io/api/storage/v1alpha1/generated.proto", "Protocol Buffers", 0, 0, 59, 0, 0, 139, 34, 232
"/opt/projects/swiftkube/vendor/k8s.io/api/storage/v1alpha1/register.go", "Go", 41, 0, 0, 0, 0, 0, 12, 53
"/opt/projects/swiftkube/vendor/k8s.io/api/storage/v1alpha1/types.go", "Go", 217, 0, 0, 0, 0, 0, 37, 254
"/opt/projects/swiftkube/vendor/k8s.io/api/storage/v1alpha1/types_swagger_doc_generated.go", "Go", 94, 0, 0, 0, 0, 0, 23, 117
"/opt/projects/swiftkube/vendor/k8s.io/api/storage/v1alpha1/zz_generated.deepcopy.go", "Go", 229, 0, 0, 0, 0, 0, 28, 257
"/opt/projects/swiftkube/vendor/k8s.io/api/storage/v1alpha1/zz_generated.prerelease-lifecycle.go", "Go", 99, 0, 0, 0, 0, 0, 24, 123
"/opt/projects/swiftkube/vendor/k8s.io/api/storage/v1beta1/doc.go", "Go", 18, 0, 0, 0, 0, 0, 6, 24
"/opt/projects/swiftkube/vendor/k8s.io/api/storage/v1beta1/generated.pb.go", "Go", 5277, 0, 0, 0, 0, 0, 150, 5427
"/opt/projects/swiftkube/vendor/k8s.io/api/storage/v1beta1/generated.proto", "Protocol Buffers", 0, 0, 115, 0, 0, 392, 68, 575
"/opt/projects/swiftkube/vendor/k8s.io/api/storage/v1beta1/register.go", "Go", 50, 0, 0, 0, 0, 0, 16, 66
"/opt/projects/swiftkube/vendor/k8s.io/api/storage/v1beta1/types.go", "Go", 621, 0, 0, 0, 0, 0, 93, 714
"/opt/projects/swiftkube/vendor/k8s.io/api/storage/v1beta1/types_swagger_doc_generated.go", "Go", 194, 0, 0, 0, 0, 0, 45, 239
"/opt/projects/swiftkube/vendor/k8s.io/api/storage/v1beta1/zz_generated.deepcopy.go", "Go", 563, 0, 0, 0, 0, 0, 56, 619
"/opt/projects/swiftkube/vendor/k8s.io/api/storage/v1beta1/zz_generated.prerelease-lifecycle.go", "Go", 219, 0, 0, 0, 0, 0, 48, 267
"/opt/projects/swiftkube/vendor/k8s.io/apiextensions-apiserver/pkg/features/kube_features.go", "Go", 39, 0, 0, 0, 0, 0, 10, 49
"/opt/projects/swiftkube/vendor/k8s.io/apimachinery/pkg/api/equality/semantic.go", "Go", 43, 0, 0, 0, 0, 0, 7, 50
"/opt/projects/swiftkube/vendor/k8s.io/apimachinery/pkg/api/errors/doc.go", "Go", 14, 0, 0, 0, 0, 0, 5, 19
"/opt/projects/swiftkube/vendor/k8s.io/apimachinery/pkg/api/errors/errors.go", "Go", 789, 0, 0, 0, 0, 0, 69, 858
"/opt/projects/swiftkube/vendor/k8s.io/apimachinery/pkg/api/meta/conditions.go", "Go", 86, 0, 0, 0, 0, 0, 17, 103
"/opt/projects/swiftkube/vendor/k8s.io/apimachinery/pkg/api/meta/doc.go", "Go", 15, 0, 0, 0, 0, 0, 5, 20
"/opt/projects/swiftkube/vendor/k8s.io/apimachinery/pkg/api/meta/errors.go", "Go", 109, 0, 0, 0, 0, 0, 24, 133
"/opt/projects/swiftkube/vendor/k8s.io/apimachinery/pkg/api/meta/firsthit_restmapper.go", "Go", 86, 0, 0, 0, 0, 0, 20, 106
"/opt/projects/swiftkube/vendor/k8s.io/apimachinery/pkg/api/meta/help.go", "Go", 303, 0, 0, 0, 0, 0, 29, 332
"/opt/projects/swiftkube/vendor/k8s.io/apimachinery/pkg/api/meta/interfaces.go", "Go", 111, 0, 0, 0, 0, 0, 33, 144
"/opt/projects/swiftkube/vendor/k8s.io/apimachinery/pkg/api/meta/lazy.go", "Go", 93, 0, 0, 0, 0, 0, 20, 113
"/opt/projects/swiftkube/vendor/k8s.io/apimachinery/pkg/api/meta/meta.go", "Go", 567, 0, 0, 0, 0, 0, 77, 644
"/opt/projects/swiftkube/vendor/k8s.io/apimachinery/pkg/api/meta/multirestmapper.go", "Go", 188, 0, 0, 0, 0, 0, 33, 221
"/opt/projects/swiftkube/vendor/k8s.io/apimachinery/pkg/api/meta/priority.go", "Go", 196, 0, 0, 0, 0, 0, 35, 231
"/opt/projects/swiftkube/vendor/k8s.io/apimachinery/pkg/api/meta/restmapper.go", "Go", 448, 0, 0, 0, 0, 0, 82, 530
"/opt/projects/swiftkube/vendor/k8s.io/apimachinery/pkg/api/resource/amount.go", "Go", 268, 0, 0, 0, 0, 0, 32, 300
"/opt/projects/swiftkube/vendor/k8s.io/apimachinery/pkg/api/resource/generated.pb.go", "Go", 97, 0, 0, 0, 0, 0, 18, 115
"/opt/projects/swiftkube/vendor/k8s.io/apimachinery/pkg/api/resource/generated.proto", "Protocol Buffers", 0, 0, 21, 0, 0, 79, 12, 112
"/opt/projects/swiftkube/vendor/k8s.io/apimachinery/pkg/api/resource/math.go", "Go", 285, 0, 0, 0, 0, 0, 26, 311
"/opt/projects/swiftkube/vendor/k8s.io/apimachinery/pkg/api/resource/quantity.go", "Go", 731, 0, 0, 0, 0, 0, 78, 809
"/opt/projects/swiftkube/vendor/k8s.io/apimachinery/pkg/api/resource/quantity_proto.go", "Go", 265, 0, 0, 0, 0, 0, 24, 289
"/opt/projects/swiftkube/vendor/k8s.io/apimachinery/pkg/api/resource/scale_int.go", "Go", 80, 0, 0, 0, 0, 0, 16, 96
"/opt/projects/swiftkube/vendor/k8s.io/apimachinery/pkg/api/resource/suffix.go", "Go", 171, 0, 0, 0, 0, 0, 28, 199
"/opt/projects/swiftkube/vendor/k8s.io/apimachinery/pkg/api/resource/zz_generated.deepcopy.go", "Go", 36, 0, 0, 0, 0, 0, 10, 46
"/opt/projects/swiftkube/vendor/k8s.io/apimachinery/pkg/api/validation/doc.go", "Go", 14, 0, 0, 0, 0, 0, 5, 19
"/opt/projects/swiftkube/vendor/k8s.io/apimachinery/pkg/api/validation/generic.go", "Go", 73, 0, 0, 0, 0, 0, 16, 89
"/opt/projects/swiftkube/vendor/k8s.io/apimachinery/pkg/api/validation/objectmeta.go", "Go", 235, 0, 0, 0, 0, 0, 31, 266
"/opt/projects/swiftkube/vendor/k8s.io/apimachinery/pkg/api/validation/path/name.go", "Go", 54, 0, 0, 0, 0, 0, 15, 69
"/opt/projects/swiftkube/vendor/k8s.io/apimachinery/pkg/apis/meta/internalversion/defaults.go", "Go", 32, 0, 0, 0, 0, 0, 7, 39
"/opt/projects/swiftkube/vendor/k8s.io/apimachinery/pkg/apis/meta/internalversion/doc.go", "Go", 15, 0, 0, 0, 0, 0, 6, 21
"/opt/projects/swiftkube/vendor/k8s.io/apimachinery/pkg/apis/meta/internalversion/register.go", "Go", 76, 0, 0, 0, 0, 0, 13, 89
"/opt/projects/swiftkube/vendor/k8s.io/apimachinery/pkg/apis/meta/internalversion/scheme/doc.go", "Go", 13, 0, 0, 0, 0, 0, 5, 18
"/opt/projects/swiftkube/vendor/k8s.io/apimachinery/pkg/apis/meta/internalversion/scheme/register.go", "Go", 30, 0, 0, 0, 0, 0, 10, 40
"/opt/projects/swiftkube/vendor/k8s.io/apimachinery/pkg/apis/meta/internalversion/types.go", "Go", 92, 0, 0, 0, 0, 0, 14, 106
"/opt/projects/swiftkube/vendor/k8s.io/apimachinery/pkg/apis/meta/internalversion/validation/validation.go", "Go", 68, 0, 0, 0, 0, 0, 9, 77
"/opt/projects/swiftkube/vendor/k8s.io/apimachinery/pkg/apis/meta/internalversion/zz_generated.conversion.go", "Go", 130, 0, 0, 0, 0, 0, 19, 149
"/opt/projects/swiftkube/vendor/k8s.io/apimachinery/pkg/apis/meta/internalversion/zz_generated.deepcopy.go", "Go", 89, 0, 0, 0, 0, 0, 14, 103
"/opt/projects/swiftkube/vendor/k8s.io/apimachinery/pkg/apis/meta/v1/controller_ref.go", "Go", 56, 0, 0, 0, 0, 0, 10, 66
"/opt/projects/swiftkube/vendor/k8s.io/apimachinery/pkg/apis/meta/v1/conversion.go", "Go", 310, 0, 0, 0, 0, 0, 46, 356
"/opt/projects/swiftkube/vendor/k8s.io/apimachinery/pkg/apis/meta/v1/deepcopy.go", "Go", 36, 0, 0, 0, 0, 0, 11, 47
"/opt/projects/swiftkube/vendor/k8s.io/apimachinery/pkg/apis/meta/v1/doc.go", "Go", 18, 0, 0, 0, 0, 0, 7, 25
"/opt/projects/swiftkube/vendor/k8s.io/apimachinery/pkg/apis/meta/v1/duration.go", "Go", 53, 0, 0, 0, 0, 0, 13, 66
"/opt/projects/swiftkube/vendor/k8s.io/apimachinery/pkg/apis/meta/v1/generated.pb.go", "Go", 11252, 0, 0, 0, 0, 0, 316, 11568
"/opt/projects/swiftkube/vendor/k8s.io/apimachinery/pkg/apis/meta/v1/generated.proto", "Protocol Buffers", 0, 0, 249, 0, 0, 787, 157, 1193
"/opt/projects/swiftkube/vendor/k8s.io/apimachinery/pkg/apis/meta/v1/group_version.go", "Go", 135, 0, 0, 0, 0, 0, 23, 158
"/opt/projects/swiftkube/vendor/k8s.io/apimachinery/pkg/apis/meta/v1/helpers.go", "Go", 268, 0, 0, 0, 0, 0, 31, 299
"/opt/projects/swiftkube/vendor/k8s.io/apimachinery/pkg/apis/meta/v1/labels.go", "Go", 44, 0, 0, 0, 0, 0, 12, 56
"/opt/projects/swiftkube/vendor/k8s.io/apimachinery/pkg/apis/meta/v1/meta.go", "Go", 157, 0, 0, 0, 0, 0, 20, 177
"/opt/projects/swiftkube/vendor/k8s.io/apimachinery/pkg/apis/meta/v1/micro_time.go", "Go", 151, 0, 0, 0, 0, 0, 31, 182
"/opt/projects/swiftkube/vendor/k8s.io/apimachinery/pkg/apis/meta/v1/micro_time_fuzz.go", "Go", 31, 0, 0, 0, 0, 0, 10, 41
"/opt/projects/swiftkube/vendor/k8s.io/apimachinery/pkg/apis/meta/v1/micro_time_proto.go", "Go", 72, 0, 0, 0, 0, 0, 15, 87
"/opt/projects/swiftkube/vendor/k8s.io/apimachinery/pkg/apis/meta/v1/register.go", "Go", 86, 0, 0, 0, 0, 0, 22, 108
"/opt/projects/swiftkube/vendor/k8s.io/apimachinery/pkg/apis/meta/v1/time.go", "Go", 154, 0, 0, 0, 0, 0, 29, 183
"/opt/projects/swiftkube/vendor/k8s.io/apimachinery/pkg/apis/meta/v1/time_fuzz.go", "Go", 31, 0, 0, 0, 0, 0, 10, 41
"/opt/projects/swiftkube/vendor/k8s.io/apimachinery/pkg/apis/meta/v1/time_proto.go", "Go", 88, 0, 0, 0, 0, 0, 13, 101
"/opt/projects/swiftkube/vendor/k8s.io/apimachinery/pkg/apis/meta/v1/types.go", "Go", 1384, 0, 0, 0, 0, 0, 160, 1544
"/opt/projects/swiftkube/vendor/k8s.io/apimachinery/pkg/apis/meta/v1/types_swagger_doc_generated.go", "Go", 382, 0, 0, 0, 0, 0, 81, 463
"/opt/projects/swiftkube/vendor/k8s.io/apimachinery/pkg/apis/meta/v1/unstructured/helpers.go", "Go", 445, 0, 0, 0, 0, 0, 57, 502
"/opt/projects/swiftkube/vendor/k8s.io/apimachinery/pkg/apis/meta/v1/unstructured/unstructured.go", "Go", 423, 0, 0, 0, 0, 0, 67, 490
"/opt/projects/swiftkube/vendor/k8s.io/apimachinery/pkg/apis/meta/v1/unstructured/unstructured_list.go", "Go", 183, 0, 0, 0, 0, 0, 37, 220
"/opt/projects/swiftkube/vendor/k8s.io/apimachinery/pkg/apis/meta/v1/unstructured/unstructuredscheme/scheme.go", "Go", 106, 0, 0, 0, 0, 0, 24, 130
"/opt/projects/swiftkube/vendor/k8s.io/apimachinery/pkg/apis/meta/v1/unstructured/zz_generated.deepcopy.go", "Go", 45, 0, 0, 0, 0, 0, 12, 57
"/opt/projects/swiftkube/vendor/k8s.io/apimachinery/pkg/apis/meta/v1/validation/validation.go", "Go", 274, 0, 0, 0, 0, 0, 47, 321
"/opt/projects/swiftkube/vendor/k8s.io/apimachinery/pkg/apis/meta/v1/watch.go", "Go", 76, 0, 0, 0, 0, 0, 14, 90
"/opt/projects/swiftkube/vendor/k8s.io/apimachinery/pkg/apis/meta/v1/zz_generated.conversion.go", "Go", 504, 0, 0, 0, 0, 0, 31, 535
"/opt/projects/swiftkube/vendor/k8s.io/apimachinery/pkg/apis/meta/v1/zz_generated.deepcopy.go", "Go", 1076, 0, 0, 0, 0, 0, 118, 1194
"/opt/projects/swiftkube/vendor/k8s.io/apimachinery/pkg/apis/meta/v1/zz_generated.defaults.go", "Go", 25, 0, 0, 0, 0, 0, 9, 34
"/opt/projects/swiftkube/vendor/k8s.io/apimachinery/pkg/apis/meta/v1beta1/conversion.go", "Go", 37, 0, 0, 0, 0, 0, 10, 47
"/opt/projects/swiftkube/vendor/k8s.io/apimachinery/pkg/apis/meta/v1beta1/deepcopy.go", "Go", 13, 0, 0, 0, 0, 0, 5, 18
"/opt/projects/swiftkube/vendor/k8s.io/apimachinery/pkg/apis/meta/v1beta1/doc.go", "Go", 17, 0, 0, 0, 0, 0, 7, 24
"/opt/projects/swiftkube/vendor/k8s.io/apimachinery/pkg/apis/meta/v1beta1/generated.pb.go", "Go", 389, 0, 0, 0, 0, 0, 24, 413
"/opt/projects/swiftkube/vendor/k8s.io/apimachinery/pkg/apis/meta/v1beta1/generated.proto", "Protocol Buffers", 0, 0, 21, 0, 0, 8, 13, 42
"/opt/projects/swiftkube/vendor/k8s.io/apimachinery/pkg/apis/meta/v1beta1/register.go", "Go", 51, 0, 0, 0, 0, 0, 12, 63
"/opt/projects/swiftkube/vendor/k8s.io/apimachinery/pkg/apis/meta/v1beta1/types.go", "Go", 64, 0, 0, 0, 0, 0, 21, 85
"/opt/projects/swiftkube/vendor/k8s.io/apimachinery/pkg/apis/meta/v1beta1/types_swagger_doc_generated.go", "Go", 32, 0, 0, 0, 0, 0, 9, 41
"/opt/projects/swiftkube/vendor/k8s.io/apimachinery/pkg/apis/meta/v1beta1/validation/validation.go", "Go", 27, 0, 0, 0, 0, 0, 7, 34
"/opt/projects/swiftkube/vendor/k8s.io/apimachinery/pkg/apis/meta/v1beta1/zz_generated.deepcopy.go", "Go", 50, 0, 0, 0, 0, 0, 11, 61
"/opt/projects/swiftkube/vendor/k8s.io/apimachinery/pkg/apis/meta/v1beta1/zz_generated.defaults.go", "Go", 25, 0, 0, 0, 0, 0, 9, 34
"/opt/projects/swiftkube/vendor/k8s.io/apimachinery/pkg/conversion/converter.go", "Go", 194, 0, 0, 0, 0, 0, 32, 226
"/opt/projects/swiftkube/vendor/k8s.io/apimachinery/pkg/conversion/deep_equal.go", "Go", 37, 0, 0, 0, 0, 0, 11, 48
"/opt/projects/swiftkube/vendor/k8s.io/apimachinery/pkg/conversion/doc.go", "Go", 20, 0, 0, 0, 0, 0, 5, 25
"/opt/projects/swiftkube/vendor/k8s.io/apimachinery/pkg/conversion/helper.go", "Go", 33, 0, 0, 0, 0, 0, 7, 40
"/opt/projects/swiftkube/vendor/k8s.io/apimachinery/pkg/conversion/queryparams/convert.go", "Go", 169, 0, 0, 0, 0, 0, 26, 195
"/opt/projects/swiftkube/vendor/k8s.io/apimachinery/pkg/conversion/queryparams/doc.go", "Go", 15, 0, 0, 0, 0, 0, 5, 20
"/opt/projects/swiftkube/vendor/k8s.io/apimachinery/pkg/fields/doc.go", "Go", 15, 0, 0, 0, 0, 0, 5, 20
"/opt/projects/swiftkube/vendor/k8s.io/apimachinery/pkg/fields/fields.go", "Go", 50, 0, 0, 0, 0, 0, 13, 63
"/opt/projects/swiftkube/vendor/k8s.io/apimachinery/pkg/fields/requirements.go", "Go", 23, 0, 0, 0, 0, 0, 8, 31
"/opt/projects/swiftkube/vendor/k8s.io/apimachinery/pkg/fields/selector.go", "Go", 410, 0, 0, 0, 0, 0, 69, 479
"/opt/projects/swiftkube/vendor/k8s.io/apimachinery/pkg/labels/doc.go", "Go", 15, 0, 0, 0, 0, 0, 5, 20
"/opt/projects/swiftkube/vendor/k8s.io/apimachinery/pkg/labels/labels.go", "Go", 148, 0, 0, 0, 0, 0, 27, 175
"/opt/projects/swiftkube/vendor/k8s.io/apimachinery/pkg/labels/selector.go", "Go", 938, 0, 0, 0, 0, 0, 99, 1037
"/opt/projects/swiftkube/vendor/k8s.io/apimachinery/pkg/labels/zz_generated.deepcopy.go", "Go", 35, 0, 0, 0, 0, 0, 9, 44
"/opt/projects/swiftkube/vendor/k8s.io/apimachinery/pkg/runtime/allocator.go", "Go", 64, 0, 0, 0, 0, 0, 13, 77
"/opt/projects/swiftkube/vendor/k8s.io/apimachinery/pkg/runtime/codec.go", "Go", 346, 0, 0, 0, 0, 0, 51, 397
"/opt/projects/swiftkube/vendor/k8s.io/apimachinery/pkg/runtime/codec_check.go", "Go", 49, 0, 0, 0, 0, 0, 8, 57
"/opt/projects/swiftkube/vendor/k8s.io/apimachinery/pkg/runtime/conversion.go", "Go", 178, 0, 0, 0, 0, 0, 19, 197
"/opt/projects/swiftkube/vendor/k8s.io/apimachinery/pkg/runtime/converter.go", "Go", 785, 0, 0, 0, 0, 0, 74, 859
"/opt/projects/swiftkube/vendor/k8s.io/apimachinery/pkg/runtime/doc.go", "Go", 47, 0, 0, 0, 0, 0, 5, 52
"/opt/projects/swiftkube/vendor/k8s.io/apimachinery/pkg/runtime/embedded.go", "Go", 132, 0, 0, 0, 0, 0, 18, 150
"/opt/projects/swiftkube/vendor/k8s.io/apimachinery/pkg/runtime/error.go", "Go", 144, 0, 0, 0, 0, 0, 29, 173
"/opt/projects/swiftkube/vendor/k8s.io/apimachinery/pkg/runtime/extension.go", "Go", 44, 0, 0, 0, 0, 0, 8, 52
"/opt/projects/swiftkube/vendor/k8s.io/apimachinery/pkg/runtime/generated.pb.go", "Go", 810, 0, 0, 0, 0, 0, 37, 847
"/opt/projects/swiftkube/vendor/k8s.io/apimachinery/pkg/runtime/generated.proto", "Protocol Buffers", 0, 0, 28, 0, 0, 90, 17, 135
"/opt/projects/swiftkube/vendor/k8s.io/apimachinery/pkg/runtime/helper.go", "Go", 231, 0, 0, 0, 0, 0, 29, 260
"/opt/projects/swiftkube/vendor/k8s.io/apimachinery/pkg/runtime/interfaces.go", "Go", 333, 0, 0, 0, 0, 0, 41, 374
"/opt/projects/swiftkube/vendor/k8s.io/apimachinery/pkg/runtime/mapper.go", "Go", 83, 0, 0, 0, 0, 0, 16, 99
"/opt/projects/swiftkube/vendor/k8s.io/apimachinery/pkg/runtime/negotiate.go", "Go", 95, 0, 0, 0, 0, 0, 19, 114
"/opt/projects/swiftkube/vendor/k8s.io/apimachinery/pkg/runtime/register.go", "Go", 23, 0, 0, 0, 0, 0, 9, 32
"/opt/projects/swiftkube/vendor/k8s.io/apimachinery/pkg/runtime/schema/generated.pb.go", "Go", 47, 0, 0, 0, 0, 0, 13, 60
"/opt/projects/swiftkube/vendor/k8s.io/apimachinery/pkg/runtime/schema/generated.proto", "Protocol Buffers", 0, 0, 15, 0, 0, 2, 10, 27
"/opt/projects/swiftkube/vendor/k8s.io/apimachinery/pkg/runtime/schema/group_version.go", "Go", 260, 0, 0, 0, 0, 0, 46, 306
"/opt/projects/swiftkube/vendor/k8s.io/apimachinery/pkg/runtime/schema/interfaces.go", "Go", 31, 0, 0, 0, 0, 0, 10, 41
"/opt/projects/swiftkube/vendor/k8s.io/apimachinery/pkg/runtime/scheme.go", "Go", 617, 0, 0, 0, 0, 0, 90, 707
"/opt/projects/swiftkube/vendor/k8s.io/apimachinery/pkg/runtime/scheme_builder.go", "Go", 40, 0, 0, 0, 0, 0, 9, 49
"/opt/projects/swiftkube/vendor/k8s.io/apimachinery/pkg/runtime/serializer/codec_factory.go", "Go", 292, 0, 0, 0, 0, 0, 47, 339
"/opt/projects/swiftkube/vendor/k8s.io/apimachinery/pkg/runtime/serializer/json/json.go", "Go", 304, 0, 0, 0, 0, 0, 48, 352
"/opt/projects/swiftkube/vendor/k8s.io/apimachinery/pkg/runtime/serializer/json/meta.go", "Go", 53, 0, 0, 0, 0, 0, 11, 64
"/opt/projects/swiftkube/vendor/k8s.io/apimachinery/pkg/runtime/serializer/negotiated_codec.go", "Go", 33, 0, 0, 0, 0, 0, 11, 44
"/opt/projects/swiftkube/vendor/k8s.io/apimachinery/pkg/runtime/serializer/protobuf/doc.go", "Go", 14, 0, 0, 0, 0, 0, 5, 19
"/opt/projects/swiftkube/vendor/k8s.io/apimachinery/pkg/runtime/serializer/protobuf/protobuf.go", "Go", 424, 0, 0, 0, 0, 0, 72, 496
"/opt/projects/swiftkube/vendor/k8s.io/apimachinery/pkg/runtime/serializer/recognizer/recognizer.go", "Go", 113, 0, 0, 0, 0, 0, 16, 129
"/opt/projects/swiftkube/vendor/k8s.io/apimachinery/pkg/runtime/serializer/streaming/streaming.go", "Go", 136, 0, 0, 0, 0, 0, 21, 157
"/opt/projects/swiftkube/vendor/k8s.io/apimachinery/pkg/runtime/serializer/versioning/versioning.go", "Go", 249, 0, 0, 0, 0, 0, 42, 291
"/opt/projects/swiftkube/vendor/k8s.io/apimachinery/pkg/runtime/splice.go", "Go", 64, 0, 0, 0, 0, 0, 13, 77
"/opt/projects/swiftkube/vendor/k8s.io/apimachinery/pkg/runtime/swagger_doc_generator.go", "Go", 219, 0, 0, 0, 0, 0, 44, 263
"/opt/projects/swiftkube/vendor/k8s.io/apimachinery/pkg/runtime/types.go", "Go", 124, 0, 0, 0, 0, 0, 10, 134
"/opt/projects/swiftkube/vendor/k8s.io/apimachinery/pkg/runtime/types_proto.go", "Go", 80, 0, 0, 0, 0, 0, 10, 90
"/opt/projects/swiftkube/vendor/k8s.io/apimachinery/pkg/runtime/zz_generated.deepcopy.go", "Go", 65, 0, 0, 0, 0, 0, 12, 77
"/opt/projects/swiftkube/vendor/k8s.io/apimachinery/pkg/selection/operator.go", "Go", 27, 0, 0, 0, 0, 0, 7, 34
"/opt/projects/swiftkube/vendor/k8s.io/apimachinery/pkg/types/doc.go", "Go", 14, 0, 0, 0, 0, 0, 5, 19
"/opt/projects/swiftkube/vendor/k8s.io/apimachinery/pkg/types/namespacedname.go", "Go", 41, 0, 0, 0, 0, 0, 10, 51
"/opt/projects/swiftkube/vendor/k8s.io/apimachinery/pkg/types/nodename.go", "Go", 38, 0, 0, 0, 0, 0, 6, 44
"/opt/projects/swiftkube/vendor/k8s.io/apimachinery/pkg/types/patch.go", "Go", 23, 0, 0, 0, 0, 0, 7, 30
"/opt/projects/swiftkube/vendor/k8s.io/apimachinery/pkg/types/uid.go", "Go", 17, 0, 0, 0, 0, 0, 6, 23
"/opt/projects/swiftkube/vendor/k8s.io/apimachinery/pkg/util/cache/expiring.go", "Go", 170, 0, 0, 0, 0, 0, 33, 203
"/opt/projects/swiftkube/vendor/k8s.io/apimachinery/pkg/util/cache/lruexpirecache.go", "Go", 129, 0, 0, 0, 0, 0, 32, 161
"/opt/projects/swiftkube/vendor/k8s.io/apimachinery/pkg/util/diff/diff.go", "Go", 124, 0, 0, 0, 0, 0, 15, 139
"/opt/projects/swiftkube/vendor/k8s.io/apimachinery/pkg/util/dump/dump.go", "Go", 44, 0, 0, 0, 0, 0, 11, 55
"/opt/projects/swiftkube/vendor/k8s.io/apimachinery/pkg/util/duration/duration.go", "Go", 86, 0, 0, 0, 0, 0, 8, 94
"/opt/projects/swiftkube/vendor/k8s.io/apimachinery/pkg/util/errors/doc.go", "Go", 14, 0, 0, 0, 0, 0, 5, 19
"/opt/projects/swiftkube/vendor/k8s.io/apimachinery/pkg/util/errors/errors.go", "Go", 225, 0, 0, 0, 0, 0, 25, 250
"/opt/projects/swiftkube/vendor/k8s.io/apimachinery/pkg/util/framer/framer.go", "Go", 149, 0, 0, 0, 0, 0, 22, 171
"/opt/projects/swiftkube/vendor/k8s.io/apimachinery/pkg/util/httpstream/doc.go", "Go", 15, 0, 0, 0, 0, 0, 5, 20
"/opt/projects/swiftkube/vendor/k8s.io/apimachinery/pkg/util/httpstream/httpstream.go", "Go", 138, 0, 0, 0, 0, 0, 22, 160
"/opt/projects/swiftkube/vendor/k8s.io/apimachinery/pkg/util/httpstream/spdy/connection.go", "Go", 178, 0, 0, 0, 0, 0, 27, 205
"/opt/projects/swiftkube/vendor/k8s.io/apimachinery/pkg/util/httpstream/spdy/roundtripper.go", "Go", 309, 0, 0, 0, 0, 0, 62, 371
"/opt/projects/swiftkube/vendor/k8s.io/apimachinery/pkg/util/httpstream/spdy/upgrade.go", "Go", 101, 0, 0, 0, 0, 0, 20, 121
"/opt/projects/swiftkube/vendor/k8s.io/apimachinery/pkg/util/httpstream/wsstream/conn.go", "Go", 309, 0, 0, 0, 0, 0, 42, 351
"/opt/projects/swiftkube/vendor/k8s.io/apimachinery/pkg/util/httpstream/wsstream/doc.go", "Go", 17, 0, 0, 0, 0, 0, 5, 22
"/opt/projects/swiftkube/vendor/k8s.io/apimachinery/pkg/util/httpstream/wsstream/stream.go", "Go", 154, 0, 0, 0, 0, 0, 24, 178
"/opt/projects/swiftkube/vendor/k8s.io/apimachinery/pkg/util/intstr/generated.pb.go", "Go", 347, 0, 0, 0, 0, 0, 23, 370
"/opt/projects/swiftkube/vendor/k8s.io/apimachinery/pkg/util/intstr/generated.proto", "Protocol Buffers", 0, 0, 20, 0, 0, 11, 13, 44
"/opt/projects/swiftkube/vendor/k8s.io/apimachinery/pkg/util/intstr/instr_fuzz.go", "Go", 35, 0, 0, 0, 0, 0, 9, 44
"/opt/projects/swiftkube/vendor/k8s.io/apimachinery/pkg/util/intstr/intstr.go", "Go", 207, 0, 0, 0, 0, 0, 26, 233
"/opt/projects/swiftkube/vendor/k8s.io/apimachinery/pkg/util/json/json.go", "Go", 105, 0, 0, 0, 0, 0, 17, 122
"/opt/projects/swiftkube/vendor/k8s.io/apimachinery/pkg/util/jsonmergepatch/patch.go", "Go", 142, 0, 0, 0, 0, 0, 19, 161
"/opt/projects/swiftkube/vendor/k8s.io/apimachinery/pkg/util/managedfields/extract.go", "Go", 95, 0, 0, 0, 0, 0, 14, 109
"/opt/projects/swiftkube/vendor/k8s.io/apimachinery/pkg/util/managedfields/fieldmanager.go", "Go", 47, 0, 0, 0, 0, 0, 11, 58
"/opt/projects/swiftkube/vendor/k8s.io/apimachinery/pkg/util/managedfields/gvkparser.go", "Go", 111, 0, 0, 0, 0, 0, 18, 129
"/opt/projects/swiftkube/vendor/k8s.io/apimachinery/pkg/util/managedfields/internal/atmostevery.go", "Go", 51, 0, 0, 0, 0, 0, 10, 61
"/opt/projects/swiftkube/vendor/k8s.io/apimachinery/pkg/util/managedfields/internal/buildmanagerinfo.go", "Go", 62, 0, 0, 0, 0, 0, 13, 75
"/opt/projects/swiftkube/vendor/k8s.io/apimachinery/pkg/util/managedfields/internal/capmanagers.go", "Go", 114, 0, 0, 0, 0, 0, 20, 134
"/opt/projects/swiftkube/vendor/k8s.io/apimachinery/pkg/util/managedfields/internal/conflict.go", "Go", 76, 0, 0, 0, 0, 0, 14, 90
"/opt/projects/swiftkube/vendor/k8s.io/apimachinery/pkg/util/managedfields/internal/fieldmanager.go", "Go", 176, 0, 0, 0, 0, 0, 34, 210
"/opt/projects/swiftkube/vendor/k8s.io/apimachinery/pkg/util/managedfields/internal/fields.go", "Go", 37, 0, 0, 0, 0, 0, 11, 48
"/opt/projects/swiftkube/vendor/k8s.io/apimachinery/pkg/util/managedfields/internal/lastapplied.go", "Go", 42, 0, 0, 0, 0, 0, 9, 51
"/opt/projects/swiftkube/vendor/k8s.io/apimachinery/pkg/util/managedfields/internal/lastappliedmanager.go", "Go", 144, 0, 0, 0, 0, 0, 28, 172
"/opt/projects/swiftkube/vendor/k8s.io/apimachinery/pkg/util/managedfields/internal/lastappliedupdater.go", "Go", 85, 0, 0, 0, 0, 0, 18, 103
"/opt/projects/swiftkube/vendor/k8s.io/apimachinery/pkg/util/managedfields/internal/managedfields.go", "Go", 209, 0, 0, 0, 0, 0, 40, 249
"/opt/projects/swiftkube/vendor/k8s.io/apimachinery/pkg/util/managedfields/internal/managedfieldsupdater.go", "Go", 67, 0, 0, 0, 0, 0, 16, 83
"/opt/projects/swiftkube/vendor/k8s.io/apimachinery/pkg/util/managedfields/internal/manager.go", "Go", 43, 0, 0, 0, 0, 0, 10, 53
"/opt/projects/swiftkube/vendor/k8s.io/apimachinery/pkg/util/managedfields/internal/pathelement.go", "Go", 126, 0, 0, 0, 0, 0, 15, 141
"/opt/projects/swiftkube/vendor/k8s.io/apimachinery/pkg/util/managedfields/internal/skipnonapplied.go", "Go", 76, 0, 0, 0, 0, 0, 14, 90
"/opt/projects/swiftkube/vendor/k8s.io/apimachinery/pkg/util/managedfields/internal/stripmeta.go", "Go", 77, 0, 0, 0, 0, 0, 14, 91
"/opt/projects/swiftkube/vendor/k8s.io/apimachinery/pkg/util/managedfields/internal/structuredmerge.go", "Go", 160, 0, 0, 0, 0, 0, 27, 187
"/opt/projects/swiftkube/vendor/k8s.io/apimachinery/pkg/util/managedfields/internal/typeconverter.go", "Go", 164, 0, 0, 0, 0, 0, 30, 194
"/opt/projects/swiftkube/vendor/k8s.io/apimachinery/pkg/util/managedfields/internal/versioncheck.go", "Go", 41, 0, 0, 0, 0, 0, 12, 53
"/opt/projects/swiftkube/vendor/k8s.io/apimachinery/pkg/util/managedfields/internal/versionconverter.go", "Go", 102, 0, 0, 0, 0, 0, 22, 124
"/opt/projects/swiftkube/vendor/k8s.io/apimachinery/pkg/util/managedfields/scalehandler.go", "Go", 149, 0, 0, 0, 0, 0, 26, 175
"/opt/projects/swiftkube/vendor/k8s.io/apimachinery/pkg/util/managedfields/typeconverter.go", "Go", 39, 0, 0, 0, 0, 0, 9, 48
"/opt/projects/swiftkube/vendor/k8s.io/apimachinery/pkg/util/mergepatch/errors.go", "Go", 84, 0, 0, 0, 0, 0, 19, 103
"/opt/projects/swiftkube/vendor/k8s.io/apimachinery/pkg/util/mergepatch/util.go", "Go", 115, 0, 0, 0, 0, 0, 19, 134
"/opt/projects/swiftkube/vendor/k8s.io/apimachinery/pkg/util/naming/from_stack.go", "Go", 82, 0, 0, 0, 0, 0, 12, 94
"/opt/projects/swiftkube/vendor/k8s.io/apimachinery/pkg/util/net/http.go", "Go", 626, 0, 0, 0, 0, 0, 74, 700
"/opt/projects/swiftkube/vendor/k8s.io/apimachinery/pkg/util/net/interface.go", "Go", 457, 0, 0, 0, 0, 0, 44, 501
"/opt/projects/swiftkube/vendor/k8s.io/apimachinery/pkg/util/net/port_range.go", "Go", 129, 0, 0, 0, 0, 0, 21, 150
"/opt/projects/swiftkube/vendor/k8s.io/apimachinery/pkg/util/net/port_split.go", "Go", 68, 0, 0, 0, 0, 0, 11, 79
"/opt/projects/swiftkube/vendor/k8s.io/apimachinery/pkg/util/net/util.go", "Go", 54, 0, 0, 0, 0, 0, 10, 64
"/opt/projects/swiftkube/vendor/k8s.io/apimachinery/pkg/util/proxy/dial.go", "Go", 109, 0, 0, 0, 0, 0, 14, 123
"/opt/projects/swiftkube/vendor/k8s.io/apimachinery/pkg/util/proxy/doc.go", "Go", 14, 0, 0, 0, 0, 0, 5, 19
"/opt/projects/swiftkube/vendor/k8s.io/apimachinery/pkg/util/proxy/transport.go", "Go", 242, 0, 0, 0, 0, 0, 31, 273
"/opt/projects/swiftkube/vendor/k8s.io/apimachinery/pkg/util/proxy/upgradeaware.go", "Go", 493, 0, 0, 0, 0, 0, 64, 557
"/opt/projects/swiftkube/vendor/k8s.io/apimachinery/pkg/util/rand/rand.go", "Go", 110, 0, 0, 0, 0, 0, 18, 128
"/opt/projects/swiftkube/vendor/k8s.io/apimachinery/pkg/util/remotecommand/constants.go", "Go", 40, 0, 0, 0, 0, 0, 14, 54
"/opt/projects/swiftkube/vendor/k8s.io/apimachinery/pkg/util/runtime/runtime.go", "Go", 153, 0, 0, 0, 0, 0, 22, 175
"/opt/projects/swiftkube/vendor/k8s.io/apimachinery/pkg/util/sets/byte.go", "Go", 114, 0, 0, 0, 0, 0, 24, 138
"/opt/projects/swiftkube/vendor/k8s.io/apimachinery/pkg/util/sets/doc.go", "Go", 15, 0, 0, 0, 0, 0, 5, 20
"/opt/projects/swiftkube/vendor/k8s.io/apimachinery/pkg/util/sets/empty.go", "Go", 16, 0, 0, 0, 0, 0, 6, 22
"/opt/projects/swiftkube/vendor/k8s.io/apimachinery/pkg/util/sets/int.go", "Go", 114, 0, 0, 0, 0, 0, 24, 138
"/opt/projects/swiftkube/vendor/k8s.io/apimachinery/pkg/util/sets/int32.go", "Go", 114, 0, 0, 0, 0, 0, 24, 138
"/opt/projects/swiftkube/vendor/k8s.io/apimachinery/pkg/util/sets/int64.go", "Go", 114, 0, 0, 0, 0, 0, 24, 138
"/opt/projects/swiftkube/vendor/k8s.io/apimachinery/pkg/util/sets/ordered.go", "Go", 44, 0, 0, 0, 0, 0, 10, 54
"/opt/projects/swiftkube/vendor/k8s.io/apimachinery/pkg/util/sets/set.go", "Go", 211, 0, 0, 0, 0, 0, 31, 242
"/opt/projects/swiftkube/vendor/k8s.io/apimachinery/pkg/util/sets/string.go", "Go", 114, 0, 0, 0, 0, 0, 24, 138
"/opt/projects/swiftkube/vendor/k8s.io/apimachinery/pkg/util/strategicpatch/errors.go", "Go", 38, 0, 0, 0, 0, 0, 12, 50
"/opt/projects/swiftkube/vendor/k8s.io/apimachinery/pkg/util/strategicpatch/meta.go", "Go", 160, 0, 0, 0, 0, 0, 35, 195
"/opt/projects/swiftkube/vendor/k8s.io/apimachinery/pkg/util/strategicpatch/patch.go", "Go", 2041, 0, 0, 0, 0, 0, 213, 2254
"/opt/projects/swiftkube/vendor/k8s.io/apimachinery/pkg/util/strategicpatch/types.go", "Go", 161, 0, 0, 0, 0, 0, 33, 194
"/opt/projects/swiftkube/vendor/k8s.io/apimachinery/pkg/util/uuid/uuid.go", "Go", 20, 0, 0, 0, 0, 0, 8, 28
"/opt/projects/swiftkube/vendor/k8s.io/apimachinery/pkg/util/validation/field/errors.go", "Go", 291, 0, 0, 0, 0, 0, 35, 326
"/opt/projects/swiftkube/vendor/k8s.io/apimachinery/pkg/util/validation/field/path.go", "Go", 100, 0, 0, 0, 0, 0, 18, 118
"/opt/projects/swiftkube/vendor/k8s.io/apimachinery/pkg/util/validation/validation.go", "Go", 439, 0, 0, 0, 0, 0, 72, 511
"/opt/projects/swiftkube/vendor/k8s.io/apimachinery/pkg/util/version/doc.go", "Go", 14, 0, 0, 0, 0, 0, 5, 19
"/opt/projects/swiftkube/vendor/k8s.io/apimachinery/pkg/util/version/version.go", "Go", 286, 0, 0, 0, 0, 0, 45, 331
"/opt/projects/swiftkube/vendor/k8s.io/apimachinery/pkg/util/wait/backoff.go", "Go", 450, 0, 0, 0, 0, 0, 53, 503
"/opt/projects/swiftkube/vendor/k8s.io/apimachinery/pkg/util/wait/delay.go", "Go", 41, 0, 0, 0, 0, 0, 11, 52
"/opt/projects/swiftkube/vendor/k8s.io/apimachinery/pkg/util/wait/doc.go", "Go", 15, 0, 0, 0, 0, 0, 5, 20
"/opt/projects/swiftkube/vendor/k8s.io/apimachinery/pkg/util/wait/error.go", "Go", 85, 0, 0, 0, 0, 0, 12, 97
"/opt/projects/swiftkube/vendor/k8s.io/apimachinery/pkg/util/wait/loop.go", "Go", 84, 0, 0, 0, 0, 0, 14, 98
"/opt/projects/swiftkube/vendor/k8s.io/apimachinery/pkg/util/wait/poll.go", "Go", 288, 0, 0, 0, 0, 0, 28, 316
"/opt/projects/swiftkube/vendor/k8s.io/apimachinery/pkg/util/wait/timer.go", "Go", 105, 0, 0, 0, 0, 0, 17, 122
"/opt/projects/swiftkube/vendor/k8s.io/apimachinery/pkg/util/wait/wait.go", "Go", 195, 0, 0, 0, 0, 0, 29, 224
"/opt/projects/swiftkube/vendor/k8s.io/apimachinery/pkg/util/waitgroup/doc.go", "Go", 15, 0, 0, 0, 0, 0, 5, 20
"/opt/projects/swiftkube/vendor/k8s.io/apimachinery/pkg/util/waitgroup/ratelimited_waitgroup.go", "Go", 113, 0, 0, 0, 0, 0, 22, 135
"/opt/projects/swiftkube/vendor/k8s.io/apimachinery/pkg/util/waitgroup/waitgroup.go", "Go", 48, 0, 0, 0, 0, 0, 10, 58
"/opt/projects/swiftkube/vendor/k8s.io/apimachinery/pkg/util/yaml/decoder.go", "Go", 353, 0, 0, 0, 0, 0, 45, 398
"/opt/projects/swiftkube/vendor/k8s.io/apimachinery/pkg/version/doc.go", "Go", 15, 0, 0, 0, 0, 0, 6, 21
"/opt/projects/swiftkube/vendor/k8s.io/apimachinery/pkg/version/helpers.go", "Go", 78, 0, 0, 0, 0, 0, 11, 89
"/opt/projects/swiftkube/vendor/k8s.io/apimachinery/pkg/version/types.go", "Go", 31, 0, 0, 0, 0, 0, 7, 38
"/opt/projects/swiftkube/vendor/k8s.io/apimachinery/pkg/watch/doc.go", "Go", 15, 0, 0, 0, 0, 0, 5, 20
"/opt/projects/swiftkube/vendor/k8s.io/apimachinery/pkg/watch/filter.go", "Go", 87, 0, 0, 0, 0, 0, 18, 105
"/opt/projects/swiftkube/vendor/k8s.io/apimachinery/pkg/watch/mux.go", "Go", 287, 0, 0, 0, 0, 0, 34, 321
"/opt/projects/swiftkube/vendor/k8s.io/apimachinery/pkg/watch/streamwatcher.go", "Go", 121, 0, 0, 0, 0, 0, 16, 137
"/opt/projects/swiftkube/vendor/k8s.io/apimachinery/pkg/watch/watch.go", "Go", 275, 0, 0, 0, 0, 0, 50, 325
"/opt/projects/swiftkube/vendor/k8s.io/apimachinery/pkg/watch/zz_generated.deepcopy.go", "Go", 33, 0, 0, 0, 0, 0, 9, 42
"/opt/projects/swiftkube/vendor/k8s.io/apimachinery/third_party/forked/golang/json/fields.go", "Go", 466, 0, 0, 0, 0, 0, 48, 514
"/opt/projects/swiftkube/vendor/k8s.io/apimachinery/third_party/forked/golang/netutil/addr.go", "Go", 24, 0, 0, 0, 0, 0, 5, 29
"/opt/projects/swiftkube/vendor/k8s.io/apimachinery/third_party/forked/golang/reflect/deep_equal.go", "Go", 398, 0, 0, 0, 0, 0, 37, 435
"/opt/projects/swiftkube/vendor/k8s.io/apiserver/pkg/admission/attributes.go", "Go", 175, 0, 0, 0, 0, 0, 37, 212
"/opt/projects/swiftkube/vendor/k8s.io/apiserver/pkg/admission/audit.go", "Go", 87, 0, 0, 0, 0, 0, 16, 103
"/opt/projects/swiftkube/vendor/k8s.io/apiserver/pkg/admission/cel/metrics.go", "Go", 106, 0, 0, 0, 0, 0, 18, 124
"/opt/projects/swiftkube/vendor/k8s.io/apiserver/pkg/admission/chain.go", "Go", 60, 0, 0, 0, 0, 0, 11, 71
"/opt/projects/swiftkube/vendor/k8s.io/apiserver/pkg/admission/config.go", "Go", 161, 0, 0, 0, 0, 0, 15, 176
"/opt/projects/swiftkube/vendor/k8s.io/apiserver/pkg/admission/configuration/configuration_manager.go", "Go", 148, 0, 0, 0, 0, 0, 19, 167
"/opt/projects/swiftkube/vendor/k8s.io/apiserver/pkg/admission/configuration/mutating_webhook_manager.go", "Go", 137, 0, 0, 0, 0, 0, 21, 158
"/opt/projects/swiftkube/vendor/k8s.io/apiserver/pkg/admission/configuration/validating_webhook_manager.go", "Go", 134, 0, 0, 0, 0, 0, 22, 156
"/opt/projects/swiftkube/vendor/k8s.io/apiserver/pkg/admission/conversion.go", "Go", 121, 0, 0, 0, 0, 0, 16, 137
"/opt/projects/swiftkube/vendor/k8s.io/apiserver/pkg/admission/decorator.go", "Go", 29, 0, 0, 0, 0, 0, 11, 40
"/opt/projects/swiftkube/vendor/k8s.io/apiserver/pkg/admission/errors.go", "Go", 61, 0, 0, 0, 0, 0, 12, 73
"/opt/projects/swiftkube/vendor/k8s.io/apiserver/pkg/admission/handler.go", "Go", 65, 0, 0, 0, 0, 0, 15, 80
"/opt/projects/swiftkube/vendor/k8s.io/apiserver/pkg/admission/initializer/initializer.go", "Go", 74, 0, 0, 0, 0, 0, 15, 89
"/opt/projects/swiftkube/vendor/k8s.io/apiserver/pkg/admission/initializer/interfaces.go", "Go", 77, 0, 0, 0, 0, 0, 15, 92
"/opt/projects/swiftkube/vendor/k8s.io/apiserver/pkg/admission/interfaces.go", "Go", 148, 0, 0, 0, 0, 0, 25, 173
"/opt/projects/swiftkube/vendor/k8s.io/apiserver/pkg/admission/metrics/metrics.go", "Go", 308, 0, 0, 0, 0, 0, 49, 357
"/opt/projects/swiftkube/vendor/k8s.io/apiserver/pkg/admission/plugin/cel/compile.go", "Go", 237, 0, 0, 0, 0, 0, 24, 261
"/opt/projects/swiftkube/vendor/k8s.io/apiserver/pkg/admission/plugin/cel/composition.go", "Go", 166, 0, 0, 0, 0, 0, 33, 199
"/opt/projects/swiftkube/vendor/k8s.io/apiserver/pkg/admission/plugin/cel/filter.go", "Go", 325, 0, 0, 0, 0, 0, 33, 358
"/opt/projects/swiftkube/vendor/k8s.io/apiserver/pkg/admission/plugin/cel/interface.go", "Go", 79, 0, 0, 0, 0, 0, 17, 96
"/opt/projects/swiftkube/vendor/k8s.io/apiserver/pkg/admission/plugin/namespace/lifecycle/admission.go", "Go", 200, 0, 0, 0, 0, 0, 34, 234
"/opt/projects/swiftkube/vendor/k8s.io/apiserver/pkg/admission/plugin/validatingadmissionpolicy/admission.go", "Go", 165, 0, 0, 0, 0, 0, 33, 198
"/opt/projects/swiftkube/vendor/k8s.io/apiserver/pkg/admission/plugin/validatingadmissionpolicy/caching_authorizer.go", "Go", 112, 0, 0, 0, 0, 0, 22, 134
"/opt/projects/swiftkube/vendor/k8s.io/apiserver/pkg/admission/plugin/validatingadmissionpolicy/controller.go", "Go", 571, 0, 0, 0, 0, 0, 79, 650
"/opt/projects/swiftkube/vendor/k8s.io/apiserver/pkg/admission/plugin/validatingadmissionpolicy/controller_reconcile.go", "Go", 472, 0, 0, 0, 0, 0, 79, 551
"/opt/projects/swiftkube/vendor/k8s.io/apiserver/pkg/admission/plugin/validatingadmissionpolicy/initializer.go", "Go", 23, 0, 0, 0, 0, 0, 9, 32
"/opt/projects/swiftkube/vendor/k8s.io/apiserver/pkg/admission/plugin/validatingadmissionpolicy/interface.go", "Go", 89, 0, 0, 0, 0, 0, 25, 114
"/opt/projects/swiftkube/vendor/k8s.io/apiserver/pkg/admission/plugin/validatingadmissionpolicy/internal/generic/controller.go", "Go", 244, 0, 0, 0, 0, 0, 50, 294
"/opt/projects/swiftkube/vendor/k8s.io/apiserver/pkg/admission/plugin/validatingadmissionpolicy/internal/generic/doc.go", "Go", 25, 0, 0, 0, 0, 0, 5, 30
"/opt/projects/swiftkube/vendor/k8s.io/apiserver/pkg/admission/plugin/validatingadmissionpolicy/internal/generic/informer.go", "Go", 28, 0, 0, 0, 0, 0, 9, 37
"/opt/projects/swiftkube/vendor/k8s.io/apiserver/pkg/admission/plugin/validatingadmissionpolicy/internal/generic/interface.go", "Go", 50, 0, 0, 0, 0, 0, 13, 63
"/opt/projects/swiftkube/vendor/k8s.io/apiserver/pkg/admission/plugin/validatingadmissionpolicy/internal/generic/lister.go", "Go", 83, 0, 0, 0, 0, 0, 18, 101
"/opt/projects/swiftkube/vendor/k8s.io/apiserver/pkg/admission/plugin/validatingadmissionpolicy/matcher.go", "Go", 67, 0, 0, 0, 0, 0, 17, 84
"/opt/projects/swiftkube/vendor/k8s.io/apiserver/pkg/admission/plugin/validatingadmissionpolicy/matching/matching.go", "Go", 175, 0, 0, 0, 0, 0, 27, 202
"/opt/projects/swiftkube/vendor/k8s.io/apiserver/pkg/admission/plugin/validatingadmissionpolicy/message.go", "Go", 27, 0, 0, 0, 0, 0, 10, 37
"/opt/projects/swiftkube/vendor/k8s.io/apiserver/pkg/admission/plugin/validatingadmissionpolicy/policy_decision.go", "Go", 72, 0, 0, 0, 0, 0, 16, 88
"/opt/projects/swiftkube/vendor/k8s.io/apiserver/pkg/admission/plugin/validatingadmissionpolicy/typechecking.go", "Go", 365, 0, 0, 0, 0, 0, 43, 408
"/opt/projects/swiftkube/vendor/k8s.io/apiserver/pkg/admission/plugin/validatingadmissionpolicy/validator.go", "Go", 231, 0, 0, 0, 0, 0, 21, 252
"/opt/projects/swiftkube/vendor/k8s.io/apiserver/pkg/admission/plugin/webhook/accessors.go", "Go", 308, 0, 0, 0, 0, 0, 69, 377
"/opt/projects/swiftkube/vendor/k8s.io/apiserver/pkg/admission/plugin/webhook/config/apis/webhookadmission/doc.go", "Go", 14, 0, 0, 0, 0, 0, 6, 20
"/opt/projects/swiftkube/vendor/k8s.io/apiserver/pkg/admission/plugin/webhook/config/apis/webhookadmission/register.go", "Go", 42, 0, 0, 0, 0, 0, 12, 54
"/opt/projects/swiftkube/vendor/k8s.io/apiserver/pkg/admission/plugin/webhook/config/apis/webhookadmission/types.go", "Go", 21, 0, 0, 0, 0, 0, 9, 30
"/opt/projects/swiftkube/vendor/k8s.io/apiserver/pkg/admission/plugin/webhook/config/apis/webhookadmission/v1/doc.go", "Go", 18, 0, 0, 0, 0, 0, 6, 24
"/opt/projects/swiftkube/vendor/k8s.io/apiserver/pkg/admission/plugin/webhook/config/apis/webhookadmission/v1/register.go", "Go", 40, 0, 0, 0, 0, 0, 11, 51
"/opt/projects/swiftkube/vendor/k8s.io/apiserver/pkg/admission/plugin/webhook/config/apis/webhookadmission/v1/types.go", "Go", 21, 0, 0, 0, 0, 0, 9, 30
"/opt/projects/swiftkube/vendor/k8s.io/apiserver/pkg/admission/plugin/webhook/config/apis/webhookadmission/v1/zz_generated.conversion.go", "Go", 55, 0, 0, 0, 0, 0, 14, 69
"/opt/projects/swiftkube/vendor/k8s.io/apiserver/pkg/admission/plugin/webhook/config/apis/webhookadmission/v1/zz_generated.deepcopy.go", "Go", 41, 0, 0, 0, 0, 0, 11, 52
"/opt/projects/swiftkube/vendor/k8s.io/apiserver/pkg/admission/plugin/webhook/config/apis/webhookadmission/v1/zz_generated.defaults.go", "Go", 25, 0, 0, 0, 0, 0, 9, 34
"/opt/projects/swiftkube/vendor/k8s.io/apiserver/pkg/admission/plugin/webhook/config/apis/webhookadmission/v1alpha1/doc.go", "Go", 18, 0, 0, 0, 0, 0, 6, 24
"/opt/projects/swiftkube/vendor/k8s.io/apiserver/pkg/admission/plugin/webhook/config/apis/webhookadmission/v1alpha1/register.go", "Go", 40, 0, 0, 0, 0, 0, 11, 51
"/opt/projects/swiftkube/vendor/k8s.io/apiserver/pkg/admission/plugin/webhook/config/apis/webhookadmission/v1alpha1/types.go", "Go", 21, 0, 0, 0, 0, 0, 9, 30
"/opt/projects/swiftkube/vendor/k8s.io/apiserver/pkg/admission/plugin/webhook/config/apis/webhookadmission/v1alpha1/zz_generated.conversion.go", "Go", 55, 0, 0, 0, 0, 0, 14, 69
"/opt/projects/swiftkube/vendor/k8s.io/apiserver/pkg/admission/plugin/webhook/config/apis/webhookadmission/v1alpha1/zz_generated.deepcopy.go", "Go", 41, 0, 0, 0, 0, 0, 11, 52
"/opt/projects/swiftkube/vendor/k8s.io/apiserver/pkg/admission/plugin/webhook/config/apis/webhookadmission/v1alpha1/zz_generated.defaults.go", "Go", 25, 0, 0, 0, 0, 0, 9, 34
"/opt/projects/swiftkube/vendor/k8s.io/apiserver/pkg/admission/plugin/webhook/config/apis/webhookadmission/zz_generated.deepcopy.go", "Go", 41, 0, 0, 0, 0, 0, 11, 52
"/opt/projects/swiftkube/vendor/k8s.io/apiserver/pkg/admission/plugin/webhook/config/kubeconfig.go", "Go", 60, 0, 0, 0, 0, 0, 12, 72
"/opt/projects/swiftkube/vendor/k8s.io/apiserver/pkg/admission/plugin/webhook/errors/doc.go", "Go", 14, 0, 0, 0, 0, 0, 5, 19
"/opt/projects/swiftkube/vendor/k8s.io/apiserver/pkg/admission/plugin/webhook/errors/statuserror.go", "Go", 51, 0, 0, 0, 0, 0, 13, 64
"/opt/projects/swiftkube/vendor/k8s.io/apiserver/pkg/admission/plugin/webhook/generic/interfaces.go", "Go", 43, 0, 0, 0, 0, 0, 11, 54
"/opt/projects/swiftkube/vendor/k8s.io/apiserver/pkg/admission/plugin/webhook/generic/webhook.go", "Go", 231, 0, 0, 0, 0, 0, 32, 263
"/opt/projects/swiftkube/vendor/k8s.io/apiserver/pkg/admission/plugin/webhook/matchconditions/interface.go", "Go", 29, 0, 0, 0, 0, 0, 9, 38
"/opt/projects/swiftkube/vendor/k8s.io/apiserver/pkg/admission/plugin/webhook/matchconditions/matcher.go", "Go", 127, 0, 0, 0, 0, 0, 18, 145
"/opt/projects/swiftkube/vendor/k8s.io/apiserver/pkg/admission/plugin/webhook/mutating/dispatcher.go", "Go", 445, 0, 0, 0, 0, 0, 52, 497
"/opt/projects/swiftkube/vendor/k8s.io/apiserver/pkg/admission/plugin/webhook/mutating/doc.go", "Go", 15, 0, 0, 0, 0, 0, 5, 20
"/opt/projects/swiftkube/vendor/k8s.io/apiserver/pkg/admission/plugin/webhook/mutating/plugin.go", "Go", 61, 0, 0, 0, 0, 0, 16, 77
"/opt/projects/swiftkube/vendor/k8s.io/apiserver/pkg/admission/plugin/webhook/mutating/reinvocationcontext.go", "Go", 57, 0, 0, 0, 0, 0, 12, 69
"/opt/projects/swiftkube/vendor/k8s.io/apiserver/pkg/admission/plugin/webhook/predicates/namespace/doc.go", "Go", 16, 0, 0, 0, 0, 0, 5, 21
"/opt/projects/swiftkube/vendor/k8s.io/apiserver/pkg/admission/plugin/webhook/predicates/namespace/matcher.go", "Go", 116, 0, 0, 0, 0, 0, 16, 132
"/opt/projects/swiftkube/vendor/k8s.io/apiserver/pkg/admission/plugin/webhook/predicates/object/doc.go", "Go", 16, 0, 0, 0, 0, 0, 5, 21
"/opt/projects/swiftkube/vendor/k8s.io/apiserver/pkg/admission/plugin/webhook/predicates/object/matcher.go", "Go", 51, 0, 0, 0, 0, 0, 11, 62
"/opt/projects/swiftkube/vendor/k8s.io/apiserver/pkg/admission/plugin/webhook/predicates/rules/rules.go", "Go", 111, 0, 0, 0, 0, 0, 19, 130
"/opt/projects/swiftkube/vendor/k8s.io/apiserver/pkg/admission/plugin/webhook/request/admissionreview.go", "Go", 257, 0, 0, 0, 0, 0, 28, 285
"/opt/projects/swiftkube/vendor/k8s.io/apiserver/pkg/admission/plugin/webhook/request/doc.go", "Go", 14, 0, 0, 0, 0, 0, 5, 19
"/opt/projects/swiftkube/vendor/k8s.io/apiserver/pkg/admission/plugin/webhook/validating/dispatcher.go", "Go", 301, 0, 0, 0, 0, 0, 33, 334
"/opt/projects/swiftkube/vendor/k8s.io/apiserver/pkg/admission/plugin/webhook/validating/doc.go", "Go", 15, 0, 0, 0, 0, 0, 5, 20
"/opt/projects/swiftkube/vendor/k8s.io/apiserver/pkg/admission/plugin/webhook/validating/plugin.go", "Go", 54, 0, 0, 0, 0, 0, 14, 68
"/opt/projects/swiftkube/vendor/k8s.io/apiserver/pkg/admission/plugins.go", "Go", 178, 0, 0, 0, 0, 0, 31, 209
"/opt/projects/swiftkube/vendor/k8s.io/apiserver/pkg/admission/reinvocation.go", "Go", 54, 0, 0, 0, 0, 0, 11, 65
"/opt/projects/swiftkube/vendor/k8s.io/apiserver/pkg/admission/util.go", "Go", 39, 0, 0, 0, 0, 0, 9, 48
"/opt/projects/swiftkube/vendor/k8s.io/apiserver/pkg/apis/apiserver/doc.go", "Go", 16, 0, 0, 0, 0, 0, 6, 22
"/opt/projects/swiftkube/vendor/k8s.io/apiserver/pkg/apis/apiserver/install/install.go", "Go", 34, 0, 0, 0, 0, 0, 10, 44
"/opt/projects/swiftkube/vendor/k8s.io/apiserver/pkg/apis/apiserver/register.go", "Go", 40, 0, 0, 0, 0, 0, 11, 51
"/opt/projects/swiftkube/vendor/k8s.io/apiserver/pkg/apis/apiserver/types.go", "Go", 128, 0, 0, 0, 0, 0, 32, 160
"/opt/projects/swiftkube/vendor/k8s.io/apiserver/pkg/apis/apiserver/v1/doc.go", "Go", 18, 0, 0, 0, 0, 0, 6, 24
"/opt/projects/swiftkube/vendor/k8s.io/apiserver/pkg/apis/apiserver/v1/register.go", "Go", 42, 0, 0, 0, 0, 0, 11, 53
"/opt/projects/swiftkube/vendor/k8s.io/apiserver/pkg/apis/apiserver/v1/types.go", "Go", 39, 0, 0, 0, 0, 0, 12, 51
"/opt/projects/swiftkube/vendor/k8s.io/apiserver/pkg/apis/apiserver/v1/zz_generated.conversion.go", "Go", 86, 0, 0, 0, 0, 0, 19, 105
"/opt/projects/swiftkube/vendor/k8s.io/apiserver/pkg/apis/apiserver/v1/zz_generated.deepcopy.go", "Go", 67, 0, 0, 0, 0, 0, 13, 80
"/opt/projects/swiftkube/vendor/k8s.io/apiserver/pkg/apis/apiserver/v1/zz_generated.defaults.go", "Go", 25, 0, 0, 0, 0, 0, 9, 34
"/opt/projects/swiftkube/vendor/k8s.io/apiserver/pkg/apis/apiserver/v1alpha1/conversion.go", "Go", 26, 0, 0, 0, 0, 0, 7, 33
"/opt/projects/swiftkube/vendor/k8s.io/apiserver/pkg/apis/apiserver/v1alpha1/doc.go", "Go", 19, 0, 0, 0, 0, 0, 6, 25
"/opt/projects/swiftkube/vendor/k8s.io/apiserver/pkg/apis/apiserver/v1alpha1/register.go", "Go", 50, 0, 0, 0, 0, 0, 12, 62
"/opt/projects/swiftkube/vendor/k8s.io/apiserver/pkg/apis/apiserver/v1alpha1/types.go", "Go", 129, 0, 0, 0, 0, 0, 32, 161
"/opt/projects/swiftkube/vendor/k8s.io/apiserver/pkg/apis/apiserver/v1alpha1/zz_generated.conversion.go", "Go", 326, 0, 0, 0, 0, 0, 50, 376
"/opt/projects/swiftkube/vendor/k8s.io/apiserver/pkg/apis/apiserver/v1alpha1/zz_generated.deepcopy.go", "Go", 224, 0, 0, 0, 0, 0, 31, 255
"/opt/projects/swiftkube/vendor/k8s.io/apiserver/pkg/apis/apiserver/v1alpha1/zz_generated.defaults.go", "Go", 25, 0, 0, 0, 0, 0, 9, 34
"/opt/projects/swiftkube/vendor/k8s.io/apiserver/pkg/apis/apiserver/v1beta1/conversion.go", "Go", 26, 0, 0, 0, 0, 0, 7, 33
"/opt/projects/swiftkube/vendor/k8s.io/apiserver/pkg/apis/apiserver/v1beta1/doc.go", "Go", 18, 0, 0, 0, 0, 0, 6, 24
"/opt/projects/swiftkube/vendor/k8s.io/apiserver/pkg/apis/apiserver/v1beta1/register.go", "Go", 48, 0, 0, 0, 0, 0, 12, 60
"/opt/projects/swiftkube/vendor/k8s.io/apiserver/pkg/apis/apiserver/v1beta1/types.go", "Go", 106, 0, 0, 0, 0, 0, 26, 132
"/opt/projects/swiftkube/vendor/k8s.io/apiserver/pkg/apis/apiserver/v1beta1/zz_generated.conversion.go", "Go", 270, 0, 0, 0, 0, 0, 42, 312
"/opt/projects/swiftkube/vendor/k8s.io/apiserver/pkg/apis/apiserver/v1beta1/zz_generated.deepcopy.go", "Go", 176, 0, 0, 0, 0, 0, 26, 202
"/opt/projects/swiftkube/vendor/k8s.io/apiserver/pkg/apis/apiserver/v1beta1/zz_generated.defaults.go", "Go", 25, 0, 0, 0, 0, 0, 9, 34
"/opt/projects/swiftkube/vendor/k8s.io/apiserver/pkg/apis/apiserver/zz_generated.deepcopy.go", "Go", 224, 0, 0, 0, 0, 0, 31, 255
"/opt/projects/swiftkube/vendor/k8s.io/apiserver/pkg/apis/audit/doc.go", "Go", 15, 0, 0, 0, 0, 0, 6, 21
"/opt/projects/swiftkube/vendor/k8s.io/apiserver/pkg/apis/audit/helpers.go", "Go", 31, 0, 0, 0, 0, 0, 8, 39
"/opt/projects/swiftkube/vendor/k8s.io/apiserver/pkg/apis/audit/install/install.go", "Go", 27, 0, 0, 0, 0, 0, 7, 34
"/opt/projects/swiftkube/vendor/k8s.io/apiserver/pkg/apis/audit/register.go", "Go", 42, 0, 0, 0, 0, 0, 12, 54
"/opt/projects/swiftkube/vendor/k8s.io/apiserver/pkg/apis/audit/types.go", "Go", 273, 0, 0, 0, 0, 0, 40, 313
"/opt/projects/swiftkube/vendor/k8s.io/apiserver/pkg/apis/audit/v1/doc.go", "Go", 19, 0, 0, 0, 0, 0, 7, 26
"/opt/projects/swiftkube/vendor/k8s.io/apiserver/pkg/apis/audit/v1/generated.pb.go", "Go", 3165, 0, 0, 0, 0, 0, 67, 3232
"/opt/projects/swiftkube/vendor/k8s.io/apiserver/pkg/apis/audit/v1/generated.proto", "Protocol Buffers", 0, 0, 77, 0, 0, 144, 55, 276
"/opt/projects/swiftkube/vendor/k8s.io/apiserver/pkg/apis/audit/v1/register.go", "Go", 47, 0, 0, 0, 0, 0, 12, 59
"/opt/projects/swiftkube/vendor/k8s.io/apiserver/pkg/apis/audit/v1/types.go", "Go", 268, 0, 0, 0, 0, 0, 39, 307
"/opt/projects/swiftkube/vendor/k8s.io/apiserver/pkg/apis/audit/v1/zz_generated.conversion.go", "Go", 289, 0, 0, 0, 0, 0, 39, 328
"/opt/projects/swiftkube/vendor/k8s.io/apiserver/pkg/apis/audit/v1/zz_generated.deepcopy.go", "Go", 272, 0, 0, 0, 0, 0, 26, 298
"/opt/projects/swiftkube/vendor/k8s.io/apiserver/pkg/apis/audit/v1/zz_generated.defaults.go", "Go", 25, 0, 0, 0, 0, 0, 9, 34
"/opt/projects/swiftkube/vendor/k8s.io/apiserver/pkg/apis/audit/validation/validation.go", "Go", 114, 0, 0, 0, 0, 0, 20, 134
"/opt/projects/swiftkube/vendor/k8s.io/apiserver/pkg/apis/audit/zz_generated.deepcopy.go", "Go", 272, 0, 0, 0, 0, 0, 26, 298
"/opt/projects/swiftkube/vendor/k8s.io/apiserver/pkg/apis/cel/config.go", "Go", 35, 0, 0, 0, 0, 0, 11, 46
"/opt/projects/swiftkube/vendor/k8s.io/apiserver/pkg/apis/config/doc.go", "Go", 14, 0, 0, 0, 0, 0, 6, 20
"/opt/projects/swiftkube/vendor/k8s.io/apiserver/pkg/apis/config/register.go", "Go", 42, 0, 0, 0, 0, 0, 12, 54
"/opt/projects/swiftkube/vendor/k8s.io/apiserver/pkg/apis/config/types.go", "Go", 131, 0, 0, 0, 0, 0, 19, 150
"/opt/projects/swiftkube/vendor/k8s.io/apiserver/pkg/apis/config/v1/defaults.go", "Go", 39, 0, 0, 0, 0, 0, 12, 51
"/opt/projects/swiftkube/vendor/k8s.io/apiserver/pkg/apis/config/v1/doc.go", "Go", 18, 0, 0, 0, 0, 0, 6, 24
"/opt/projects/swiftkube/vendor/k8s.io/apiserver/pkg/apis/config/v1/register.go", "Go", 43, 0, 0, 0, 0, 0, 11, 54
"/opt/projects/swiftkube/vendor/k8s.io/apiserver/pkg/apis/config/v1/types.go", "Go", 131, 0, 0, 0, 0, 0, 19, 150
"/opt/projects/swiftkube/vendor/k8s.io/apiserver/pkg/apis/config/v1/zz_generated.conversion.go", "Go", 257, 0, 0, 0, 0, 0, 43, 300
"/opt/projects/swiftkube/vendor/k8s.io/apiserver/pkg/apis/config/v1/zz_generated.deepcopy.go", "Go", 204, 0, 0, 0, 0, 0, 25, 229
"/opt/projects/swiftkube/vendor/k8s.io/apiserver/pkg/apis/config/v1/zz_generated.defaults.go", "Go", 37, 0, 0, 0, 0, 0, 10, 47
"/opt/projects/swiftkube/vendor/k8s.io/apiserver/pkg/apis/config/validation/validation.go", "Go", 375, 0, 0, 0, 0, 0, 78, 453
"/opt/projects/swiftkube/vendor/k8s.io/apiserver/pkg/apis/config/zz_generated.deepcopy.go", "Go", 204, 0, 0, 0, 0, 0, 25, 229
"/opt/projects/swiftkube/vendor/k8s.io/apiserver/pkg/apis/flowcontrol/bootstrap/default.go", "Go", 558, 0, 0, 0, 0, 0, 20, 578
"/opt/projects/swiftkube/vendor/k8s.io/apiserver/pkg/audit/context.go", "Go", 156, 0, 0, 0, 0, 0, 33, 189
"/opt/projects/swiftkube/vendor/k8s.io/apiserver/pkg/audit/evaluator.go", "Go", 36, 0, 0, 0, 0, 0, 10, 46
"/opt/projects/swiftkube/vendor/k8s.io/apiserver/pkg/audit/format.go", "Go", 61, 0, 0, 0, 0, 0, 13, 74
"/opt/projects/swiftkube/vendor/k8s.io/apiserver/pkg/audit/metrics.go", "Go", 97, 0, 0, 0, 0, 0, 15, 112
"/opt/projects/swiftkube/vendor/k8s.io/apiserver/pkg/audit/policy/checker.go", "Go", 208, 0, 0, 0, 0, 0, 32, 240
"/opt/projects/swiftkube/vendor/k8s.io/apiserver/pkg/audit/policy/reader.go", "Go", 84, 0, 0, 0, 0, 0, 18, 102
"/opt/projects/swiftkube/vendor/k8s.io/apiserver/pkg/audit/policy/util.go", "Go", 58, 0, 0, 0, 0, 0, 11, 69
"/opt/projects/swiftkube/vendor/k8s.io/apiserver/pkg/audit/request.go", "Go", 273, 0, 0, 0, 0, 0, 40, 313
"/opt/projects/swiftkube/vendor/k8s.io/apiserver/pkg/audit/scheme.go", "Go", 31, 0, 0, 0, 0, 0, 8, 39
"/opt/projects/swiftkube/vendor/k8s.io/apiserver/pkg/audit/types.go", "Go", 36, 0, 0, 0, 0, 0, 11, 47
"/opt/projects/swiftkube/vendor/k8s.io/apiserver/pkg/audit/union.go", "Go", 59, 0, 0, 0, 0, 0, 13, 72
"/opt/projects/swiftkube/vendor/k8s.io/apiserver/pkg/authentication/authenticator/audagnostic.go", "Go", 76, 0, 0, 0, 0, 0, 15, 91
"/opt/projects/swiftkube/vendor/k8s.io/apiserver/pkg/authentication/authenticator/audiences.go", "Go", 51, 0, 0, 0, 0, 0, 13, 64
"/opt/projects/swiftkube/vendor/k8s.io/apiserver/pkg/authentication/authenticator/interfaces.go", "Go", 52, 0, 0, 0, 0, 0, 14, 66
"/opt/projects/swiftkube/vendor/k8s.io/apiserver/pkg/authentication/authenticatorfactory/delegating.go", "Go", 105, 0, 0, 0, 0, 0, 22, 127
"/opt/projects/swiftkube/vendor/k8s.io/apiserver/pkg/authentication/authenticatorfactory/loopback.go", "Go", 23, 0, 0, 0, 0, 0, 7, 30
"/opt/projects/swiftkube/vendor/k8s.io/apiserver/pkg/authentication/authenticatorfactory/metrics.go", "Go", 56, 0, 0, 0, 0, 0, 14, 70
"/opt/projects/swiftkube/vendor/k8s.io/apiserver/pkg/authentication/authenticatorfactory/requestheader.go", "Go", 31, 0, 0, 0, 0, 0, 7, 38
"/opt/projects/swiftkube/vendor/k8s.io/apiserver/pkg/authentication/group/authenticated_group_adder.go", "Go", 54, 0, 0, 0, 0, 0, 13, 67
"/opt/projects/swiftkube/vendor/k8s.io/apiserver/pkg/authentication/group/group_adder.go", "Go", 46, 0, 0, 0, 0, 0, 12, 58
"/opt/projects/swiftkube/vendor/k8s.io/apiserver/pkg/authentication/group/token_group_adder.go", "Go", 46, 0, 0, 0, 0, 0, 12, 58
"/opt/projects/swiftkube/vendor/k8s.io/apiserver/pkg/authentication/request/anonymous/anonymous.go", "Go", 34, 0, 0, 0, 0, 0, 10, 44
"/opt/projects/swiftkube/vendor/k8s.io/apiserver/pkg/authentication/request/bearertoken/bearertoken.go", "Go", 60, 0, 0, 0, 0, 0, 17, 77
"/opt/projects/swiftkube/vendor/k8s.io/apiserver/pkg/authentication/request/headerrequest/requestheader.go", "Go", 211, 0, 0, 0, 0, 0, 39, 250
"/opt/projects/swiftkube/vendor/k8s.io/apiserver/pkg/authentication/request/headerrequest/requestheader_controller.go", "Go", 280, 0, 0, 0, 0, 0, 58, 338
"/opt/projects/swiftkube/vendor/k8s.io/apiserver/pkg/authentication/request/union/union.go", "Go", 59, 0, 0, 0, 0, 0, 13, 72
"/opt/projects/swiftkube/vendor/k8s.io/apiserver/pkg/authentication/request/websocket/protocol.go", "Go", 86, 0, 0, 0, 0, 0, 23, 109
"/opt/projects/swiftkube/vendor/k8s.io/apiserver/pkg/authentication/request/x509/doc.go", "Go", 15, 0, 0, 0, 0, 0, 5, 20
"/opt/projects/swiftkube/vendor/k8s.io/apiserver/pkg/authentication/request/x509/verify_options.go", "Go", 56, 0, 0, 0, 0, 0, 16, 72
"/opt/projects/swiftkube/vendor/k8s.io/apiserver/pkg/authentication/request/x509/x509.go", "Go", 226, 0, 0, 0, 0, 0, 33, 259
"/opt/projects/swiftkube/vendor/k8s.io/apiserver/pkg/authentication/serviceaccount/util.go", "Go", 157, 0, 0, 0, 0, 0, 27, 184
"/opt/projects/swiftkube/vendor/k8s.io/apiserver/pkg/authentication/token/cache/cache_simple.go", "Go", 38, 0, 0, 0, 0, 0, 12, 50
"/opt/projects/swiftkube/vendor/k8s.io/apiserver/pkg/authentication/token/cache/cache_striped.go", "Go", 50, 0, 0, 0, 0, 0, 11, 61
"/opt/projects/swiftkube/vendor/k8s.io/apiserver/pkg/authentication/token/cache/cached_token_authenticator.go", "Go", 266, 0, 0, 0, 0, 0, 53, 319
"/opt/projects/swiftkube/vendor/k8s.io/apiserver/pkg/authentication/token/cache/stats.go", "Go", 106, 0, 0, 0, 0, 0, 21, 127
"/opt/projects/swiftkube/vendor/k8s.io/apiserver/pkg/authentication/token/tokenfile/tokenfile.go", "Go", 84, 0, 0, 0, 0, 0, 16, 100
"/opt/projects/swiftkube/vendor/k8s.io/apiserver/pkg/authentication/user/doc.go", "Go", 15, 0, 0, 0, 0, 0, 5, 20
"/opt/projects/swiftkube/vendor/k8s.io/apiserver/pkg/authentication/user/user.go", "Go", 70, 0, 0, 0, 0, 0, 15, 85
"/opt/projects/swiftkube/vendor/k8s.io/apiserver/pkg/authorization/authorizer/interfaces.go", "Go", 123, 0, 0, 0, 0, 0, 37, 160
"/opt/projects/swiftkube/vendor/k8s.io/apiserver/pkg/authorization/authorizer/rule.go", "Go", 59, 0, 0, 0, 0, 0, 15, 74
"/opt/projects/swiftkube/vendor/k8s.io/apiserver/pkg/authorization/authorizerfactory/builtin.go", "Go", 78, 0, 0, 0, 0, 0, 18, 96
"/opt/projects/swiftkube/vendor/k8s.io/apiserver/pkg/authorization/authorizerfactory/delegating.go", "Go", 50, 0, 0, 0, 0, 0, 13, 63
"/opt/projects/swiftkube/vendor/k8s.io/apiserver/pkg/authorization/authorizerfactory/metrics.go", "Go", 56, 0, 0, 0, 0, 0, 14, 70
"/opt/projects/swiftkube/vendor/k8s.io/apiserver/pkg/authorization/path/doc.go", "Go", 14, 0, 0, 0, 0, 0, 5, 19
"/opt/projects/swiftkube/vendor/k8s.io/apiserver/pkg/authorization/path/path.go", "Go", 57, 0, 0, 0, 0, 0, 12, 69
"/opt/projects/swiftkube/vendor/k8s.io/apiserver/pkg/authorization/union/union.go", "Go", 88, 0, 0, 0, 0, 0, 19, 107
"/opt/projects/swiftkube/vendor/k8s.io/apiserver/pkg/cel/common/adaptor.go", "Go", 66, 0, 0, 0, 0, 0, 16, 82
"/opt/projects/swiftkube/vendor/k8s.io/apiserver/pkg/cel/common/maplist.go", "Go", 152, 0, 0, 0, 0, 0, 26, 178
"/opt/projects/swiftkube/vendor/k8s.io/apiserver/pkg/cel/common/schemas.go", "Go", 236, 0, 0, 0, 0, 0, 22, 258
"/opt/projects/swiftkube/vendor/k8s.io/apiserver/pkg/cel/common/values.go", "Go", 650, 0, 0, 0, 0, 0, 68, 718
"/opt/projects/swiftkube/vendor/k8s.io/apiserver/pkg/cel/environment/base.go", "Go", 106, 0, 0, 0, 0, 0, 14, 120
"/opt/projects/swiftkube/vendor/k8s.io/apiserver/pkg/cel/environment/environment.go", "Go", 246, 0, 0, 0, 0, 0, 29, 275
"/opt/projects/swiftkube/vendor/k8s.io/apiserver/pkg/cel/errors.go", "Go", 38, 0, 0, 0, 0, 0, 10, 48
"/opt/projects/swiftkube/vendor/k8s.io/apiserver/pkg/cel/escaping.go", "Go", 150, 0, 0, 0, 0, 0, 21, 171
"/opt/projects/swiftkube/vendor/k8s.io/apiserver/pkg/cel/lazy/lazy.go", "Go", 158, 0, 0, 0, 0, 0, 34, 192
"/opt/projects/swiftkube/vendor/k8s.io/apiserver/pkg/cel/library/authz.go", "Go", 547, 0, 0, 0, 0, 0, 76, 623
"/opt/projects/swiftkube/vendor/k8s.io/apiserver/pkg/cel/library/cost.go", "Go", 296, 0, 0, 0, 0, 0, 26, 322
"/opt/projects/swiftkube/vendor/k8s.io/apiserver/pkg/cel/library/lists.go", "Go", 288, 0, 0, 0, 0, 0, 25, 313
"/opt/projects/swiftkube/vendor/k8s.io/apiserver/pkg/cel/library/quantity.go", "Go", 329, 0, 0, 0, 0, 0, 47, 376
"/opt/projects/swiftkube/vendor/k8s.io/apiserver/pkg/cel/library/regex.go", "Go", 169, 0, 0, 0, 0, 0, 21, 190
"/opt/projects/swiftkube/vendor/k8s.io/apiserver/pkg/cel/library/test.go", "Go", 65, 0, 0, 0, 0, 0, 15, 80
"/opt/projects/swiftkube/vendor/k8s.io/apiserver/pkg/cel/library/urls.go", "Go", 214, 0, 0, 0, 0, 0, 23, 237
"/opt/projects/swiftkube/vendor/k8s.io/apiserver/pkg/cel/limits.go", "Go", 43, 0, 0, 0, 0, 0, 8, 51
"/opt/projects/swiftkube/vendor/k8s.io/apiserver/pkg/cel/openapi/adaptor.go", "Go", 115, 0, 0, 0, 0, 0, 33, 148
"/opt/projects/swiftkube/vendor/k8s.io/apiserver/pkg/cel/openapi/extensions.go", "Go", 49, 0, 0, 0, 0, 0, 14, 63
"/opt/projects/swiftkube/vendor/k8s.io/apiserver/pkg/cel/openapi/resolver/definitions.go", "Go", 105, 0, 0, 0, 0, 0, 11, 116
"/opt/projects/swiftkube/vendor/k8s.io/apiserver/pkg/cel/openapi/resolver/discovery.go", "Go", 90, 0, 0, 0, 0, 0, 15, 105
"/opt/projects/swiftkube/vendor/k8s.io/apiserver/pkg/cel/openapi/resolver/refs.go", "Go", 91, 0, 0, 0, 0, 0, 10, 101
"/opt/projects/swiftkube/vendor/k8s.io/apiserver/pkg/cel/openapi/resolver/resolver.go", "Go", 31, 0, 0, 0, 0, 0, 9, 40
"/opt/projects/swiftkube/vendor/k8s.io/apiserver/pkg/cel/quantity.go", "Go", 63, 0, 0, 0, 0, 0, 14, 77
"/opt/projects/swiftkube/vendor/k8s.io/apiserver/pkg/cel/types.go", "Go", 523, 0, 0, 0, 0, 0, 65, 588
"/opt/projects/swiftkube/vendor/k8s.io/apiserver/pkg/cel/url.go", "Go", 67, 0, 0, 0, 0, 0, 14, 81
"/opt/projects/swiftkube/vendor/k8s.io/apiserver/pkg/cel/value.go", "Go", 683, 0, 0, 0, 0, 0, 87, 770
"/opt/projects/swiftkube/vendor/k8s.io/apiserver/pkg/endpoints/deprecation/deprecation.go", "Go", 114, 0, 0, 0, 0, 0, 21, 135
"/opt/projects/swiftkube/vendor/k8s.io/apiserver/pkg/endpoints/discovery/addresses.go", "Go", 57, 0, 0, 0, 0, 0, 16, 73
"/opt/projects/swiftkube/vendor/k8s.io/apiserver/pkg/endpoints/discovery/aggregated/etag.go", "Go", 71, 0, 0, 0, 0, 0, 13, 84
"/opt/projects/swiftkube/vendor/k8s.io/apiserver/pkg/endpoints/discovery/aggregated/fake.go", "Go", 143, 0, 0, 0, 0, 0, 33, 176
"/opt/projects/swiftkube/vendor/k8s.io/apiserver/pkg/endpoints/discovery/aggregated/handler.go", "Go", 443, 0, 0, 0, 0, 0, 89, 532
"/opt/projects/swiftkube/vendor/k8s.io/apiserver/pkg/endpoints/discovery/aggregated/metrics.go", "Go", 29, 0, 0, 0, 0, 0, 8, 37
"/opt/projects/swiftkube/vendor/k8s.io/apiserver/pkg/endpoints/discovery/aggregated/negotiation.go", "Go", 33, 0, 0, 0, 0, 0, 13, 46
"/opt/projects/swiftkube/vendor/k8s.io/apiserver/pkg/endpoints/discovery/aggregated/wrapper.go", "Go", 65, 0, 0, 0, 0, 0, 14, 79
"/opt/projects/swiftkube/vendor/k8s.io/apiserver/pkg/endpoints/discovery/group.go", "Go", 60, 0, 0, 0, 0, 0, 14, 74
"/opt/projects/swiftkube/vendor/k8s.io/apiserver/pkg/endpoints/discovery/legacy.go", "Go", 66, 0, 0, 0, 0, 0, 15, 81
"/opt/projects/swiftkube/vendor/k8s.io/apiserver/pkg/endpoints/discovery/root.go", "Go", 111, 0, 0, 0, 0, 0, 25, 136
"/opt/projects/swiftkube/vendor/k8s.io/apiserver/pkg/endpoints/discovery/storageversionhash.go", "Go", 30, 0, 0, 0, 0, 0, 7, 37
"/opt/projects/swiftkube/vendor/k8s.io/apiserver/pkg/endpoints/discovery/util.go", "Go", 94, 0, 0, 0, 0, 0, 17, 111
"/opt/projects/swiftkube/vendor/k8s.io/apiserver/pkg/endpoints/discovery/version.go", "Go", 66, 0, 0, 0, 0, 0, 18, 84
"/opt/projects/swiftkube/vendor/k8s.io/apiserver/pkg/endpoints/doc.go", "Go", 14, 0, 0, 0, 0, 0, 5, 19
"/opt/projects/swiftkube/vendor/k8s.io/apiserver/pkg/endpoints/filterlatency/filterlatency.go", "Go", 90, 0, 0, 0, 0, 0, 22, 112
"/opt/projects/swiftkube/vendor/k8s.io/apiserver/pkg/endpoints/filters/audit.go", "Go", 227, 0, 0, 0, 0, 0, 37, 264
"/opt/projects/swiftkube/vendor/k8s.io/apiserver/pkg/endpoints/filters/audit_init.go", "Go", 52, 0, 0, 0, 0, 0, 14, 66
"/opt/projects/swiftkube/vendor/k8s.io/apiserver/pkg/endpoints/filters/authentication.go", "Go", 110, 0, 0, 0, 0, 0, 20, 130
"/opt/projects/swiftkube/vendor/k8s.io/apiserver/pkg/endpoints/filters/authn_audit.go", "Go", 71, 0, 0, 0, 0, 0, 17, 88
"/opt/projects/swiftkube/vendor/k8s.io/apiserver/pkg/endpoints/filters/authorization.go", "Go", 99, 0, 0, 0, 0, 0, 23, 122
"/opt/projects/swiftkube/vendor/k8s.io/apiserver/pkg/endpoints/filters/cachecontrol.go", "Go", 27, 0, 0, 0, 0, 0, 7, 34
"/opt/projects/swiftkube/vendor/k8s.io/apiserver/pkg/endpoints/filters/doc.go", "Go", 17, 0, 0, 0, 0, 0, 5, 22
"/opt/projects/swiftkube/vendor/k8s.io/apiserver/pkg/endpoints/filters/impersonation.go", "Go", 220, 0, 0, 0, 0, 0, 37, 257
"/opt/projects/swiftkube/vendor/k8s.io/apiserver/pkg/endpoints/filters/metrics.go", "Go", 139, 0, 0, 0, 0, 0, 23, 162
"/opt/projects/swiftkube/vendor/k8s.io/apiserver/pkg/endpoints/filters/mux_discovery_complete.go", "Go", 54, 0, 0, 0, 0, 0, 11, 65
"/opt/projects/swiftkube/vendor/k8s.io/apiserver/pkg/endpoints/filters/request_deadline.go", "Go", 146, 0, 0, 0, 0, 0, 28, 174
"/opt/projects/swiftkube/vendor/k8s.io/apiserver/pkg/endpoints/filters/request_received_time.go", "Go", 31, 0, 0, 0, 0, 0, 10, 41
"/opt/projects/swiftkube/vendor/k8s.io/apiserver/pkg/endpoints/filters/requestinfo.go", "Go", 32, 0, 0, 0, 0, 0, 10, 42
"/opt/projects/swiftkube/vendor/k8s.io/apiserver/pkg/endpoints/filters/storageversion.go", "Go", 112, 0, 0, 0, 0, 0, 10, 122
"/opt/projects/swiftkube/vendor/k8s.io/apiserver/pkg/endpoints/filters/traces.go", "Go", 30, 0, 0, 0, 0, 0, 9, 39
"/opt/projects/swiftkube/vendor/k8s.io/apiserver/pkg/endpoints/filters/warning.go", "Go", 108, 0, 0, 0, 0, 0, 26, 134
"/opt/projects/swiftkube/vendor/k8s.io/apiserver/pkg/endpoints/filters/webhook_duration.go", "Go", 64, 0, 0, 0, 0, 0, 17, 81
"/opt/projects/swiftkube/vendor/k8s.io/apiserver/pkg/endpoints/groupversion.go", "Go", 124, 0, 0, 0, 0, 0, 28, 152
"/opt/projects/swiftkube/vendor/k8s.io/apiserver/pkg/endpoints/handlers/create.go", "Go", 249, 0, 0, 0, 0, 0, 35, 284
"/opt/projects/swiftkube/vendor/k8s.io/apiserver/pkg/endpoints/handlers/delete.go", "Go", 265, 0, 0, 0, 0, 0, 30, 295
"/opt/projects/swiftkube/vendor/k8s.io/apiserver/pkg/endpoints/handlers/doc.go", "Go", 14, 0, 0, 0, 0, 0, 5, 19
"/opt/projects/swiftkube/vendor/k8s.io/apiserver/pkg/endpoints/handlers/fieldmanager/admission.go", "Go", 77, 0, 0, 0, 0, 0, 14, 91
"/opt/projects/swiftkube/vendor/k8s.io/apiserver/pkg/endpoints/handlers/fieldmanager/equality.go", "Go", 156, 0, 0, 0, 0, 0, 26, 182
"/opt/projects/swiftkube/vendor/k8s.io/apiserver/pkg/endpoints/handlers/finisher/finisher.go", "Go", 153, 0, 0, 0, 0, 0, 24, 177
"/opt/projects/swiftkube/vendor/k8s.io/apiserver/pkg/endpoints/handlers/get.go", "Go", 253, 0, 0, 0, 0, 0, 35, 288
"/opt/projects/swiftkube/vendor/k8s.io/apiserver/pkg/endpoints/handlers/helpers.go", "Go", 116, 0, 0, 0, 0, 0, 26, 142
"/opt/projects/swiftkube/vendor/k8s.io/apiserver/pkg/endpoints/handlers/metrics/metrics.go", "Go", 42, 0, 0, 0, 0, 0, 10, 52
"/opt/projects/swiftkube/vendor/k8s.io/apiserver/pkg/endpoints/handlers/namer.go", "Go", 71, 0, 0, 0, 0, 0, 15, 86
"/opt/projects/swiftkube/vendor/k8s.io/apiserver/pkg/endpoints/handlers/negotiation/doc.go", "Go", 14, 0, 0, 0, 0, 0, 5, 19
"/opt/projects/swiftkube/vendor/k8s.io/apiserver/pkg/endpoints/handlers/negotiation/errors.go", "Go", 81, 0, 0, 0, 0, 0, 19, 100
"/opt/projects/swiftkube/vendor/k8s.io/apiserver/pkg/endpoints/handlers/negotiation/negotiate.go", "Go", 226, 0, 0, 0, 0, 0, 38, 264
"/opt/projects/swiftkube/vendor/k8s.io/apiserver/pkg/endpoints/handlers/patch.go", "Go", 698, 0, 0, 0, 0, 0, 89, 787
"/opt/projects/swiftkube/vendor/k8s.io/apiserver/pkg/endpoints/handlers/response.go", "Go", 254, 0, 0, 0, 0, 0, 34, 288
"/opt/projects/swiftkube/vendor/k8s.io/apiserver/pkg/endpoints/handlers/responsewriters/doc.go", "Go", 14, 0, 0, 0, 0, 0, 5, 19
"/opt/projects/swiftkube/vendor/k8s.io/apiserver/pkg/endpoints/handlers/responsewriters/errors.go", "Go", 63, 0, 0, 0, 0, 0, 16, 79
"/opt/projects/swiftkube/vendor/k8s.io/apiserver/pkg/endpoints/handlers/responsewriters/status.go", "Go", 75, 0, 0, 0, 0, 0, 9, 84
"/opt/projects/swiftkube/vendor/k8s.io/apiserver/pkg/endpoints/handlers/responsewriters/writers.go", "Go", 306, 0, 0, 0, 0, 0, 38, 344
"/opt/projects/swiftkube/vendor/k8s.io/apiserver/pkg/endpoints/handlers/rest.go", "Go", 420, 0, 0, 0, 0, 0, 53, 473
"/opt/projects/swiftkube/vendor/k8s.io/apiserver/pkg/endpoints/handlers/trace_util.go", "Go", 30, 0, 0, 0, 0, 0, 8, 38
"/opt/projects/swiftkube/vendor/k8s.io/apiserver/pkg/endpoints/handlers/update.go", "Go", 269, 0, 0, 0, 0, 0, 32, 301
"/opt/projects/swiftkube/vendor/k8s.io/apiserver/pkg/endpoints/handlers/watch.go", "Go", 326, 0, 0, 0, 0, 0, 48, 374
"/opt/projects/swiftkube/vendor/k8s.io/apiserver/pkg/endpoints/installer.go", "Go", 1201, 0, 0, 0, 0, 0, 124, 1325
"/opt/projects/swiftkube/vendor/k8s.io/apiserver/pkg/endpoints/metrics/metrics.go", "Go", 774, 0, 0, 0, 0, 0, 84, 858
"/opt/projects/swiftkube/vendor/k8s.io/apiserver/pkg/endpoints/openapi/openapi.go", "Go", 169, 0, 0, 0, 0, 0, 23, 192
"/opt/projects/swiftkube/vendor/k8s.io/apiserver/pkg/endpoints/request/context.go", "Go", 61, 0, 0, 0, 0, 0, 18, 79
"/opt/projects/swiftkube/vendor/k8s.io/apiserver/pkg/endpoints/request/doc.go", "Go", 16, 0, 0, 0, 0, 0, 5, 21
"/opt/projects/swiftkube/vendor/k8s.io/apiserver/pkg/endpoints/request/received_time.go", "Go", 36, 0, 0, 0, 0, 0, 10, 46
"/opt/projects/swiftkube/vendor/k8s.io/apiserver/pkg/endpoints/request/requestinfo.go", "Go", 236, 0, 0, 0, 0, 0, 39, 275
"/opt/projects/swiftkube/vendor/k8s.io/apiserver/pkg/endpoints/request/server_shutdown_signal.go", "Go", 44, 0, 0, 0, 0, 0, 12, 56
"/opt/projects/swiftkube/vendor/k8s.io/apiserver/pkg/endpoints/request/webhook_duration.go", "Go", 244, 0, 0, 0, 0, 0, 42, 286
"/opt/projects/swiftkube/vendor/k8s.io/apiserver/pkg/endpoints/responsewriter/fake.go", "Go", 42, 0, 0, 0, 0, 0, 13, 55
"/opt/projects/swiftkube/vendor/k8s.io/apiserver/pkg/endpoints/responsewriter/wrapper.go", "Go", 153, 0, 0, 0, 0, 0, 28, 181
"/opt/projects/swiftkube/vendor/k8s.io/apiserver/pkg/endpoints/warning/warning.go", "Go", 31, 0, 0, 0, 0, 0, 9, 40
"/opt/projects/swiftkube/vendor/k8s.io/apiserver/pkg/features/kube_features.go", "Go", 227, 0, 0, 0, 0, 0, 60, 287
"/opt/projects/swiftkube/vendor/k8s.io/apiserver/pkg/quota/v1/interfaces.go", "Go", 77, 0, 0, 0, 0, 0, 12, 89
"/opt/projects/swiftkube/vendor/k8s.io/apiserver/pkg/quota/v1/resources.go", "Go", 273, 0, 0, 0, 0, 0, 32, 305
"/opt/projects/swiftkube/vendor/k8s.io/apiserver/pkg/registry/generic/doc.go", "Go", 15, 0, 0, 0, 0, 0, 5, 20
"/opt/projects/swiftkube/vendor/k8s.io/apiserver/pkg/registry/generic/matcher.go", "Go", 44, 0, 0, 0, 0, 0, 9, 53
"/opt/projects/swiftkube/vendor/k8s.io/apiserver/pkg/registry/generic/options.go", "Go", 45, 0, 0, 0, 0, 0, 12, 57
"/opt/projects/swiftkube/vendor/k8s.io/apiserver/pkg/registry/generic/registry/decorated_watcher.go", "Go", 81, 0, 0, 0, 0, 0, 11, 92
"/opt/projects/swiftkube/vendor/k8s.io/apiserver/pkg/registry/generic/registry/doc.go", "Go", 15, 0, 0, 0, 0, 0, 5, 20
"/opt/projects/swiftkube/vendor/k8s.io/apiserver/pkg/registry/generic/registry/dryrun.go", "Go", 105, 0, 0, 0, 0, 0, 19, 124
"/opt/projects/swiftkube/vendor/k8s.io/apiserver/pkg/registry/generic/registry/storage_factory.go", "Go", 82, 0, 0, 0, 0, 0, 14, 96
"/opt/projects/swiftkube/vendor/k8s.io/apiserver/pkg/registry/generic/registry/store.go", "Go", 1465, 0, 0, 0, 0, 0, 166, 1631
"/opt/projects/swiftkube/vendor/k8s.io/apiserver/pkg/registry/generic/storage_decorator.go", "Go", 50, 0, 0, 0, 0, 0, 9, 59
"/opt/projects/swiftkube/vendor/k8s.io/apiserver/pkg/registry/rest/create.go", "Go", 196, 0, 0, 0, 0, 0, 28, 224
"/opt/projects/swiftkube/vendor/k8s.io/apiserver/pkg/registry/rest/create_update.go", "Go", 63, 0, 0, 0, 0, 0, 10, 73
"/opt/projects/swiftkube/vendor/k8s.io/apiserver/pkg/registry/rest/delete.go", "Go", 181, 0, 0, 0, 0, 0, 22, 203
"/opt/projects/swiftkube/vendor/k8s.io/apiserver/pkg/registry/rest/doc.go", "Go", 14, 0, 0, 0, 0, 0, 5, 19
"/opt/projects/swiftkube/vendor/k8s.io/apiserver/pkg/registry/rest/meta.go", "Go", 68, 0, 0, 0, 0, 0, 14, 82
"/opt/projects/swiftkube/vendor/k8s.io/apiserver/pkg/registry/rest/rest.go", "Go", 337, 0, 0, 0, 0, 0, 56, 393
"/opt/projects/swiftkube/vendor/k8s.io/apiserver/pkg/registry/rest/table.go", "Go", 92, 0, 0, 0, 0, 0, 14, 106
"/opt/projects/swiftkube/vendor/k8s.io/apiserver/pkg/registry/rest/update.go", "Go", 257, 0, 0, 0, 0, 0, 39, 296
"/opt/projects/swiftkube/vendor/k8s.io/apiserver/pkg/server/config.go", "Go", 950, 0, 0, 0, 0, 0, 141, 1091
"/opt/projects/swiftkube/vendor/k8s.io/apiserver/pkg/server/config_selfclient.go", "Go", 80, 0, 0, 0, 0, 0, 18, 98
"/opt/projects/swiftkube/vendor/k8s.io/apiserver/pkg/server/deleted_kinds.go", "Go", 176, 0, 0, 0, 0, 0, 26, 202
"/opt/projects/swiftkube/vendor/k8s.io/apiserver/pkg/server/deprecated_insecure_serving.go", "Go", 81, 0, 0, 0, 0, 0, 17, 98
"/opt/projects/swiftkube/vendor/k8s.io/apiserver/pkg/server/doc.go", "Go", 14, 0, 0, 0, 0, 0, 5, 19
"/opt/projects/swiftkube/vendor/k8s.io/apiserver/pkg/server/dynamiccertificates/cert_key.go", "Go", 46, 0, 0, 0, 0, 0, 14, 60
"/opt/projects/swiftkube/vendor/k8s.io/apiserver/pkg/server/dynamiccertificates/client_ca.go", "Go", 54, 0, 0, 0, 0, 0, 16, 70
"/opt/projects/swiftkube/vendor/k8s.io/apiserver/pkg/server/dynamiccertificates/configmap_cafile_content.go", "Go", 227, 0, 0, 0, 0, 0, 48, 275
"/opt/projects/swiftkube/vendor/k8s.io/apiserver/pkg/server/dynamiccertificates/dynamic_cafile_content.go", "Go", 237, 0, 0, 0, 0, 0, 54, 291
"/opt/projects/swiftkube/vendor/k8s.io/apiserver/pkg/server/dynamiccertificates/dynamic_serving_content.go", "Go", 191, 0, 0, 0, 0, 0, 43, 234
"/opt/projects/swiftkube/vendor/k8s.io/apiserver/pkg/server/dynamiccertificates/dynamic_sni_content.go", "Go", 39, 0, 0, 0, 0, 0, 11, 50
"/opt/projects/swiftkube/vendor/k8s.io/apiserver/pkg/server/dynamiccertificates/interfaces.go", "Go", 55, 0, 0, 0, 0, 0, 14, 69
"/opt/projects/swiftkube/vendor/k8s.io/apiserver/pkg/server/dynamiccertificates/named_certificates.go", "Go", 74, 0, 0, 0, 0, 0, 18, 92
"/opt/projects/swiftkube/vendor/k8s.io/apiserver/pkg/server/dynamiccertificates/static_content.go", "Go", 96, 0, 0, 0, 0, 0, 25, 121
"/opt/projects/swiftkube/vendor/k8s.io/apiserver/pkg/server/dynamiccertificates/tlsconfig.go", "Go", 230, 0, 0, 0, 0, 0, 55, 285
"/opt/projects/swiftkube/vendor/k8s.io/apiserver/pkg/server/dynamiccertificates/union_content.go", "Go", 86, 0, 0, 0, 0, 0, 20, 106
"/opt/projects/swiftkube/vendor/k8s.io/apiserver/pkg/server/dynamiccertificates/util.go", "Go", 55, 0, 0, 0, 0, 0, 12, 67
"/opt/projects/swiftkube/vendor/k8s.io/apiserver/pkg/server/egressselector/config.go", "Go", 229, 0, 0, 0, 0, 0, 26, 255
"/opt/projects/swiftkube/vendor/k8s.io/apiserver/pkg/server/egressselector/egress_selector.go", "Go", 360, 0, 0, 0, 0, 0, 47, 407
"/opt/projects/swiftkube/vendor/k8s.io/apiserver/pkg/server/egressselector/metrics/metrics.go", "Go", 112, 0, 0, 0, 0, 0, 22, 134
"/opt/projects/swiftkube/vendor/k8s.io/apiserver/pkg/server/filters/content_type.go", "Go", 22, 0, 0, 0, 0, 0, 7, 29
"/opt/projects/swiftkube/vendor/k8s.io/apiserver/pkg/server/filters/cors.go", "Go", 112, 0, 0, 0, 0, 0, 19, 131
"/opt/projects/swiftkube/vendor/k8s.io/apiserver/pkg/server/filters/doc.go", "Go", 15, 0, 0, 0, 0, 0, 5, 20
"/opt/projects/swiftkube/vendor/k8s.io/apiserver/pkg/server/filters/goaway.go", "Go", 71, 0, 0, 0, 0, 0, 14, 85
"/opt/projects/swiftkube/vendor/k8s.io/apiserver/pkg/server/filters/hsts.go", "Go", 34, 0, 0, 0, 0, 0, 7, 41
"/opt/projects/swiftkube/vendor/k8s.io/apiserver/pkg/server/filters/longrunning.go", "Go", 34, 0, 0, 0, 0, 0, 8, 42
"/opt/projects/swiftkube/vendor/k8s.io/apiserver/pkg/server/filters/maxinflight.go", "Go", 191, 0, 0, 0, 0, 0, 32, 223
"/opt/projects/swiftkube/vendor/k8s.io/apiserver/pkg/server/filters/priority-and-fairness.go", "Go", 309, 0, 0, 0, 0, 0, 50, 359
"/opt/projects/swiftkube/vendor/k8s.io/apiserver/pkg/server/filters/timeout.go", "Go", 261, 0, 0, 0, 0, 0, 50, 311
"/opt/projects/swiftkube/vendor/k8s.io/apiserver/pkg/server/filters/waitgroup.go", "Go", 82, 0, 0, 0, 0, 0, 16, 98
"/opt/projects/swiftkube/vendor/k8s.io/apiserver/pkg/server/filters/watch_termination.go", "Go", 52, 0, 0, 0, 0, 0, 11, 63
"/opt/projects/swiftkube/vendor/k8s.io/apiserver/pkg/server/filters/with_retry_after.go", "Go", 112, 0, 0, 0, 0, 0, 19, 131
"/opt/projects/swiftkube/vendor/k8s.io/apiserver/pkg/server/filters/wrap.go", "Go", 66, 0, 0, 0, 0, 0, 11, 77
"/opt/projects/swiftkube/vendor/k8s.io/apiserver/pkg/server/genericapiserver.go", "Go", 872, 0, 0, 0, 0, 0, 149, 1021
"/opt/projects/swiftkube/vendor/k8s.io/apiserver/pkg/server/handler.go", "Go", 165, 0, 0, 0, 0, 0, 26, 191
"/opt/projects/swiftkube/vendor/k8s.io/apiserver/pkg/server/healthz.go", "Go", 142, 0, 0, 0, 0, 0, 23, 165
"/opt/projects/swiftkube/vendor/k8s.io/apiserver/pkg/server/healthz/doc.go", "Go", 18, 0, 0, 0, 0, 0, 5, 23
"/opt/projects/swiftkube/vendor/k8s.io/apiserver/pkg/server/healthz/healthz.go", "Go", 268, 0, 0, 0, 0, 0, 47, 315
"/opt/projects/swiftkube/vendor/k8s.io/apiserver/pkg/server/hooks.go", "Go", 204, 0, 0, 0, 0, 0, 42, 246
"/opt/projects/swiftkube/vendor/k8s.io/apiserver/pkg/server/httplog/doc.go", "Go", 15, 0, 0, 0, 0, 0, 5, 20
"/opt/projects/swiftkube/vendor/k8s.io/apiserver/pkg/server/httplog/httplog.go", "Go", 276, 0, 0, 0, 0, 0, 51, 327
"/opt/projects/swiftkube/vendor/k8s.io/apiserver/pkg/server/lifecycle_signals.go", "Go", 162, 0, 0, 0, 0, 0, 37, 199
"/opt/projects/swiftkube/vendor/k8s.io/apiserver/pkg/server/mux/doc.go", "Go", 14, 0, 0, 0, 0, 0, 5, 19
"/opt/projects/swiftkube/vendor/k8s.io/apiserver/pkg/server/mux/pathrecorder.go", "Go", 228, 0, 0, 0, 0, 0, 52, 280
"/opt/projects/swiftkube/vendor/k8s.io/apiserver/pkg/server/options/admission.go", "Go", 201, 0, 0, 0, 0, 0, 34, 235
"/opt/projects/swiftkube/vendor/k8s.io/apiserver/pkg/server/options/api_enablement.go", "Go", 94, 0, 0, 0, 0, 0, 22, 116
"/opt/projects/swiftkube/vendor/k8s.io/apiserver/pkg/server/options/audit.go", "Go", 533, 0, 0, 0, 0, 0, 80, 613
"/opt/projects/swiftkube/vendor/k8s.io/apiserver/pkg/server/options/authentication.go", "Go", 394, 0, 0, 0, 0, 0, 74, 468
"/opt/projects/swiftkube/vendor/k8s.io/apiserver/pkg/server/options/authentication_dynamic_request_header.go", "Go", 66, 0, 0, 0, 0, 0, 14, 80
"/opt/projects/swiftkube/vendor/k8s.io/apiserver/pkg/server/options/authorization.go", "Go", 202, 0, 0, 0, 0, 0, 42, 244
"/opt/projects/swiftkube/vendor/k8s.io/apiserver/pkg/server/options/coreapi.go", "Go", 76, 0, 0, 0, 0, 0, 15, 91
"/opt/projects/swiftkube/vendor/k8s.io/apiserver/pkg/server/options/deprecated_insecure_serving.go", "Go", 102, 0, 0, 0, 0, 0, 25, 127
"/opt/projects/swiftkube/vendor/k8s.io/apiserver/pkg/server/options/doc.go", "Go", 17, 0, 0, 0, 0, 0, 5, 22
"/opt/projects/swiftkube/vendor/k8s.io/apiserver/pkg/server/options/egress_selector.go", "Go", 75, 0, 0, 0, 0, 0, 19, 94
"/opt/projects/swiftkube/vendor/k8s.io/apiserver/pkg/server/options/encryptionconfig/config.go", "Go", 836, 0, 0, 0, 0, 0, 159, 995
"/opt/projects/swiftkube/vendor/k8s.io/apiserver/pkg/server/options/encryptionconfig/controller/controller.go", "Go", 226, 0, 0, 0, 0, 0, 47, 273
"/opt/projects/swiftkube/vendor/k8s.io/apiserver/pkg/server/options/encryptionconfig/metrics/metrics.go", "Go", 71, 0, 0, 0, 0, 0, 16, 87
"/opt/projects/swiftkube/vendor/k8s.io/apiserver/pkg/server/options/etcd.go", "Go", 410, 0, 0, 0, 0, 0, 92, 502
"/opt/projects/swiftkube/vendor/k8s.io/apiserver/pkg/server/options/feature.go", "Go", 58, 0, 0, 0, 0, 0, 17, 75
"/opt/projects/swiftkube/vendor/k8s.io/apiserver/pkg/server/options/recommended.go", "Go", 164, 0, 0, 0, 0, 0, 17, 181
"/opt/projects/swiftkube/vendor/k8s.io/apiserver/pkg/server/options/server_run_options.go", "Go", 295, 0, 0, 0, 0, 0, 52, 347
"/opt/projects/swiftkube/vendor/k8s.io/apiserver/pkg/server/options/serving.go", "Go", 325, 0, 0, 0, 0, 0, 60, 385
"/opt/projects/swiftkube/vendor/k8s.io/apiserver/pkg/server/options/serving_unix.go", "Go", 34, 0, 0, 0, 0, 0, 11, 45
"/opt/projects/swiftkube/vendor/k8s.io/apiserver/pkg/server/options/serving_windows.go", "Go", 27, 0, 0, 0, 0, 0, 9, 36
"/opt/projects/swiftkube/vendor/k8s.io/apiserver/pkg/server/options/serving_with_loopback.go", "Go", 63, 0, 0, 0, 0, 0, 19, 82
"/opt/projects/swiftkube/vendor/k8s.io/apiserver/pkg/server/options/tracing.go", "Go", 136, 0, 0, 0, 0, 0, 23, 159
"/opt/projects/swiftkube/vendor/k8s.io/apiserver/pkg/server/plugins.go", "Go", 28, 0, 0, 0, 0, 0, 7, 35
"/opt/projects/swiftkube/vendor/k8s.io/apiserver/pkg/server/resourceconfig/doc.go", "Go", 14, 0, 0, 0, 0, 0, 5, 19
"/opt/projects/swiftkube/vendor/k8s.io/apiserver/pkg/server/resourceconfig/helpers.go", "Go", 202, 0, 0, 0, 0, 0, 28, 230
"/opt/projects/swiftkube/vendor/k8s.io/apiserver/pkg/server/routes/debugsocket.go", "Go", 68, 0, 0, 0, 0, 0, 15, 83
"/opt/projects/swiftkube/vendor/k8s.io/apiserver/pkg/server/routes/doc.go", "Go", 14, 0, 0, 0, 0, 0, 5, 19
"/opt/projects/swiftkube/vendor/k8s.io/apiserver/pkg/server/routes/flags.go", "Go", 108, 0, 0, 0, 0, 0, 20, 128
"/opt/projects/swiftkube/vendor/k8s.io/apiserver/pkg/server/routes/index.go", "Go", 54, 0, 0, 0, 0, 0, 16, 70
"/opt/projects/swiftkube/vendor/k8s.io/apiserver/pkg/server/routes/metrics.go", "Go", 45, 0, 0, 0, 0, 0, 11, 56
"/opt/projects/swiftkube/vendor/k8s.io/apiserver/pkg/server/routes/openapi.go", "Go", 62, 0, 0, 0, 0, 0, 15, 77
"/opt/projects/swiftkube/vendor/k8s.io/apiserver/pkg/server/routes/profiling.go", "Go", 34, 0, 0, 0, 0, 0, 10, 44
"/opt/projects/swiftkube/vendor/k8s.io/apiserver/pkg/server/routes/version.go", "Go", 45, 0, 0, 0, 0, 0, 13, 58
"/opt/projects/swiftkube/vendor/k8s.io/apiserver/pkg/server/secure_serving.go", "Go", 259, 0, 0, 0, 0, 0, 45, 304
"/opt/projects/swiftkube/vendor/k8s.io/apiserver/pkg/server/signal.go", "Go", 56, 0, 0, 0, 0, 0, 14, 70
"/opt/projects/swiftkube/vendor/k8s.io/apiserver/pkg/server/signal_posix.go", "Go", 20, 0, 0, 0, 0, 0, 8, 28
"/opt/projects/swiftkube/vendor/k8s.io/apiserver/pkg/server/signal_windows.go", "Go", 17, 0, 0, 0, 0, 0, 7, 24
"/opt/projects/swiftkube/vendor/k8s.io/apiserver/pkg/server/storage/doc.go", "Go", 14, 0, 0, 0, 0, 0, 5, 19
"/opt/projects/swiftkube/vendor/k8s.io/apiserver/pkg/server/storage/resource_config.go", "Go", 128, 0, 0, 0, 0, 0, 26, 154
"/opt/projects/swiftkube/vendor/k8s.io/apiserver/pkg/server/storage/resource_encoding_config.go", "Go", 66, 0, 0, 0, 0, 0, 19, 85
"/opt/projects/swiftkube/vendor/k8s.io/apiserver/pkg/server/storage/storage_codec.go", "Go", 88, 0, 0, 0, 0, 0, 16, 104
"/opt/projects/swiftkube/vendor/k8s.io/apiserver/pkg/server/storage/storage_factory.go", "Go", 324, 0, 0, 0, 0, 0, 56, 380
"/opt/projects/swiftkube/vendor/k8s.io/apiserver/pkg/storage/api_object_versioner.go", "Go", 114, 0, 0, 0, 0, 0, 17, 131
"/opt/projects/swiftkube/vendor/k8s.io/apiserver/pkg/storage/cacher/cache_watcher.go", "Go", 485, 0, 0, 0, 0, 0, 59, 544
"/opt/projects/swiftkube/vendor/k8s.io/apiserver/pkg/storage/cacher/cacher.go", "Go", 1249, 0, 0, 0, 0, 0, 158, 1407
"/opt/projects/swiftkube/vendor/k8s.io/apiserver/pkg/storage/cacher/caching_object.go", "Go", 381, 0, 0, 0, 0, 0, 32, 413
"/opt/projects/swiftkube/vendor/k8s.io/apiserver/pkg/storage/cacher/lister_watcher.go", "Go", 66, 0, 0, 0, 0, 0, 12, 78
"/opt/projects/swiftkube/vendor/k8s.io/apiserver/pkg/storage/cacher/metrics/metrics.go", "Go", 167, 0, 0, 0, 0, 0, 20, 187
"/opt/projects/swiftkube/vendor/k8s.io/apiserver/pkg/storage/cacher/ready.go", "Go", 140, 0, 0, 0, 0, 0, 18, 158
"/opt/projects/swiftkube/vendor/k8s.io/apiserver/pkg/storage/cacher/time_budget.go", "Go", 90, 0, 0, 0, 0, 0, 13, 103
"/opt/projects/swiftkube/vendor/k8s.io/apiserver/pkg/storage/cacher/util.go", "Go", 50, 0, 0, 0, 0, 0, 11, 61
"/opt/projects/swiftkube/vendor/k8s.io/apiserver/pkg/storage/cacher/watch_cache.go", "Go", 654, 0, 0, 0, 0, 0, 94, 748
"/opt/projects/swiftkube/vendor/k8s.io/apiserver/pkg/storage/cacher/watch_cache_interval.go", "Go", 201, 0, 0, 0, 0, 0, 26, 227
"/opt/projects/swiftkube/vendor/k8s.io/apiserver/pkg/storage/cacher/watch_progress.go", "Go", 104, 0, 0, 0, 0, 0, 18, 122
"/opt/projects/swiftkube/vendor/k8s.io/apiserver/pkg/storage/continue.go", "Go", 84, 0, 0, 0, 0, 0, 10, 94
"/opt/projects/swiftkube/vendor/k8s.io/apiserver/pkg/storage/doc.go", "Go", 14, 0, 0, 0, 0, 0, 5, 19
"/opt/projects/swiftkube/vendor/k8s.io/apiserver/pkg/storage/errors.go", "Go", 162, 0, 0, 0, 0, 0, 34, 196
"/opt/projects/swiftkube/vendor/k8s.io/apiserver/pkg/storage/errors/doc.go", "Go", 14, 0, 0, 0, 0, 0, 5, 19
"/opt/projects/swiftkube/vendor/k8s.io/apiserver/pkg/storage/errors/storage.go", "Go", 105, 0, 0, 0, 0, 0, 12, 117
"/opt/projects/swiftkube/vendor/k8s.io/apiserver/pkg/storage/etcd3/compact.go", "Go", 143, 0, 0, 0, 0, 0, 20, 163
"/opt/projects/swiftkube/vendor/k8s.io/apiserver/pkg/storage/etcd3/errors.go", "Go", 62, 0, 0, 0, 0, 0, 11, 73
"/opt/projects/swiftkube/vendor/k8s.io/apiserver/pkg/storage/etcd3/event.go", "Go", 61, 0, 0, 0, 0, 0, 11, 72
"/opt/projects/swiftkube/vendor/k8s.io/apiserver/pkg/storage/etcd3/healthcheck.go", "Go", 34, 0, 0, 0, 0, 0, 8, 42
"/opt/projects/swiftkube/vendor/k8s.io/apiserver/pkg/storage/etcd3/latency_tracker.go", "Go", 86, 0, 0, 0, 0, 0, 22, 108
"/opt/projects/swiftkube/vendor/k8s.io/apiserver/pkg/storage/etcd3/lease_manager.go", "Go", 114, 0, 0, 0, 0, 0, 18, 132
"/opt/projects/swiftkube/vendor/k8s.io/apiserver/pkg/storage/etcd3/logger.go", "Go", 68, 0, 0, 0, 0, 0, 23, 91
"/opt/projects/swiftkube/vendor/k8s.io/apiserver/pkg/storage/etcd3/metrics/metrics.go", "Go", 266, 0, 0, 0, 0, 0, 30, 296
"/opt/projects/swiftkube/vendor/k8s.io/apiserver/pkg/storage/etcd3/store.go", "Go", 981, 0, 0, 0, 0, 0, 108, 1089
"/opt/projects/swiftkube/vendor/k8s.io/apiserver/pkg/storage/etcd3/watcher.go", "Go", 448, 0, 0, 0, 0, 0, 48, 496
"/opt/projects/swiftkube/vendor/k8s.io/apiserver/pkg/storage/interfaces.go", "Go", 262, 0, 0, 0, 0, 0, 31, 293
"/opt/projects/swiftkube/vendor/k8s.io/apiserver/pkg/storage/names/generate.go", "Go", 43, 0, 0, 0, 0, 0, 12, 55
"/opt/projects/swiftkube/vendor/k8s.io/apiserver/pkg/storage/selection_predicate.go", "Go", 150, 0, 0, 0, 0, 0, 22, 172
"/opt/projects/swiftkube/vendor/k8s.io/apiserver/pkg/storage/storagebackend/config.go", "Go", 109, 0, 0, 0, 0, 0, 20, 129
"/opt/projects/swiftkube/vendor/k8s.io/apiserver/pkg/storage/storagebackend/factory/etcd3.go", "Go", 437, 0, 0, 0, 0, 0, 56, 493
"/opt/projects/swiftkube/vendor/k8s.io/apiserver/pkg/storage/storagebackend/factory/factory.go", "Go", 80, 0, 0, 0, 0, 0, 14, 94
"/opt/projects/swiftkube/vendor/k8s.io/apiserver/pkg/storage/util.go", "Go", 68, 0, 0, 0, 0, 0, 14, 82
"/opt/projects/swiftkube/vendor/k8s.io/apiserver/pkg/storage/value/encrypt/aes/aes.go", "Go", 231, 0, 0, 0, 0, 0, 43, 274
"/opt/projects/swiftkube/vendor/k8s.io/apiserver/pkg/storage/value/encrypt/aes/aes_extended_nonce.go", "Go", 150, 0, 0, 0, 0, 0, 37, 187
"/opt/projects/swiftkube/vendor/k8s.io/apiserver/pkg/storage/value/encrypt/aes/cache.go", "Go", 76, 0, 0, 0, 0, 0, 16, 92
"/opt/projects/swiftkube/vendor/k8s.io/apiserver/pkg/storage/value/encrypt/envelope/envelope.go", "Go", 169, 0, 0, 0, 0, 0, 34, 203
"/opt/projects/swiftkube/vendor/k8s.io/apiserver/pkg/storage/value/encrypt/envelope/grpc_service.go", "Go", 134, 0, 0, 0, 0, 0, 29, 163
"/opt/projects/swiftkube/vendor/k8s.io/apiserver/pkg/storage/value/encrypt/envelope/kmsv2/cache.go", "Go", 88, 0, 0, 0, 0, 0, 15, 103
"/opt/projects/swiftkube/vendor/k8s.io/apiserver/pkg/storage/value/encrypt/envelope/kmsv2/envelope.go", "Go", 411, 0, 0, 0, 0, 0, 65, 476
"/opt/projects/swiftkube/vendor/k8s.io/apiserver/pkg/storage/value/encrypt/envelope/kmsv2/grpc_service.go", "Go", 129, 0, 0, 0, 0, 0, 25, 154
"/opt/projects/swiftkube/vendor/k8s.io/apiserver/pkg/storage/value/encrypt/envelope/kmsv2/v2/api.pb.go", "Go", 152, 0, 0, 0, 0, 0, 26, 178
"/opt/projects/swiftkube/vendor/k8s.io/apiserver/pkg/storage/value/encrypt/envelope/kmsv2/v2/api.proto", "Protocol Buffers", 0, 0, 26, 0, 0, 13, 13, 52
"/opt/projects/swiftkube/vendor/k8s.io/apiserver/pkg/storage/value/encrypt/envelope/kmsv2/v2/v2.go", "Go", 14, 0, 0, 0, 0, 0, 5, 19
"/opt/projects/swiftkube/vendor/k8s.io/apiserver/pkg/storage/value/encrypt/envelope/metrics/metrics.go", "Go", 267, 0, 0, 0, 0, 0, 38, 305
"/opt/projects/swiftkube/vendor/k8s.io/apiserver/pkg/storage/value/encrypt/identity/identity.go", "Go", 46, 0, 0, 0, 0, 0, 12, 58
"/opt/projects/swiftkube/vendor/k8s.io/apiserver/pkg/storage/value/encrypt/secretbox/secretbox.go", "Go", 58, 0, 0, 0, 0, 0, 13, 71
"/opt/projects/swiftkube/vendor/k8s.io/apiserver/pkg/storage/value/metrics.go", "Go", 137, 0, 0, 0, 0, 0, 26, 163
"/opt/projects/swiftkube/vendor/k8s.io/apiserver/pkg/storage/value/transformer.go", "Go", 187, 0, 0, 0, 0, 0, 27, 214
"/opt/projects/swiftkube/vendor/k8s.io/apiserver/pkg/storageversion/manager.go", "Go", 261, 0, 0, 0, 0, 0, 41, 302
"/opt/projects/swiftkube/vendor/k8s.io/apiserver/pkg/storageversion/updater.go", "Go", 181, 0, 0, 0, 0, 0, 17, 198
"/opt/projects/swiftkube/vendor/k8s.io/apiserver/pkg/util/apihelpers/helpers.go", "Go", 81, 0, 0, 0, 0, 0, 20, 101
"/opt/projects/swiftkube/vendor/k8s.io/apiserver/pkg/util/dryrun/dryrun.go", "Go", 17, 0, 0, 0, 0, 0, 6, 23
"/opt/projects/swiftkube/vendor/k8s.io/apiserver/pkg/util/feature/feature_gate.go", "Go", 26, 0, 0, 0, 0, 0, 8, 34
"/opt/projects/swiftkube/vendor/k8s.io/apiserver/pkg/util/flowcontrol/apf_context.go", "Go", 77, 0, 0, 0, 0, 0, 17, 94
"/opt/projects/swiftkube/vendor/k8s.io/apiserver/pkg/util/flowcontrol/apf_controller.go", "Go", 1015, 0, 0, 0, 0, 0, 111, 1126
"/opt/projects/swiftkube/vendor/k8s.io/apiserver/pkg/util/flowcontrol/apf_controller_debug.go", "Go", 250, 0, 0, 0, 0, 0, 22, 272
"/opt/projects/swiftkube/vendor/k8s.io/apiserver/pkg/util/flowcontrol/apf_filter.go", "Go", 179, 0, 0, 0, 0, 0, 30, 209
"/opt/projects/swiftkube/vendor/k8s.io/apiserver/pkg/util/flowcontrol/conc_alloc.go", "Go", 238, 0, 0, 0, 0, 0, 20, 258
"/opt/projects/swiftkube/vendor/k8s.io/apiserver/pkg/util/flowcontrol/debug/dump.go", "Go", 56, 0, 0, 0, 0, 0, 11, 67
"/opt/projects/swiftkube/vendor/k8s.io/apiserver/pkg/util/flowcontrol/dropped_requests_tracker.go", "Go", 199, 0, 0, 0, 0, 0, 36, 235
"/opt/projects/swiftkube/vendor/k8s.io/apiserver/pkg/util/flowcontrol/fairqueuing/eventclock/interface.go", "Go", 36, 0, 0, 0, 0, 0, 12, 48
"/opt/projects/swiftkube/vendor/k8s.io/apiserver/pkg/util/flowcontrol/fairqueuing/eventclock/real.go", "Go", 34, 0, 0, 0, 0, 0, 11, 45
"/opt/projects/swiftkube/vendor/k8s.io/apiserver/pkg/util/flowcontrol/fairqueuing/integrator.go", "Go", 162, 0, 0, 0, 0, 0, 30, 192
"/opt/projects/swiftkube/vendor/k8s.io/apiserver/pkg/util/flowcontrol/fairqueuing/interface.go", "Go", 125, 0, 0, 0, 0, 0, 22, 147
"/opt/projects/swiftkube/vendor/k8s.io/apiserver/pkg/util/flowcontrol/fairqueuing/promise/interface.go", "Go", 28, 0, 0, 0, 0, 0, 7, 35
"/opt/projects/swiftkube/vendor/k8s.io/apiserver/pkg/util/flowcontrol/fairqueuing/promise/promise.go", "Go", 60, 0, 0, 0, 0, 0, 11, 71
"/opt/projects/swiftkube/vendor/k8s.io/apiserver/pkg/util/flowcontrol/fairqueuing/queueset/doc.go", "Go", 115, 0, 0, 0, 0, 0, 5, 120
"/opt/projects/swiftkube/vendor/k8s.io/apiserver/pkg/util/flowcontrol/fairqueuing/queueset/fifo_list.go", "Go", 128, 0, 0, 0, 0, 0, 29, 157
"/opt/projects/swiftkube/vendor/k8s.io/apiserver/pkg/util/flowcontrol/fairqueuing/queueset/queueset.go", "Go", 986, 0, 0, 0, 0, 0, 114, 1100
"/opt/projects/swiftkube/vendor/k8s.io/apiserver/pkg/util/flowcontrol/fairqueuing/queueset/types.go", "Go", 177, 0, 0, 0, 0, 0, 42, 219
"/opt/projects/swiftkube/vendor/k8s.io/apiserver/pkg/util/flowcontrol/format/formatting.go", "Go", 209, 0, 0, 0, 0, 0, 23, 232
"/opt/projects/swiftkube/vendor/k8s.io/apiserver/pkg/util/flowcontrol/formatting.go", "Go", 30, 0, 0, 0, 0, 0, 11, 41
"/opt/projects/swiftkube/vendor/k8s.io/apiserver/pkg/util/flowcontrol/max_seats.go", "Go", 49, 0, 0, 0, 0, 0, 18, 67
"/opt/projects/swiftkube/vendor/k8s.io/apiserver/pkg/util/flowcontrol/metrics/interface.go", "Go", 56, 0, 0, 0, 0, 0, 12, 68
"/opt/projects/swiftkube/vendor/k8s.io/apiserver/pkg/util/flowcontrol/metrics/metrics.go", "Go", 574, 0, 0, 0, 0, 0, 43, 617
"/opt/projects/swiftkube/vendor/k8s.io/apiserver/pkg/util/flowcontrol/metrics/timing_ratio_histogram.go", "Go", 194, 0, 0, 0, 0, 0, 33, 227
"/opt/projects/swiftkube/vendor/k8s.io/apiserver/pkg/util/flowcontrol/metrics/union_gauge.go", "Go", 44, 0, 0, 0, 0, 0, 13, 57
"/opt/projects/swiftkube/vendor/k8s.io/apiserver/pkg/util/flowcontrol/metrics/vec_element_pair.go", "Go", 20, 0, 0, 0, 0, 0, 6, 26
"/opt/projects/swiftkube/vendor/k8s.io/apiserver/pkg/util/flowcontrol/request/config.go", "Go", 76, 0, 0, 0, 0, 0, 18, 94
"/opt/projects/swiftkube/vendor/k8s.io/apiserver/pkg/util/flowcontrol/request/list_work_estimator.go", "Go", 156, 0, 0, 0, 0, 0, 26, 182
"/opt/projects/swiftkube/vendor/k8s.io/apiserver/pkg/util/flowcontrol/request/mutating_work_estimator.go", "Go", 139, 0, 0, 0, 0, 0, 19, 158
"/opt/projects/swiftkube/vendor/k8s.io/apiserver/pkg/util/flowcontrol/request/object_count_tracker.go", "Go", 139, 0, 0, 0, 0, 0, 31, 170
"/opt/projects/swiftkube/vendor/k8s.io/apiserver/pkg/util/flowcontrol/request/seat_seconds.go", "Go", 52, 0, 0, 0, 0, 0, 14, 66
"/opt/projects/swiftkube/vendor/k8s.io/apiserver/pkg/util/flowcontrol/request/width.go", "Go", 107, 0, 0, 0, 0, 0, 23, 130
"/opt/projects/swiftkube/vendor/k8s.io/apiserver/pkg/util/flowcontrol/rule.go", "Go", 180, 0, 0, 0, 0, 0, 24, 204
"/opt/projects/swiftkube/vendor/k8s.io/apiserver/pkg/util/flowcontrol/watch_tracker.go", "Go", 199, 0, 0, 0, 0, 0, 35, 234
"/opt/projects/swiftkube/vendor/k8s.io/apiserver/pkg/util/flushwriter/doc.go", "Go", 15, 0, 0, 0, 0, 0, 5, 20
"/opt/projects/swiftkube/vendor/k8s.io/apiserver/pkg/util/flushwriter/writer.go", "Go", 45, 0, 0, 0, 0, 0, 9, 54
"/opt/projects/swiftkube/vendor/k8s.io/apiserver/pkg/util/peerproxy/metrics/metrics.go", "Go", 45, 0, 0, 0, 0, 0, 12, 57
"/opt/projects/swiftkube/vendor/k8s.io/apiserver/pkg/util/shufflesharding/shufflesharding.go", "Go", 93, 0, 0, 0, 0, 0, 15, 108
"/opt/projects/swiftkube/vendor/k8s.io/apiserver/pkg/util/webhook/authentication.go", "Go", 238, 0, 0, 0, 0, 0, 39, 277
"/opt/projects/swiftkube/vendor/k8s.io/apiserver/pkg/util/webhook/client.go", "Go", 197, 0, 0, 0, 0, 0, 34, 231
"/opt/projects/swiftkube/vendor/k8s.io/apiserver/pkg/util/webhook/error.go", "Go", 38, 0, 0, 0, 0, 0, 11, 49
"/opt/projects/swiftkube/vendor/k8s.io/apiserver/pkg/util/webhook/metrics.go", "Go", 44, 0, 0, 0, 0, 0, 9, 53
"/opt/projects/swiftkube/vendor/k8s.io/apiserver/pkg/util/webhook/serviceresolver.go", "Go", 39, 0, 0, 0, 0, 0, 10, 49
"/opt/projects/swiftkube/vendor/k8s.io/apiserver/pkg/util/webhook/validation.go", "Go", 88, 0, 0, 0, 0, 0, 18, 106
"/opt/projects/swiftkube/vendor/k8s.io/apiserver/pkg/util/webhook/webhook.go", "Go", 145, 0, 0, 0, 0, 0, 26, 171
"/opt/projects/swiftkube/vendor/k8s.io/apiserver/pkg/util/x509metrics/server_cert_deprecations.go", "Go", 192, 0, 0, 0, 0, 0, 34, 226
"/opt/projects/swiftkube/vendor/k8s.io/apiserver/pkg/warning/context.go", "Go", 49, 0, 0, 0, 0, 0, 12, 61
"/opt/projects/swiftkube/vendor/k8s.io/apiserver/plugin/pkg/audit/buffered/buffered.go", "Go", 247, 0, 0, 0, 0, 0, 44, 291
"/opt/projects/swiftkube/vendor/k8s.io/apiserver/plugin/pkg/audit/buffered/doc.go", "Go", 15, 0, 0, 0, 0, 0, 5, 20
"/opt/projects/swiftkube/vendor/k8s.io/apiserver/plugin/pkg/audit/log/backend.go", "Go", 87, 0, 0, 0, 0, 0, 18, 105
"/opt/projects/swiftkube/vendor/k8s.io/apiserver/plugin/pkg/audit/truncate/doc.go", "Go", 15, 0, 0, 0, 0, 0, 5, 20
"/opt/projects/swiftkube/vendor/k8s.io/apiserver/plugin/pkg/audit/truncate/truncate.go", "Go", 135, 0, 0, 0, 0, 0, 31, 166
"/opt/projects/swiftkube/vendor/k8s.io/apiserver/plugin/pkg/audit/webhook/webhook.go", "Go", 125, 0, 0, 0, 0, 0, 22, 147
"/opt/projects/swiftkube/vendor/k8s.io/apiserver/plugin/pkg/authenticator/token/webhook/metrics.go", "Go", 26, 0, 0, 0, 0, 0, 10, 36
"/opt/projects/swiftkube/vendor/k8s.io/apiserver/plugin/pkg/authenticator/token/webhook/webhook.go", "Go", 285, 0, 0, 0, 0, 0, 43, 328
"/opt/projects/swiftkube/vendor/k8s.io/apiserver/plugin/pkg/authorizer/webhook/metrics.go", "Go", 26, 0, 0, 0, 0, 0, 10, 36
"/opt/projects/swiftkube/vendor/k8s.io/apiserver/plugin/pkg/authorizer/webhook/webhook.go", "Go", 388, 0, 0, 0, 0, 0, 49, 437
"/opt/projects/swiftkube/vendor/k8s.io/cli-runtime/pkg/genericclioptions/builder_flags.go", "Go", 191, 0, 0, 0, 0, 0, 41, 232
"/opt/projects/swiftkube/vendor/k8s.io/cli-runtime/pkg/genericclioptions/builder_flags_fake.go", "Go", 44, 0, 0, 0, 0, 0, 11, 55
"/opt/projects/swiftkube/vendor/k8s.io/cli-runtime/pkg/genericclioptions/client_config.go", "Go", 57, 0, 0, 0, 0, 0, 16, 73
"/opt/projects/swiftkube/vendor/k8s.io/cli-runtime/pkg/genericclioptions/command_headers.go", "Go", 83, 0, 0, 0, 0, 0, 12, 95
"/opt/projects/swiftkube/vendor/k8s.io/cli-runtime/pkg/genericclioptions/config_flags.go", "Go", 418, 0, 0, 0, 0, 0, 59, 477
"/opt/projects/swiftkube/vendor/k8s.io/cli-runtime/pkg/genericclioptions/config_flags_fake.go", "Go", 108, 0, 0, 0, 0, 0, 20, 128
"/opt/projects/swiftkube/vendor/k8s.io/cli-runtime/pkg/genericclioptions/doc.go", "Go", 15, 0, 0, 0, 0, 0, 5, 20
"/opt/projects/swiftkube/vendor/k8s.io/cli-runtime/pkg/genericclioptions/filename_flags.go", "Go", 67, 0, 0, 0, 0, 0, 16, 83
"/opt/projects/swiftkube/vendor/k8s.io/cli-runtime/pkg/genericclioptions/io_options.go", "Go", 44, 0, 0, 0, 0, 0, 11, 55
"/opt/projects/swiftkube/vendor/k8s.io/cli-runtime/pkg/genericclioptions/json_yaml_flags.go", "Go", 64, 0, 0, 0, 0, 0, 16, 80
"/opt/projects/swiftkube/vendor/k8s.io/cli-runtime/pkg/genericclioptions/jsonpath_flags.go", "Go", 113, 0, 0, 0, 0, 0, 25, 138
"/opt/projects/swiftkube/vendor/k8s.io/cli-runtime/pkg/genericclioptions/kube_template_flags.go", "Go", 78, 0, 0, 0, 0, 0, 17, 95
"/opt/projects/swiftkube/vendor/k8s.io/cli-runtime/pkg/genericclioptions/name_flags.go", "Go", 69, 0, 0, 0, 0, 0, 15, 84
"/opt/projects/swiftkube/vendor/k8s.io/cli-runtime/pkg/genericclioptions/print_flags.go", "Go", 141, 0, 0, 0, 0, 0, 31, 172
"/opt/projects/swiftkube/vendor/k8s.io/cli-runtime/pkg/genericclioptions/record_flags.go", "Go", 166, 0, 0, 0, 0, 0, 36, 202
"/opt/projects/swiftkube/vendor/k8s.io/cli-runtime/pkg/genericclioptions/template_flags.go", "Go", 113, 0, 0, 0, 0, 0, 24, 137
"/opt/projects/swiftkube/vendor/k8s.io/cli-runtime/pkg/genericiooptions/io_options.go", "Go", 47, 0, 0, 0, 0, 0, 10, 57
"/opt/projects/swiftkube/vendor/k8s.io/cli-runtime/pkg/printers/discard.go", "Go", 23, 0, 0, 0, 0, 0, 8, 31
"/opt/projects/swiftkube/vendor/k8s.io/cli-runtime/pkg/printers/doc.go", "Go", 15, 0, 0, 0, 0, 0, 5, 20
"/opt/projects/swiftkube/vendor/k8s.io/cli-runtime/pkg/printers/interface.go", "Go", 42, 0, 0, 0, 0, 0, 13, 55
"/opt/projects/swiftkube/vendor/k8s.io/cli-runtime/pkg/printers/json.go", "Go", 68, 0, 0, 0, 0, 0, 12, 80
"/opt/projects/swiftkube/vendor/k8s.io/cli-runtime/pkg/printers/jsonpath.go", "Go", 134, 0, 0, 0, 0, 0, 14, 148
"/opt/projects/swiftkube/vendor/k8s.io/cli-runtime/pkg/printers/managedfields.go", "Go", 49, 0, 0, 0, 0, 0, 11, 60
"/opt/projects/swiftkube/vendor/k8s.io/cli-runtime/pkg/printers/name.go", "Go", 108, 0, 0, 0, 0, 0, 23, 131
"/opt/projects/swiftkube/vendor/k8s.io/cli-runtime/pkg/printers/sourcechecker.go", "Go", 47, 0, 0, 0, 0, 0, 14, 61
"/opt/projects/swiftkube/vendor/k8s.io/cli-runtime/pkg/printers/tableprinter.go", "Go", 519, 0, 0, 0, 0, 0, 71, 590
"/opt/projects/swiftkube/vendor/k8s.io/cli-runtime/pkg/printers/tabwriter.go", "Go", 28, 0, 0, 0, 0, 0, 9, 37
"/opt/projects/swiftkube/vendor/k8s.io/cli-runtime/pkg/printers/template.go", "Go", 104, 0, 0, 0, 0, 0, 15, 119
"/opt/projects/swiftkube/vendor/k8s.io/cli-runtime/pkg/printers/terminal.go", "Go", 31, 0, 0, 0, 0, 0, 9, 40
"/opt/projects/swiftkube/vendor/k8s.io/cli-runtime/pkg/printers/typesetter.go", "Go", 77, 0, 0, 0, 0, 0, 19, 96
"/opt/projects/swiftkube/vendor/k8s.io/cli-runtime/pkg/printers/warningprinter.go", "Go", 45, 0, 0, 0, 0, 0, 11, 56
"/opt/projects/swiftkube/vendor/k8s.io/cli-runtime/pkg/printers/yaml.go", "Go", 72, 0, 0, 0, 0, 0, 14, 86
"/opt/projects/swiftkube/vendor/k8s.io/cli-runtime/pkg/resource/builder.go", "Go", 1112, 0, 0, 0, 0, 0, 148, 1260
"/opt/projects/swiftkube/vendor/k8s.io/cli-runtime/pkg/resource/client.go", "Go", 59, 0, 0, 0, 0, 0, 11, 70
"/opt/projects/swiftkube/vendor/k8s.io/cli-runtime/pkg/resource/crd_finder.go", "Go", 91, 0, 0, 0, 0, 0, 20, 111
"/opt/projects/swiftkube/vendor/k8s.io/cli-runtime/pkg/resource/doc.go", "Go", 20, 0, 0, 0, 0, 0, 5, 25
"/opt/projects/swiftkube/vendor/k8s.io/cli-runtime/pkg/resource/fake.go", "Go", 34, 0, 0, 0, 0, 0, 7, 41
"/opt/projects/swiftkube/vendor/k8s.io/cli-runtime/pkg/resource/fallback_query_param_verifier.go", "Go", 50, 0, 0, 0, 0, 0, 10, 60
"/opt/projects/swiftkube/vendor/k8s.io/cli-runtime/pkg/resource/helper.go", "Go", 288, 0, 0, 0, 0, 0, 34, 322
"/opt/projects/swiftkube/vendor/k8s.io/cli-runtime/pkg/resource/interfaces.go", "Go", 86, 0, 0, 0, 0, 0, 18, 104
"/opt/projects/swiftkube/vendor/k8s.io/cli-runtime/pkg/resource/kustomizevisitor.go", "Go", 46, 0, 0, 0, 0, 0, 9, 55
"/opt/projects/swiftkube/vendor/k8s.io/cli-runtime/pkg/resource/mapper.go", "Go", 140, 0, 0, 0, 0, 0, 27, 167
"/opt/projects/swiftkube/vendor/k8s.io/cli-runtime/pkg/resource/metadata_decoder.go", "Go", 45, 0, 0, 0, 0, 0, 12, 57
"/opt/projects/swiftkube/vendor/k8s.io/cli-runtime/pkg/resource/query_param_verifier.go", "Go", 152, 0, 0, 0, 0, 0, 25, 177
"/opt/projects/swiftkube/vendor/k8s.io/cli-runtime/pkg/resource/query_param_verifier_v3.go", "Go", 131, 0, 0, 0, 0, 0, 15, 146
"/opt/projects/swiftkube/vendor/k8s.io/cli-runtime/pkg/resource/result.go", "Go", 212, 0, 0, 0, 0, 0, 31, 243
"/opt/projects/swiftkube/vendor/k8s.io/cli-runtime/pkg/resource/scheme.go", "Go", 68, 0, 0, 0, 0, 0, 15, 83
"/opt/projects/swiftkube/vendor/k8s.io/cli-runtime/pkg/resource/selector.go", "Go", 78, 0, 0, 0, 0, 0, 15, 93
"/opt/projects/swiftkube/vendor/k8s.io/cli-runtime/pkg/resource/visitor.go", "Go", 691, 0, 0, 0, 0, 0, 80, 771
"/opt/projects/swiftkube/vendor/k8s.io/client-go/applyconfigurations/admissionregistration/v1/matchcondition.go", "Go", 39, 0, 0, 0, 0, 0, 10, 49
"/opt/projects/swiftkube/vendor/k8s.io/client-go/applyconfigurations/admissionregistration/v1/mutatingwebhook.go", "Go", 135, 0, 0, 0, 0, 0, 21, 156
"/opt/projects/swiftkube/vendor/k8s.io/client-go/applyconfigurations/admissionregistration/v1/mutatingwebhookconfiguration.go", "Go", 223, 0, 0, 0, 0, 0, 30, 253
"/opt/projects/swiftkube/vendor/k8s.io/client-go/applyconfigurations/admissionregistration/v1/rule.go", "Go", 64, 0, 0, 0, 0, 0, 13, 77
"/opt/projects/swiftkube/vendor/k8s.io/client-go/applyconfigurations/admissionregistration/v1/rulewithoperations.go", "Go", 71, 0, 0, 0, 0, 0, 14, 85
"/opt/projects/swiftkube/vendor/k8s.io/client-go/applyconfigurations/admissionregistration/v1/servicereference.go", "Go", 55, 0, 0, 0, 0, 0, 12, 67
"/opt/projects/swiftkube/vendor/k8s.io/client-go/applyconfigurations/admissionregistration/v1/validatingwebhook.go", "Go", 127, 0, 0, 0, 0, 0, 20, 147
"/opt/projects/swiftkube/vendor/k8s.io/client-go/applyconfigurations/admissionregistration/v1/validatingwebhookconfiguration.go", "Go", 223, 0, 0, 0, 0, 0, 30, 253
"/opt/projects/swiftkube/vendor/k8s.io/client-go/applyconfigurations/admissionregistration/v1/webhookclientconfig.go", "Go", 49, 0, 0, 0, 0, 0, 11, 60
"/opt/projects/swiftkube/vendor/k8s.io/client-go/applyconfigurations/admissionregistration/v1alpha1/auditannotation.go", "Go", 39, 0, 0, 0, 0, 0, 10, 49
"/opt/projects/swiftkube/vendor/k8s.io/client-go/applyconfigurations/admissionregistration/v1alpha1/expressionwarning.go", "Go", 39, 0, 0, 0, 0, 0, 10, 49
"/opt/projects/swiftkube/vendor/k8s.io/client-go/applyconfigurations/admissionregistration/v1alpha1/matchcondition.go", "Go", 39, 0, 0, 0, 0, 0, 10, 49
"/opt/projects/swiftkube/vendor/k8s.io/client-go/applyconfigurations/admissionregistration/v1alpha1/matchresources.go", "Go", 77, 0, 0, 0, 0, 0, 14, 91
"/opt/projects/swiftkube/vendor/k8s.io/client-go/applyconfigurations/admissionregistration/v1alpha1/namedrulewithoperations.go", "Go", 81, 0, 0, 0, 0, 0, 15, 96
"/opt/projects/swiftkube/vendor/k8s.io/client-go/applyconfigurations/admissionregistration/v1alpha1/paramkind.go", "Go", 39, 0, 0, 0, 0, 0, 10, 49
"/opt/projects/swiftkube/vendor/k8s.io/client-go/applyconfigurations/admissionregistration/v1alpha1/paramref.go", "Go", 59, 0, 0, 0, 0, 0, 13, 72
"/opt/projects/swiftkube/vendor/k8s.io/client-go/applyconfigurations/admissionregistration/v1alpha1/typechecking.go", "Go", 36, 0, 0, 0, 0, 0, 9, 45
"/opt/projects/swiftkube/vendor/k8s.io/client-go/applyconfigurations/admissionregistration/v1alpha1/validatingadmissionpolicy.go", "Go", 226, 0, 0, 0, 0, 0, 31, 257
"/opt/projects/swiftkube/vendor/k8s.io/client-go/applyconfigurations/admissionregistration/v1alpha1/validatingadmissionpolicybinding.go", "Go", 218, 0, 0, 0, 0, 0, 30, 248
"/opt/projects/swiftkube/vendor/k8s.io/client-go/applyconfigurations/admissionregistration/v1alpha1/validatingadmissionpolicybindingspec.go", "Go", 60, 0, 0, 0, 0, 0, 13, 73
"/opt/projects/swiftkube/vendor/k8s.io/client-go/applyconfigurations/admissionregistration/v1alpha1/validatingadmissionpolicyspec.go", "Go", 102, 0, 0, 0, 0, 0, 16, 118
"/opt/projects/swiftkube/vendor/k8s.io/client-go/applyconfigurations/admissionregistration/v1alpha1/validatingadmissionpolicystatus.go", "Go", 55, 0, 0, 0, 0, 0, 12, 67
"/opt/projects/swiftkube/vendor/k8s.io/client-go/applyconfigurations/admissionregistration/v1alpha1/validation.go", "Go", 58, 0, 0, 0, 0, 0, 13, 71
"/opt/projects/swiftkube/vendor/k8s.io/client-go/applyconfigurations/admissionregistration/v1alpha1/variable.go", "Go", 39, 0, 0, 0, 0, 0, 10, 49
"/opt/projects/swiftkube/vendor/k8s.io/client-go/applyconfigurations/admissionregistration/v1beta1/auditannotation.go", "Go", 39, 0, 0, 0, 0, 0, 10, 49
"/opt/projects/swiftkube/vendor/k8s.io/client-go/applyconfigurations/admissionregistration/v1beta1/expressionwarning.go", "Go", 39, 0, 0, 0, 0, 0, 10, 49
"/opt/projects/swiftkube/vendor/k8s.io/client-go/applyconfigurations/admissionregistration/v1beta1/matchcondition.go", "Go", 39, 0, 0, 0, 0, 0, 10, 49
"/opt/projects/swiftkube/vendor/k8s.io/client-go/applyconfigurations/admissionregistration/v1beta1/matchresources.go", "Go", 77, 0, 0, 0, 0, 0, 14, 91
"/opt/projects/swiftkube/vendor/k8s.io/client-go/applyconfigurations/admissionregistration/v1beta1/mutatingwebhook.go", "Go", 136, 0, 0, 0, 0, 0, 21, 157
"/opt/projects/swiftkube/vendor/k8s.io/client-go/applyconfigurations/admissionregistration/v1beta1/mutatingwebhookconfiguration.go", "Go", 223, 0, 0, 0, 0, 0, 30, 253
"/opt/projects/swiftkube/vendor/k8s.io/client-go/applyconfigurations/admissionregistration/v1beta1/namedrulewithoperations.go", "Go", 81, 0, 0, 0, 0, 0, 15, 96
"/opt/projects/swiftkube/vendor/k8s.io/client-go/applyconfigurations/admissionregistration/v1beta1/paramkind.go", "Go", 39, 0, 0, 0, 0, 0, 10, 49
"/opt/projects/swiftkube/vendor/k8s.io/client-go/applyconfigurations/admissionregistration/v1beta1/paramref.go", "Go", 59, 0, 0, 0, 0, 0, 13, 72
"/opt/projects/swiftkube/vendor/k8s.io/client-go/applyconfigurations/admissionregistration/v1beta1/servicereference.go", "Go", 55, 0, 0, 0, 0, 0, 12, 67
"/opt/projects/swiftkube/vendor/k8s.io/client-go/applyconfigurations/admissionregistration/v1beta1/typechecking.go", "Go", 36, 0, 0, 0, 0, 0, 9, 45
"/opt/projects/swiftkube/vendor/k8s.io/client-go/applyconfigurations/admissionregistration/v1beta1/validatingadmissionpolicy.go", "Go", 226, 0, 0, 0, 0, 0, 31, 257
"/opt/projects/swiftkube/vendor/k8s.io/client-go/applyconfigurations/admissionregistration/v1beta1/validatingadmissionpolicybinding.go", "Go", 218, 0, 0, 0, 0, 0, 30, 248
"/opt/projects/swiftkube/vendor/k8s.io/client-go/applyconfigurations/admissionregistration/v1beta1/validatingadmissionpolicybindingspec.go", "Go", 60, 0, 0, 0, 0, 0, 13, 73
"/opt/projects/swiftkube/vendor/k8s.io/client-go/applyconfigurations/admissionregistration/v1beta1/validatingadmissionpolicyspec.go", "Go", 102, 0, 0, 0, 0, 0, 16, 118
"/opt/projects/swiftkube/vendor/k8s.io/client-go/applyconfigurations/admissionregistration/v1beta1/validatingadmissionpolicystatus.go", "Go", 55, 0, 0, 0, 0, 0, 12, 67
"/opt/projects/swiftkube/vendor/k8s.io/client-go/applyconfigurations/admissionregistration/v1beta1/validatingwebhook.go", "Go", 128, 0, 0, 0, 0, 0, 20, 148
"/opt/projects/swiftkube/vendor/k8s.io/client-go/applyconfigurations/admissionregistration/v1beta1/validatingwebhookconfiguration.go", "Go", 223, 0, 0, 0, 0, 0, 30, 253
"/opt/projects/swiftkube/vendor/k8s.io/client-go/applyconfigurations/admissionregistration/v1beta1/validation.go", "Go", 58, 0, 0, 0, 0, 0, 13, 71
"/opt/projects/swiftkube/vendor/k8s.io/client-go/applyconfigurations/admissionregistration/v1beta1/variable.go", "Go", 39, 0, 0, 0, 0, 0, 10, 49
"/opt/projects/swiftkube/vendor/k8s.io/client-go/applyconfigurations/admissionregistration/v1beta1/webhookclientconfig.go", "Go", 49, 0, 0, 0, 0, 0, 11, 60
"/opt/projects/swiftkube/vendor/k8s.io/client-go/applyconfigurations/apiserverinternal/v1alpha1/serverstorageversion.go", "Go", 59, 0, 0, 0, 0, 0, 12, 71
"/opt/projects/swiftkube/vendor/k8s.io/client-go/applyconfigurations/apiserverinternal/v1alpha1/storageversion.go", "Go", 226, 0, 0, 0, 0, 0, 31, 257
"/opt/projects/swiftkube/vendor/k8s.io/client-go/applyconfigurations/apiserverinternal/v1alpha1/storageversioncondition.go", "Go", 75, 0, 0, 0, 0, 0, 15, 90
"/opt/projects/swiftkube/vendor/k8s.io/client-go/applyconfigurations/apiserverinternal/v1alpha1/storageversionstatus.go", "Go", 57, 0, 0, 0, 0, 0, 11, 68
"/opt/projects/swiftkube/vendor/k8s.io/client-go/applyconfigurations/apps/v1/controllerrevision.go", "Go", 229, 0, 0, 0, 0, 0, 31, 260
"/opt/projects/swiftkube/vendor/k8s.io/client-go/applyconfigurations/apps/v1/daemonset.go", "Go", 228, 0, 0, 0, 0, 0, 31, 259
"/opt/projects/swiftkube/vendor/k8s.io/client-go/applyconfigurations/apps/v1/daemonsetcondition.go", "Go", 68, 0, 0, 0, 0, 0, 14, 82
"/opt/projects/swiftkube/vendor/k8s.io/client-go/applyconfigurations/apps/v1/daemonsetspec.go", "Go", 67, 0, 0, 0, 0, 0, 14, 81
"/opt/projects/swiftkube/vendor/k8s.io/client-go/applyconfigurations/apps/v1/daemonsetstatus.go", "Go", 108, 0, 0, 0, 0, 0, 18, 126
"/opt/projects/swiftkube/vendor/k8s.io/client-go/applyconfigurations/apps/v1/daemonsetupdatestrategy.go", "Go", 42, 0, 0, 0, 0, 0, 11, 53
"/opt/projects/swiftkube/vendor/k8s.io/client-go/applyconfigurations/apps/v1/deployment.go", "Go", 228, 0, 0, 0, 0, 0, 31, 259
"/opt/projects/swiftkube/vendor/k8s.io/client-go/applyconfigurations/apps/v1/deploymentcondition.go", "Go", 76, 0, 0, 0, 0, 0, 15, 91
"/opt/projects/swiftkube/vendor/k8s.io/client-go/applyconfigurations/apps/v1/deploymentspec.go", "Go", 91, 0, 0, 0, 0, 0, 17, 108
"/opt/projects/swiftkube/vendor/k8s.io/client-go/applyconfigurations/apps/v1/deploymentstatus.go", "Go", 92, 0, 0, 0, 0, 0, 16, 108
"/opt/projects/swiftkube/vendor/k8s.io/client-go/applyconfigurations/apps/v1/deploymentstrategy.go", "Go", 42, 0, 0, 0, 0, 0, 11, 53
"/opt/projects/swiftkube/vendor/k8s.io/client-go/applyconfigurations/apps/v1/replicaset.go", "Go", 228, 0, 0, 0, 0, 0, 31, 259
"/opt/projects/swiftkube/vendor/k8s.io/client-go/applyconfigurations/apps/v1/replicasetcondition.go", "Go", 68, 0, 0, 0, 0, 0, 14, 82
"/opt/projects/swiftkube/vendor/k8s.io/client-go/applyconfigurations/apps/v1/replicasetspec.go", "Go", 59, 0, 0, 0, 0, 0, 13, 72
"/opt/projects/swiftkube/vendor/k8s.io/client-go/applyconfigurations/apps/v1/replicasetstatus.go", "Go", 76, 0, 0, 0, 0, 0, 14, 90
"/opt/projects/swiftkube/vendor/k8s.io/client-go/applyconfigurations/apps/v1/rollingupdatedaemonset.go", "Go", 42, 0, 0, 0, 0, 0, 11, 53
"/opt/projects/swiftkube/vendor/k8s.io/client-go/applyconfigurations/apps/v1/rollingupdatedeployment.go", "Go", 42, 0, 0, 0, 0, 0, 11, 53
"/opt/projects/swiftkube/vendor/k8s.io/client-go/applyconfigurations/apps/v1/rollingupdatestatefulsetstrategy.go", "Go", 42, 0, 0, 0, 0, 0, 11, 53
"/opt/projects/swiftkube/vendor/k8s.io/client-go/applyconfigurations/apps/v1/statefulset.go", "Go", 228, 0, 0, 0, 0, 0, 31, 259
"/opt/projects/swiftkube/vendor/k8s.io/client-go/applyconfigurations/apps/v1/statefulsetcondition.go", "Go", 68, 0, 0, 0, 0, 0, 14, 82
"/opt/projects/swiftkube/vendor/k8s.io/client-go/applyconfigurations/apps/v1/statefulsetordinals.go", "Go", 31, 0, 0, 0, 0, 0, 9, 40
"/opt/projects/swiftkube/vendor/k8s.io/client-go/applyconfigurations/apps/v1/statefulsetpersistentvolumeclaimretentionpolicy.go", "Go", 42, 0, 0, 0, 0, 0, 11, 53
"/opt/projects/swiftkube/vendor/k8s.io/client-go/applyconfigurations/apps/v1/statefulsetspec.go", "Go", 121, 0, 0, 0, 0, 0, 20, 141
"/opt/projects/swiftkube/vendor/k8s.io/client-go/applyconfigurations/apps/v1/statefulsetstatus.go", "Go", 108, 0, 0, 0, 0, 0, 18, 126
"/opt/projects/swiftkube/vendor/k8s.io/client-go/applyconfigurations/apps/v1/statefulsetupdatestrategy.go", "Go", 42, 0, 0, 0, 0, 0, 11, 53
"/opt/projects/swiftkube/vendor/k8s.io/client-go/applyconfigurations/apps/v1beta1/controllerrevision.go", "Go", 229, 0, 0, 0, 0, 0, 31, 260
"/opt/projects/swiftkube/vendor/k8s.io/client-go/applyconfigurations/apps/v1beta1/deployment.go", "Go", 228, 0, 0, 0, 0, 0, 31, 259
"/opt/projects/swiftkube/vendor/k8s.io/client-go/applyconfigurations/apps/v1beta1/deploymentcondition.go", "Go", 76, 0, 0, 0, 0, 0, 15, 91
"/opt/projects/swiftkube/vendor/k8s.io/client-go/applyconfigurations/apps/v1beta1/deploymentspec.go", "Go", 99, 0, 0, 0, 0, 0, 18, 117
"/opt/projects/swiftkube/vendor/k8s.io/client-go/applyconfigurations/apps/v1beta1/deploymentstatus.go", "Go", 92, 0, 0, 0, 0, 0, 16, 108
"/opt/projects/swiftkube/vendor/k8s.io/client-go/applyconfigurations/apps/v1beta1/deploymentstrategy.go", "Go", 42, 0, 0, 0, 0, 0, 11, 53
"/opt/projects/swiftkube/vendor/k8s.io/client-go/applyconfigurations/apps/v1beta1/rollbackconfig.go", "Go", 31, 0, 0, 0, 0, 0, 9, 40
"/opt/projects/swiftkube/vendor/k8s.io/client-go/applyconfigurations/apps/v1beta1/rollingupdatedeployment.go", "Go", 42, 0, 0, 0, 0, 0, 11, 53
"/opt/projects/swiftkube/vendor/k8s.io/client-go/applyconfigurations/apps/v1beta1/rollingupdatestatefulsetstrategy.go", "Go", 42, 0, 0, 0, 0, 0, 11, 53
"/opt/projects/swiftkube/vendor/k8s.io/client-go/applyconfigurations/apps/v1beta1/statefulset.go", "Go", 228, 0, 0, 0, 0, 0, 31, 259
"/opt/projects/swiftkube/vendor/k8s.io/client-go/applyconfigurations/apps/v1beta1/statefulsetcondition.go", "Go", 68, 0, 0, 0, 0, 0, 14, 82
"/opt/projects/swiftkube/vendor/k8s.io/client-go/applyconfigurations/apps/v1beta1/statefulsetordinals.go", "Go", 31, 0, 0, 0, 0, 0, 9, 40
"/opt/projects/swiftkube/vendor/k8s.io/client-go/applyconfigurations/apps/v1beta1/statefulsetpersistentvolumeclaimretentionpolicy.go", "Go", 42, 0, 0, 0, 0, 0, 11, 53
"/opt/projects/swiftkube/vendor/k8s.io/client-go/applyconfigurations/apps/v1beta1/statefulsetspec.go", "Go", 121, 0, 0, 0, 0, 0, 20, 141
"/opt/projects/swiftkube/vendor/k8s.io/client-go/applyconfigurations/apps/v1beta1/statefulsetstatus.go", "Go", 108, 0, 0, 0, 0, 0, 18, 126
"/opt/projects/swiftkube/vendor/k8s.io/client-go/applyconfigurations/apps/v1beta1/statefulsetupdatestrategy.go", "Go", 42, 0, 0, 0, 0, 0, 11, 53
"/opt/projects/swiftkube/vendor/k8s.io/client-go/applyconfigurations/apps/v1beta2/controllerrevision.go", "Go", 229, 0, 0, 0, 0, 0, 31, 260
"/opt/projects/swiftkube/vendor/k8s.io/client-go/applyconfigurations/apps/v1beta2/daemonset.go", "Go", 228, 0, 0, 0, 0, 0, 31, 259
"/opt/projects/swiftkube/vendor/k8s.io/client-go/applyconfigurations/apps/v1beta2/daemonsetcondition.go", "Go", 68, 0, 0, 0, 0, 0, 14, 82
"/opt/projects/swiftkube/vendor/k8s.io/client-go/applyconfigurations/apps/v1beta2/daemonsetspec.go", "Go", 67, 0, 0, 0, 0, 0, 14, 81
"/opt/projects/swiftkube/vendor/k8s.io/client-go/applyconfigurations/apps/v1beta2/daemonsetstatus.go", "Go", 108, 0, 0, 0, 0, 0, 18, 126
"/opt/projects/swiftkube/vendor/k8s.io/client-go/applyconfigurations/apps/v1beta2/daemonsetupdatestrategy.go", "Go", 42, 0, 0, 0, 0, 0, 11, 53
"/opt/projects/swiftkube/vendor/k8s.io/client-go/applyconfigurations/apps/v1beta2/deployment.go", "Go", 228, 0, 0, 0, 0, 0, 31, 259
"/opt/projects/swiftkube/vendor/k8s.io/client-go/applyconfigurations/apps/v1beta2/deploymentcondition.go", "Go", 76, 0, 0, 0, 0, 0, 15, 91
"/opt/projects/swiftkube/vendor/k8s.io/client-go/applyconfigurations/apps/v1beta2/deploymentspec.go", "Go", 91, 0, 0, 0, 0, 0, 17, 108
"/opt/projects/swiftkube/vendor/k8s.io/client-go/applyconfigurations/apps/v1beta2/deploymentstatus.go", "Go", 92, 0, 0, 0, 0, 0, 16, 108
"/opt/projects/swiftkube/vendor/k8s.io/client-go/applyconfigurations/apps/v1beta2/deploymentstrategy.go", "Go", 42, 0, 0, 0, 0, 0, 11, 53
"/opt/projects/swiftkube/vendor/k8s.io/client-go/applyconfigurations/apps/v1beta2/replicaset.go", "Go", 228, 0, 0, 0, 0, 0, 31, 259
"/opt/projects/swiftkube/vendor/k8s.io/client-go/applyconfigurations/apps/v1beta2/replicasetcondition.go", "Go", 68, 0, 0, 0, 0, 0, 14, 82
"/opt/projects/swiftkube/vendor/k8s.io/client-go/applyconfigurations/apps/v1beta2/replicasetspec.go", "Go", 59, 0, 0, 0, 0, 0, 13, 72
"/opt/projects/swiftkube/vendor/k8s.io/client-go/applyconfigurations/apps/v1beta2/replicasetstatus.go", "Go", 76, 0, 0, 0, 0, 0, 14, 90
"/opt/projects/swiftkube/vendor/k8s.io/client-go/applyconfigurations/apps/v1beta2/rollingupdatedaemonset.go", "Go", 42, 0, 0, 0, 0, 0, 11, 53
"/opt/projects/swiftkube/vendor/k8s.io/client-go/applyconfigurations/apps/v1beta2/rollingupdatedeployment.go", "Go", 42, 0, 0, 0, 0, 0, 11, 53
"/opt/projects/swiftkube/vendor/k8s.io/client-go/applyconfigurations/apps/v1beta2/rollingupdatestatefulsetstrategy.go", "Go", 42, 0, 0, 0, 0, 0, 11, 53
"/opt/projects/swiftkube/vendor/k8s.io/client-go/applyconfigurations/apps/v1beta2/scale.go", "Go", 192, 0, 0, 0, 0, 0, 27, 219
"/opt/projects/swiftkube/vendor/k8s.io/client-go/applyconfigurations/apps/v1beta2/statefulset.go", "Go", 228, 0, 0, 0, 0, 0, 31, 259
"/opt/projects/swiftkube/vendor/k8s.io/client-go/applyconfigurations/apps/v1beta2/statefulsetcondition.go", "Go", 68, 0, 0, 0, 0, 0, 14, 82
"/opt/projects/swiftkube/vendor/k8s.io/client-go/applyconfigurations/apps/v1beta2/statefulsetordinals.go", "Go", 31, 0, 0, 0, 0, 0, 9, 40
"/opt/projects/swiftkube/vendor/k8s.io/client-go/applyconfigurations/apps/v1beta2/statefulsetpersistentvolumeclaimretentionpolicy.go", "Go", 42, 0, 0, 0, 0, 0, 11, 53
"/opt/projects/swiftkube/vendor/k8s.io/client-go/applyconfigurations/apps/v1beta2/statefulsetspec.go", "Go", 121, 0, 0, 0, 0, 0, 20, 141
"/opt/projects/swiftkube/vendor/k8s.io/client-go/applyconfigurations/apps/v1beta2/statefulsetstatus.go", "Go", 108, 0, 0, 0, 0, 0, 18, 126
"/opt/projects/swiftkube/vendor/k8s.io/client-go/applyconfigurations/apps/v1beta2/statefulsetupdatestrategy.go", "Go", 42, 0, 0, 0, 0, 0, 11, 53
"/opt/projects/swiftkube/vendor/k8s.io/client-go/applyconfigurations/autoscaling/v1/crossversionobjectreference.go", "Go", 47, 0, 0, 0, 0, 0, 11, 58
"/opt/projects/swiftkube/vendor/k8s.io/client-go/applyconfigurations/autoscaling/v1/horizontalpodautoscaler.go", "Go", 228, 0, 0, 0, 0, 0, 31, 259
"/opt/projects/swiftkube/vendor/k8s.io/client-go/applyconfigurations/autoscaling/v1/horizontalpodautoscalerspec.go", "Go", 55, 0, 0, 0, 0, 0, 12, 67
"/opt/projects/swiftkube/vendor/k8s.io/client-go/applyconfigurations/autoscaling/v1/horizontalpodautoscalerstatus.go", "Go", 66, 0, 0, 0, 0, 0, 14, 80
"/opt/projects/swiftkube/vendor/k8s.io/client-go/applyconfigurations/autoscaling/v1/scale.go", "Go", 191, 0, 0, 0, 0, 0, 27, 218
"/opt/projects/swiftkube/vendor/k8s.io/client-go/applyconfigurations/autoscaling/v1/scalespec.go", "Go", 31, 0, 0, 0, 0, 0, 9, 40
"/opt/projects/swiftkube/vendor/k8s.io/client-go/applyconfigurations/autoscaling/v1/scalestatus.go", "Go", 39, 0, 0, 0, 0, 0, 10, 49
"/opt/projects/swiftkube/vendor/k8s.io/client-go/applyconfigurations/autoscaling/v2/containerresourcemetricsource.go", "Go", 50, 0, 0, 0, 0, 0, 12, 62
"/opt/projects/swiftkube/vendor/k8s.io/client-go/applyconfigurations/autoscaling/v2/containerresourcemetricstatus.go", "Go", 50, 0, 0, 0, 0, 0, 12, 62
"/opt/projects/swiftkube/vendor/k8s.io/client-go/applyconfigurations/autoscaling/v2/crossversionobjectreference.go", "Go", 47, 0, 0, 0, 0, 0, 11, 58
"/opt/projects/swiftkube/vendor/k8s.io/client-go/applyconfigurations/autoscaling/v2/externalmetricsource.go", "Go", 39, 0, 0, 0, 0, 0, 10, 49
"/opt/projects/swiftkube/vendor/k8s.io/client-go/applyconfigurations/autoscaling/v2/externalmetricstatus.go", "Go", 39, 0, 0, 0, 0, 0, 10, 49
"/opt/projects/swiftkube/vendor/k8s.io/client-go/applyconfigurations/autoscaling/v2/horizontalpodautoscaler.go", "Go", 228, 0, 0, 0, 0, 0, 31, 259
"/opt/projects/swiftkube/vendor/k8s.io/client-go/applyconfigurations/autoscaling/v2/horizontalpodautoscalerbehavior.go", "Go", 39, 0, 0, 0, 0, 0, 10, 49
"/opt/projects/swiftkube/vendor/k8s.io/client-go/applyconfigurations/autoscaling/v2/horizontalpodautoscalercondition.go", "Go", 68, 0, 0, 0, 0, 0, 14, 82
"/opt/projects/swiftkube/vendor/k8s.io/client-go/applyconfigurations/autoscaling/v2/horizontalpodautoscalerspec.go", "Go", 68, 0, 0, 0, 0, 0, 13, 81
"/opt/projects/swiftkube/vendor/k8s.io/client-go/applyconfigurations/autoscaling/v2/horizontalpodautoscalerstatus.go", "Go", 84, 0, 0, 0, 0, 0, 15, 99
"/opt/projects/swiftkube/vendor/k8s.io/client-go/applyconfigurations/autoscaling/v2/hpascalingpolicy.go", "Go", 50, 0, 0, 0, 0, 0, 12, 62
"/opt/projects/swiftkube/vendor/k8s.io/client-go/applyconfigurations/autoscaling/v2/hpascalingrules.go", "Go", 55, 0, 0, 0, 0, 0, 12, 67
"/opt/projects/swiftkube/vendor/k8s.io/client-go/applyconfigurations/autoscaling/v2/metricidentifier.go", "Go", 42, 0, 0, 0, 0, 0, 11, 53
"/opt/projects/swiftkube/vendor/k8s.io/client-go/applyconfigurations/autoscaling/v2/metricspec.go", "Go", 74, 0, 0, 0, 0, 0, 15, 89
"/opt/projects/swiftkube/vendor/k8s.io/client-go/applyconfigurations/autoscaling/v2/metricstatus.go", "Go", 74, 0, 0, 0, 0, 0, 15, 89
"/opt/projects/swiftkube/vendor/k8s.io/client-go/applyconfigurations/autoscaling/v2/metrictarget.go", "Go", 59, 0, 0, 0, 0, 0, 13, 72
"/opt/projects/swiftkube/vendor/k8s.io/client-go/applyconfigurations/autoscaling/v2/metricvaluestatus.go", "Go", 50, 0, 0, 0, 0, 0, 12, 62
"/opt/projects/swiftkube/vendor/k8s.io/client-go/applyconfigurations/autoscaling/v2/objectmetricsource.go", "Go", 47, 0, 0, 0, 0, 0, 11, 58
"/opt/projects/swiftkube/vendor/k8s.io/client-go/applyconfigurations/autoscaling/v2/objectmetricstatus.go", "Go", 47, 0, 0, 0, 0, 0, 11, 58
"/opt/projects/swiftkube/vendor/k8s.io/client-go/applyconfigurations/autoscaling/v2/podsmetricsource.go", "Go", 39, 0, 0, 0, 0, 0, 10, 49
"/opt/projects/swiftkube/vendor/k8s.io/client-go/applyconfigurations/autoscaling/v2/podsmetricstatus.go", "Go", 39, 0, 0, 0, 0, 0, 10, 49
"/opt/projects/swiftkube/vendor/k8s.io/client-go/applyconfigurations/autoscaling/v2/resourcemetricsource.go", "Go", 42, 0, 0, 0, 0, 0, 11, 53
"/opt/projects/swiftkube/vendor/k8s.io/client-go/applyconfigurations/autoscaling/v2/resourcemetricstatus.go", "Go", 42, 0, 0, 0, 0, 0, 11, 53
"/opt/projects/swiftkube/vendor/k8s.io/client-go/applyconfigurations/autoscaling/v2beta1/containerresourcemetricsource.go", "Go", 59, 0, 0, 0, 0, 0, 13, 72
"/opt/projects/swiftkube/vendor/k8s.io/client-go/applyconfigurations/autoscaling/v2beta1/containerresourcemetricstatus.go", "Go", 59, 0, 0, 0, 0, 0, 13, 72
"/opt/projects/swiftkube/vendor/k8s.io/client-go/applyconfigurations/autoscaling/v2beta1/crossversionobjectreference.go", "Go", 47, 0, 0, 0, 0, 0, 11, 58
"/opt/projects/swiftkube/vendor/k8s.io/client-go/applyconfigurations/autoscaling/v2beta1/externalmetricsource.go", "Go", 59, 0, 0, 0, 0, 0, 13, 72
"/opt/projects/swiftkube/vendor/k8s.io/client-go/applyconfigurations/autoscaling/v2beta1/externalmetricstatus.go", "Go", 59, 0, 0, 0, 0, 0, 13, 72
"/opt/projects/swiftkube/vendor/k8s.io/client-go/applyconfigurations/autoscaling/v2beta1/horizontalpodautoscaler.go", "Go", 228, 0, 0, 0, 0, 0, 31, 259
"/opt/projects/swiftkube/vendor/k8s.io/client-go/applyconfigurations/autoscaling/v2beta1/horizontalpodautoscalercondition.go", "Go", 68, 0, 0, 0, 0, 0, 14, 82
"/opt/projects/swiftkube/vendor/k8s.io/client-go/applyconfigurations/autoscaling/v2beta1/horizontalpodautoscalerspec.go", "Go", 60, 0, 0, 0, 0, 0, 12, 72
"/opt/projects/swiftkube/vendor/k8s.io/client-go/applyconfigurations/autoscaling/v2beta1/horizontalpodautoscalerstatus.go", "Go", 84, 0, 0, 0, 0, 0, 15, 99
"/opt/projects/swiftkube/vendor/k8s.io/client-go/applyconfigurations/autoscaling/v2beta1/metricspec.go", "Go", 74, 0, 0, 0, 0, 0, 15, 89
"/opt/projects/swiftkube/vendor/k8s.io/client-go/applyconfigurations/autoscaling/v2beta1/metricstatus.go", "Go", 74, 0, 0, 0, 0, 0, 15, 89
"/opt/projects/swiftkube/vendor/k8s.io/client-go/applyconfigurations/autoscaling/v2beta1/objectmetricsource.go", "Go", 67, 0, 0, 0, 0, 0, 14, 81
"/opt/projects/swiftkube/vendor/k8s.io/client-go/applyconfigurations/autoscaling/v2beta1/objectmetricstatus.go", "Go", 67, 0, 0, 0, 0, 0, 14, 81
"/opt/projects/swiftkube/vendor/k8s.io/client-go/applyconfigurations/autoscaling/v2beta1/podsmetricsource.go", "Go", 51, 0, 0, 0, 0, 0, 12, 63
"/opt/projects/swiftkube/vendor/k8s.io/client-go/applyconfigurations/autoscaling/v2beta1/podsmetricstatus.go", "Go", 51, 0, 0, 0, 0, 0, 12, 63
"/opt/projects/swiftkube/vendor/k8s.io/client-go/applyconfigurations/autoscaling/v2beta1/resourcemetricsource.go", "Go", 51, 0, 0, 0, 0, 0, 12, 63
"/opt/projects/swiftkube/vendor/k8s.io/client-go/applyconfigurations/autoscaling/v2beta1/resourcemetricstatus.go", "Go", 51, 0, 0, 0, 0, 0, 12, 63
"/opt/projects/swiftkube/vendor/k8s.io/client-go/applyconfigurations/autoscaling/v2beta2/containerresourcemetricsource.go", "Go", 50, 0, 0, 0, 0, 0, 12, 62
"/opt/projects/swiftkube/vendor/k8s.io/client-go/applyconfigurations/autoscaling/v2beta2/containerresourcemetricstatus.go", "Go", 50, 0, 0, 0, 0, 0, 12, 62
"/opt/projects/swiftkube/vendor/k8s.io/client-go/applyconfigurations/autoscaling/v2beta2/crossversionobjectreference.go", "Go", 47, 0, 0, 0, 0, 0, 11, 58
"/opt/projects/swiftkube/vendor/k8s.io/client-go/applyconfigurations/autoscaling/v2beta2/externalmetricsource.go", "Go", 39, 0, 0, 0, 0, 0, 10, 49
"/opt/projects/swiftkube/vendor/k8s.io/client-go/applyconfigurations/autoscaling/v2beta2/externalmetricstatus.go", "Go", 39, 0, 0, 0, 0, 0, 10, 49
"/opt/projects/swiftkube/vendor/k8s.io/client-go/applyconfigurations/autoscaling/v2beta2/horizontalpodautoscaler.go", "Go", 228, 0, 0, 0, 0, 0, 31, 259
"/opt/projects/swiftkube/vendor/k8s.io/client-go/applyconfigurations/autoscaling/v2beta2/horizontalpodautoscalerbehavior.go", "Go", 39, 0, 0, 0, 0, 0, 10, 49
"/opt/projects/swiftkube/vendor/k8s.io/client-go/applyconfigurations/autoscaling/v2beta2/horizontalpodautoscalercondition.go", "Go", 68, 0, 0, 0, 0, 0, 14, 82
"/opt/projects/swiftkube/vendor/k8s.io/client-go/applyconfigurations/autoscaling/v2beta2/horizontalpodautoscalerspec.go", "Go", 68, 0, 0, 0, 0, 0, 13, 81
"/opt/projects/swiftkube/vendor/k8s.io/client-go/applyconfigurations/autoscaling/v2beta2/horizontalpodautoscalerstatus.go", "Go", 84, 0, 0, 0, 0, 0, 15, 99
"/opt/projects/swiftkube/vendor/k8s.io/client-go/applyconfigurations/autoscaling/v2beta2/hpascalingpolicy.go", "Go", 50, 0, 0, 0, 0, 0, 12, 62
"/opt/projects/swiftkube/vendor/k8s.io/client-go/applyconfigurations/autoscaling/v2beta2/hpascalingrules.go", "Go", 55, 0, 0, 0, 0, 0, 12, 67
"/opt/projects/swiftkube/vendor/k8s.io/client-go/applyconfigurations/autoscaling/v2beta2/metricidentifier.go", "Go", 42, 0, 0, 0, 0, 0, 11, 53
"/opt/projects/swiftkube/vendor/k8s.io/client-go/applyconfigurations/autoscaling/v2beta2/metricspec.go", "Go", 74, 0, 0, 0, 0, 0, 15, 89
"/opt/projects/swiftkube/vendor/k8s.io/client-go/applyconfigurations/autoscaling/v2beta2/metricstatus.go", "Go", 74, 0, 0, 0, 0, 0, 15, 89
"/opt/projects/swiftkube/vendor/k8s.io/client-go/applyconfigurations/autoscaling/v2beta2/metrictarget.go", "Go", 59, 0, 0, 0, 0, 0, 13, 72
"/opt/projects/swiftkube/vendor/k8s.io/client-go/applyconfigurations/autoscaling/v2beta2/metricvaluestatus.go", "Go", 50, 0, 0, 0, 0, 0, 12, 62
"/opt/projects/swiftkube/vendor/k8s.io/client-go/applyconfigurations/autoscaling/v2beta2/objectmetricsource.go", "Go", 47, 0, 0, 0, 0, 0, 11, 58
"/opt/projects/swiftkube/vendor/k8s.io/client-go/applyconfigurations/autoscaling/v2beta2/objectmetricstatus.go", "Go", 47, 0, 0, 0, 0, 0, 11, 58
"/opt/projects/swiftkube/vendor/k8s.io/client-go/applyconfigurations/autoscaling/v2beta2/podsmetricsource.go", "Go", 39, 0, 0, 0, 0, 0, 10, 49
"/opt/projects/swiftkube/vendor/k8s.io/client-go/applyconfigurations/autoscaling/v2beta2/podsmetricstatus.go", "Go", 39, 0, 0, 0, 0, 0, 10, 49
"/opt/projects/swiftkube/vendor/k8s.io/client-go/applyconfigurations/autoscaling/v2beta2/resourcemetricsource.go", "Go", 42, 0, 0, 0, 0, 0, 11, 53
"/opt/projects/swiftkube/vendor/k8s.io/client-go/applyconfigurations/autoscaling/v2beta2/resourcemetricstatus.go", "Go", 42, 0, 0, 0, 0, 0, 11, 53
"/opt/projects/swiftkube/vendor/k8s.io/client-go/applyconfigurations/batch/v1/cronjob.go", "Go", 228, 0, 0, 0, 0, 0, 31, 259
"/opt/projects/swiftkube/vendor/k8s.io/client-go/applyconfigurations/batch/v1/cronjobspec.go", "Go", 90, 0, 0, 0, 0, 0, 17, 107
"/opt/projects/swiftkube/vendor/k8s.io/client-go/applyconfigurations/batch/v1/cronjobstatus.go", "Go", 56, 0, 0, 0, 0, 0, 12, 68
"/opt/projects/swiftkube/vendor/k8s.io/client-go/applyconfigurations/batch/v1/job.go", "Go", 228, 0, 0, 0, 0, 0, 31, 259
"/opt/projects/swiftkube/vendor/k8s.io/client-go/applyconfigurations/batch/v1/jobcondition.go", "Go", 76, 0, 0, 0, 0, 0, 15, 91
"/opt/projects/swiftkube/vendor/k8s.io/client-go/applyconfigurations/batch/v1/jobspec.go", "Go", 140, 0, 0, 0, 0, 0, 23, 163
"/opt/projects/swiftkube/vendor/k8s.io/client-go/applyconfigurations/batch/v1/jobstatus.go", "Go", 119, 0, 0, 0, 0, 0, 20, 139
"/opt/projects/swiftkube/vendor/k8s.io/client-go/applyconfigurations/batch/v1/jobtemplatespec.go", "Go", 165, 0, 0, 0, 0, 0, 24, 189
"/opt/projects/swiftkube/vendor/k8s.io/client-go/applyconfigurations/batch/v1/podfailurepolicy.go", "Go", 36, 0, 0, 0, 0, 0, 9, 45
"/opt/projects/swiftkube/vendor/k8s.io/client-go/applyconfigurations/batch/v1/podfailurepolicyonexitcodesrequirement.go", "Go", 52, 0, 0, 0, 0, 0, 12, 64
"/opt/projects/swiftkube/vendor/k8s.io/client-go/applyconfigurations/batch/v1/podfailurepolicyonpodconditionspattern.go", "Go", 42, 0, 0, 0, 0, 0, 11, 53
"/opt/projects/swiftkube/vendor/k8s.io/client-go/applyconfigurations/batch/v1/podfailurepolicyrule.go", "Go", 55, 0, 0, 0, 0, 0, 12, 67
"/opt/projects/swiftkube/vendor/k8s.io/client-go/applyconfigurations/batch/v1/uncountedterminatedpods.go", "Go", 46, 0, 0, 0, 0, 0, 11, 57
"/opt/projects/swiftkube/vendor/k8s.io/client-go/applyconfigurations/batch/v1beta1/cronjob.go", "Go", 228, 0, 0, 0, 0, 0, 31, 259
"/opt/projects/swiftkube/vendor/k8s.io/client-go/applyconfigurations/batch/v1beta1/cronjobspec.go", "Go", 90, 0, 0, 0, 0, 0, 17, 107
"/opt/projects/swiftkube/vendor/k8s.io/client-go/applyconfigurations/batch/v1beta1/cronjobstatus.go", "Go", 56, 0, 0, 0, 0, 0, 12, 68
"/opt/projects/swiftkube/vendor/k8s.io/client-go/applyconfigurations/batch/v1beta1/jobtemplatespec.go", "Go", 166, 0, 0, 0, 0, 0, 24, 190
"/opt/projects/swiftkube/vendor/k8s.io/client-go/applyconfigurations/certificates/v1/certificatesigningrequest.go", "Go", 226, 0, 0, 0, 0, 0, 31, 257
"/opt/projects/swiftkube/vendor/k8s.io/client-go/applyconfigurations/certificates/v1/certificatesigningrequestcondition.go", "Go", 76, 0, 0, 0, 0, 0, 15, 91
"/opt/projects/swiftkube/vendor/k8s.io/client-go/applyconfigurations/certificates/v1/certificatesigningrequestspec.go", "Go", 102, 0, 0, 0, 0, 0, 17, 119
"/opt/projects/swiftkube/vendor/k8s.io/client-go/applyconfigurations/certificates/v1/certificatesigningrequeststatus.go", "Go", 46, 0, 0, 0, 0, 0, 10, 56
"/opt/projects/swiftkube/vendor/k8s.io/client-go/applyconfigurations/certificates/v1alpha1/clustertrustbundle.go", "Go", 218, 0, 0, 0, 0, 0, 30, 248
"/opt/projects/swiftkube/vendor/k8s.io/client-go/applyconfigurations/certificates/v1alpha1/clustertrustbundlespec.go", "Go", 39, 0, 0, 0, 0, 0, 10, 49
"/opt/projects/swiftkube/vendor/k8s.io/client-go/applyconfigurations/certificates/v1beta1/certificatesigningrequest.go", "Go", 226, 0, 0, 0, 0, 0, 31, 257
"/opt/projects/swiftkube/vendor/k8s.io/client-go/applyconfigurations/certificates/v1beta1/certificatesigningrequestcondition.go", "Go", 76, 0, 0, 0, 0, 0, 15, 91
"/opt/projects/swiftkube/vendor/k8s.io/client-go/applyconfigurations/certificates/v1beta1/certificatesigningrequestspec.go", "Go", 102, 0, 0, 0, 0, 0, 17, 119
"/opt/projects/swiftkube/vendor/k8s.io/client-go/applyconfigurations/certificates/v1beta1/certificatesigningrequeststatus.go", "Go", 46, 0, 0, 0, 0, 0, 10, 56
"/opt/projects/swiftkube/vendor/k8s.io/client-go/applyconfigurations/coordination/v1/lease.go", "Go", 220, 0, 0, 0, 0, 0, 30, 250
"/opt/projects/swiftkube/vendor/k8s.io/client-go/applyconfigurations/coordination/v1/leasespec.go", "Go", 66, 0, 0, 0, 0, 0, 14, 80
"/opt/projects/swiftkube/vendor/k8s.io/client-go/applyconfigurations/coordination/v1beta1/lease.go", "Go", 220, 0, 0, 0, 0, 0, 30, 250
"/opt/projects/swiftkube/vendor/k8s.io/client-go/applyconfigurations/coordination/v1beta1/leasespec.go", "Go", 66, 0, 0, 0, 0, 0, 14, 80
"/opt/projects/swiftkube/vendor/k8s.io/client-go/applyconfigurations/core/v1/affinity.go", "Go", 47, 0, 0, 0, 0, 0, 11, 58
"/opt/projects/swiftkube/vendor/k8s.io/client-go/applyconfigurations/core/v1/attachedvolume.go", "Go", 42, 0, 0, 0, 0, 0, 11, 53
"/opt/projects/swiftkube/vendor/k8s.io/client-go/applyconfigurations/core/v1/awselasticblockstorevolumesource.go", "Go", 55, 0, 0, 0, 0, 0, 12, 67
"/opt/projects/swiftkube/vendor/k8s.io/client-go/applyconfigurations/core/v1/azurediskvolumesource.go", "Go", 74, 0, 0, 0, 0, 0, 15, 89
"/opt/projects/swiftkube/vendor/k8s.io/client-go/applyconfigurations/core/v1/azurefilepersistentvolumesource.go", "Go", 55, 0, 0, 0, 0, 0, 12, 67
"/opt/projects/swiftkube/vendor/k8s.io/client-go/applyconfigurations/core/v1/azurefilevolumesource.go", "Go", 47, 0, 0, 0, 0, 0, 11, 58
"/opt/projects/swiftkube/vendor/k8s.io/client-go/applyconfigurations/core/v1/capabilities.go", "Go", 46, 0, 0, 0, 0, 0, 11, 57
"/opt/projects/swiftkube/vendor/k8s.io/client-go/applyconfigurations/core/v1/cephfspersistentvolumesource.go", "Go", 73, 0, 0, 0, 0, 0, 14, 87
"/opt/projects/swiftkube/vendor/k8s.io/client-go/applyconfigurations/core/v1/cephfsvolumesource.go", "Go", 73, 0, 0, 0, 0, 0, 14, 87
"/opt/projects/swiftkube/vendor/k8s.io/client-go/applyconfigurations/core/v1/cinderpersistentvolumesource.go", "Go", 55, 0, 0, 0, 0, 0, 12, 67
"/opt/projects/swiftkube/vendor/k8s.io/client-go/applyconfigurations/core/v1/cindervolumesource.go", "Go", 55, 0, 0, 0, 0, 0, 12, 67
"/opt/projects/swiftkube/vendor/k8s.io/client-go/applyconfigurations/core/v1/claimsource.go", "Go", 39, 0, 0, 0, 0, 0, 10, 49
"/opt/projects/swiftkube/vendor/k8s.io/client-go/applyconfigurations/core/v1/clientipconfig.go", "Go", 31, 0, 0, 0, 0, 0, 9, 40
"/opt/projects/swiftkube/vendor/k8s.io/client-go/applyconfigurations/core/v1/componentcondition.go", "Go", 58, 0, 0, 0, 0, 0, 13, 71
"/opt/projects/swiftkube/vendor/k8s.io/client-go/applyconfigurations/core/v1/componentstatus.go", "Go", 223, 0, 0, 0, 0, 0, 30, 253
"/opt/projects/swiftkube/vendor/k8s.io/client-go/applyconfigurations/core/v1/configmap.go", "Go", 248, 0, 0, 0, 0, 0, 32, 280
"/opt/projects/swiftkube/vendor/k8s.io/client-go/applyconfigurations/core/v1/configmapenvsource.go", "Go", 39, 0, 0, 0, 0, 0, 10, 49
"/opt/projects/swiftkube/vendor/k8s.io/client-go/applyconfigurations/core/v1/configmapkeyselector.go", "Go", 47, 0, 0, 0, 0, 0, 11, 58
"/opt/projects/swiftkube/vendor/k8s.io/client-go/applyconfigurations/core/v1/configmapnodeconfigsource.go", "Go", 66, 0, 0, 0, 0, 0, 14, 80
"/opt/projects/swiftkube/vendor/k8s.io/client-go/applyconfigurations/core/v1/configmapprojection.go", "Go", 52, 0, 0, 0, 0, 0, 11, 63
"/opt/projects/swiftkube/vendor/k8s.io/client-go/applyconfigurations/core/v1/configmapvolumesource.go", "Go", 60, 0, 0, 0, 0, 0, 12, 72
"/opt/projects/swiftkube/vendor/k8s.io/client-go/applyconfigurations/core/v1/container.go", "Go", 252, 0, 0, 0, 0, 0, 33, 285
"/opt/projects/swiftkube/vendor/k8s.io/client-go/applyconfigurations/core/v1/containerimage.go", "Go", 41, 0, 0, 0, 0, 0, 10, 51
"/opt/projects/swiftkube/vendor/k8s.io/client-go/applyconfigurations/core/v1/containerport.go", "Go", 66, 0, 0, 0, 0, 0, 14, 80
"/opt/projects/swiftkube/vendor/k8s.io/client-go/applyconfigurations/core/v1/containerresizepolicy.go", "Go", 42, 0, 0, 0, 0, 0, 11, 53
"/opt/projects/swiftkube/vendor/k8s.io/client-go/applyconfigurations/core/v1/containerstate.go", "Go", 47, 0, 0, 0, 0, 0, 11, 58
"/opt/projects/swiftkube/vendor/k8s.io/client-go/applyconfigurations/core/v1/containerstaterunning.go", "Go", 34, 0, 0, 0, 0, 0, 10, 44
"/opt/projects/swiftkube/vendor/k8s.io/client-go/applyconfigurations/core/v1/containerstateterminated.go", "Go", 82, 0, 0, 0, 0, 0, 16, 98
"/opt/projects/swiftkube/vendor/k8s.io/client-go/applyconfigurations/core/v1/containerstatewaiting.go", "Go", 39, 0, 0, 0, 0, 0, 10, 49
"/opt/projects/swiftkube/vendor/k8s.io/client-go/applyconfigurations/core/v1/containerstatus.go", "Go", 114, 0, 0, 0, 0, 0, 20, 134
"/opt/projects/swiftkube/vendor/k8s.io/client-go/applyconfigurations/core/v1/csipersistentvolumesource.go", "Go", 109, 0, 0, 0, 0, 0, 18, 127
"/opt/projects/swiftkube/vendor/k8s.io/client-go/applyconfigurations/core/v1/csivolumesource.go", "Go", 69, 0, 0, 0, 0, 0, 13, 82
"/opt/projects/swiftkube/vendor/k8s.io/client-go/applyconfigurations/core/v1/daemonendpoint.go", "Go", 31, 0, 0, 0, 0, 0, 9, 40
"/opt/projects/swiftkube/vendor/k8s.io/client-go/applyconfigurations/core/v1/downwardapiprojection.go", "Go", 36, 0, 0, 0, 0, 0, 9, 45
"/opt/projects/swiftkube/vendor/k8s.io/client-go/applyconfigurations/core/v1/downwardapivolumefile.go", "Go", 55, 0, 0, 0, 0, 0, 12, 67
"/opt/projects/swiftkube/vendor/k8s.io/client-go/applyconfigurations/core/v1/downwardapivolumesource.go", "Go", 44, 0, 0, 0, 0, 0, 10, 54
"/opt/projects/swiftkube/vendor/k8s.io/client-go/applyconfigurations/core/v1/emptydirvolumesource.go", "Go", 43, 0, 0, 0, 0, 0, 11, 54
"/opt/projects/swiftkube/vendor/k8s.io/client-go/applyconfigurations/core/v1/endpointaddress.go", "Go", 55, 0, 0, 0, 0, 0, 12, 67
"/opt/projects/swiftkube/vendor/k8s.io/client-go/applyconfigurations/core/v1/endpointport.go", "Go", 58, 0, 0, 0, 0, 0, 13, 71
"/opt/projects/swiftkube/vendor/k8s.io/client-go/applyconfigurations/core/v1/endpoints.go", "Go", 225, 0, 0, 0, 0, 0, 30, 255
"/opt/projects/swiftkube/vendor/k8s.io/client-go/applyconfigurations/core/v1/endpointsubset.go", "Go", 62, 0, 0, 0, 0, 0, 11, 73
"/opt/projects/swiftkube/vendor/k8s.io/client-go/applyconfigurations/core/v1/envfromsource.go", "Go", 47, 0, 0, 0, 0, 0, 11, 58
"/opt/projects/swiftkube/vendor/k8s.io/client-go/applyconfigurations/core/v1/envvar.go", "Go", 47, 0, 0, 0, 0, 0, 11, 58
"/opt/projects/swiftkube/vendor/k8s.io/client-go/applyconfigurations/core/v1/envvarsource.go", "Go", 55, 0, 0, 0, 0, 0, 12, 67
"/opt/projects/swiftkube/vendor/k8s.io/client-go/applyconfigurations/core/v1/ephemeralcontainer.go", "Go", 237, 0, 0, 0, 0, 0, 34, 271
"/opt/projects/swiftkube/vendor/k8s.io/client-go/applyconfigurations/core/v1/ephemeralcontainercommon.go", "Go", 252, 0, 0, 0, 0, 0, 33, 285
"/opt/projects/swiftkube/vendor/k8s.io/client-go/applyconfigurations/core/v1/ephemeralvolumesource.go", "Go", 31, 0, 0, 0, 0, 0, 9, 40
"/opt/projects/swiftkube/vendor/k8s.io/client-go/applyconfigurations/core/v1/event.go", "Go", 324, 0, 0, 0, 0, 0, 43, 367
"/opt/projects/swiftkube/vendor/k8s.io/client-go/applyconfigurations/core/v1/eventseries.go", "Go", 42, 0, 0, 0, 0, 0, 11, 53
"/opt/projects/swiftkube/vendor/k8s.io/client-go/applyconfigurations/core/v1/eventsource.go", "Go", 39, 0, 0, 0, 0, 0, 10, 49
"/opt/projects/swiftkube/vendor/k8s.io/client-go/applyconfigurations/core/v1/execaction.go", "Go", 33, 0, 0, 0, 0, 0, 9, 42
"/opt/projects/swiftkube/vendor/k8s.io/client-go/applyconfigurations/core/v1/fcvolumesource.go", "Go", 67, 0, 0, 0, 0, 0, 13, 80
"/opt/projects/swiftkube/vendor/k8s.io/client-go/applyconfigurations/core/v1/flexpersistentvolumesource.go", "Go", 69, 0, 0, 0, 0, 0, 13, 82
"/opt/projects/swiftkube/vendor/k8s.io/client-go/applyconfigurations/core/v1/flexvolumesource.go", "Go", 69, 0, 0, 0, 0, 0, 13, 82
"/opt/projects/swiftkube/vendor/k8s.io/client-go/applyconfigurations/core/v1/flockervolumesource.go", "Go", 39, 0, 0, 0, 0, 0, 10, 49
"/opt/projects/swiftkube/vendor/k8s.io/client-go/applyconfigurations/core/v1/gcepersistentdiskvolumesource.go", "Go", 55, 0, 0, 0, 0, 0, 12, 67
"/opt/projects/swiftkube/vendor/k8s.io/client-go/applyconfigurations/core/v1/gitrepovolumesource.go", "Go", 47, 0, 0, 0, 0, 0, 11, 58
"/opt/projects/swiftkube/vendor/k8s.io/client-go/applyconfigurations/core/v1/glusterfspersistentvolumesource.go", "Go", 55, 0, 0, 0, 0, 0, 12, 67
"/opt/projects/swiftkube/vendor/k8s.io/client-go/applyconfigurations/core/v1/glusterfsvolumesource.go", "Go", 47, 0, 0, 0, 0, 0, 11, 58
"/opt/projects/swiftkube/vendor/k8s.io/client-go/applyconfigurations/core/v1/grpcaction.go", "Go", 39, 0, 0, 0, 0, 0, 10, 49
"/opt/projects/swiftkube/vendor/k8s.io/client-go/applyconfigurations/core/v1/hostalias.go", "Go", 41, 0, 0, 0, 0, 0, 10, 51
"/opt/projects/swiftkube/vendor/k8s.io/client-go/applyconfigurations/core/v1/hostip.go", "Go", 31, 0, 0, 0, 0, 0, 9, 40
"/opt/projects/swiftkube/vendor/k8s.io/client-go/applyconfigurations/core/v1/hostpathvolumesource.go", "Go", 42, 0, 0, 0, 0, 0, 11, 53
"/opt/projects/swiftkube/vendor/k8s.io/client-go/applyconfigurations/core/v1/httpgetaction.go", "Go", 72, 0, 0, 0, 0, 0, 14, 86
"/opt/projects/swiftkube/vendor/k8s.io/client-go/applyconfigurations/core/v1/httpheader.go", "Go", 39, 0, 0, 0, 0, 0, 10, 49
"/opt/projects/swiftkube/vendor/k8s.io/client-go/applyconfigurations/core/v1/iscsipersistentvolumesource.go", "Go", 113, 0, 0, 0, 0, 0, 19, 132
"/opt/projects/swiftkube/vendor/k8s.io/client-go/applyconfigurations/core/v1/iscsivolumesource.go", "Go", 113, 0, 0, 0, 0, 0, 19, 132
"/opt/projects/swiftkube/vendor/k8s.io/client-go/applyconfigurations/core/v1/keytopath.go", "Go", 47, 0, 0, 0, 0, 0, 11, 58
"/opt/projects/swiftkube/vendor/k8s.io/client-go/applyconfigurations/core/v1/lifecycle.go", "Go", 39, 0, 0, 0, 0, 0, 10, 49
"/opt/projects/swiftkube/vendor/k8s.io/client-go/applyconfigurations/core/v1/lifecyclehandler.go", "Go", 47, 0, 0, 0, 0, 0, 11, 58
"/opt/projects/swiftkube/vendor/k8s.io/client-go/applyconfigurations/core/v1/limitrange.go", "Go", 220, 0, 0, 0, 0, 0, 30, 250
"/opt/projects/swiftkube/vendor/k8s.io/client-go/applyconfigurations/core/v1/limitrangeitem.go", "Go", 74, 0, 0, 0, 0, 0, 15, 89
"/opt/projects/swiftkube/vendor/k8s.io/client-go/applyconfigurations/core/v1/limitrangespec.go", "Go", 36, 0, 0, 0, 0, 0, 9, 45
"/opt/projects/swiftkube/vendor/k8s.io/client-go/applyconfigurations/core/v1/loadbalanceringress.go", "Go", 52, 0, 0, 0, 0, 0, 11, 63
"/opt/projects/swiftkube/vendor/k8s.io/client-go/applyconfigurations/core/v1/loadbalancerstatus.go", "Go", 36, 0, 0, 0, 0, 0, 9, 45
"/opt/projects/swiftkube/vendor/k8s.io/client-go/applyconfigurations/core/v1/localobjectreference.go", "Go", 31, 0, 0, 0, 0, 0, 9, 40
"/opt/projects/swiftkube/vendor/k8s.io/client-go/applyconfigurations/core/v1/localvolumesource.go", "Go", 39, 0, 0, 0, 0, 0, 10, 49
"/opt/projects/swiftkube/vendor/k8s.io/client-go/applyconfigurations/core/v1/namespace.go", "Go", 226, 0, 0, 0, 0, 0, 31, 257
"/opt/projects/swiftkube/vendor/k8s.io/client-go/applyconfigurations/core/v1/namespacecondition.go", "Go", 67, 0, 0, 0, 0, 0, 14, 81
"/opt/projects/swiftkube/vendor/k8s.io/client-go/applyconfigurations/core/v1/namespacespec.go", "Go", 36, 0, 0, 0, 0, 0, 10, 46
"/opt/projects/swiftkube/vendor/k8s.io/client-go/applyconfigurations/core/v1/namespacestatus.go", "Go", 47, 0, 0, 0, 0, 0, 11, 58
"/opt/projects/swiftkube/vendor/k8s.io/client-go/applyconfigurations/core/v1/nfsvolumesource.go", "Go", 47, 0, 0, 0, 0, 0, 11, 58
"/opt/projects/swiftkube/vendor/k8s.io/client-go/applyconfigurations/core/v1/node.go", "Go", 226, 0, 0, 0, 0, 0, 31, 257
"/opt/projects/swiftkube/vendor/k8s.io/client-go/applyconfigurations/core/v1/nodeaddress.go", "Go", 42, 0, 0, 0, 0, 0, 11, 53
"/opt/projects/swiftkube/vendor/k8s.io/client-go/applyconfigurations/core/v1/nodeaffinity.go", "Go", 44, 0, 0, 0, 0, 0, 10, 54
"/opt/projects/swiftkube/vendor/k8s.io/client-go/applyconfigurations/core/v1/nodecondition.go", "Go", 75, 0, 0, 0, 0, 0, 15, 90
"/opt/projects/swiftkube/vendor/k8s.io/client-go/applyconfigurations/core/v1/nodeconfigsource.go", "Go", 31, 0, 0, 0, 0, 0, 9, 40
"/opt/projects/swiftkube/vendor/k8s.io/client-go/applyconfigurations/core/v1/nodeconfigstatus.go", "Go", 55, 0, 0, 0, 0, 0, 12, 67
"/opt/projects/swiftkube/vendor/k8s.io/client-go/applyconfigurations/core/v1/nodedaemonendpoints.go", "Go", 31, 0, 0, 0, 0, 0, 9, 40
"/opt/projects/swiftkube/vendor/k8s.io/client-go/applyconfigurations/core/v1/nodeselector.go", "Go", 36, 0, 0, 0, 0, 0, 9, 45
"/opt/projects/swiftkube/vendor/k8s.io/client-go/applyconfigurations/core/v1/nodeselectorrequirement.go", "Go", 52, 0, 0, 0, 0, 0, 12, 64
"/opt/projects/swiftkube/vendor/k8s.io/client-go/applyconfigurations/core/v1/nodeselectorterm.go", "Go", 49, 0, 0, 0, 0, 0, 10, 59
"/opt/projects/swiftkube/vendor/k8s.io/client-go/applyconfigurations/core/v1/nodespec.go", "Go", 86, 0, 0, 0, 0, 0, 15, 101
"/opt/projects/swiftkube/vendor/k8s.io/client-go/applyconfigurations/core/v1/nodestatus.go", "Go", 136, 0, 0, 0, 0, 0, 20, 156
"/opt/projects/swiftkube/vendor/k8s.io/client-go/applyconfigurations/core/v1/nodesysteminfo.go", "Go", 103, 0, 0, 0, 0, 0, 18, 121
"/opt/projects/swiftkube/vendor/k8s.io/client-go/applyconfigurations/core/v1/objectfieldselector.go", "Go", 39, 0, 0, 0, 0, 0, 10, 49
"/opt/projects/swiftkube/vendor/k8s.io/client-go/applyconfigurations/core/v1/objectreference.go", "Go", 82, 0, 0, 0, 0, 0, 16, 98
"/opt/projects/swiftkube/vendor/k8s.io/client-go/applyconfigurations/core/v1/persistentvolume.go", "Go", 226, 0, 0, 0, 0, 0, 31, 257
"/opt/projects/swiftkube/vendor/k8s.io/client-go/applyconfigurations/core/v1/persistentvolumeclaim.go", "Go", 228, 0, 0, 0, 0, 0, 31, 259
"/opt/projects/swiftkube/vendor/k8s.io/client-go/applyconfigurations/core/v1/persistentvolumeclaimcondition.go", "Go", 75, 0, 0, 0, 0, 0, 15, 90
"/opt/projects/swiftkube/vendor/k8s.io/client-go/applyconfigurations/core/v1/persistentvolumeclaimspec.go", "Go", 93, 0, 0, 0, 0, 0, 17, 110
"/opt/projects/swiftkube/vendor/k8s.io/client-go/applyconfigurations/core/v1/persistentvolumeclaimstatus.go", "Go", 87, 0, 0, 0, 0, 0, 15, 102
"/opt/projects/swiftkube/vendor/k8s.io/client-go/applyconfigurations/core/v1/persistentvolumeclaimtemplate.go", "Go", 165, 0, 0, 0, 0, 0, 24, 189
"/opt/projects/swiftkube/vendor/k8s.io/client-go/applyconfigurations/core/v1/persistentvolumeclaimvolumesource.go", "Go", 39, 0, 0, 0, 0, 0, 10, 49
"/opt/projects/swiftkube/vendor/k8s.io/client-go/applyconfigurations/core/v1/persistentvolumesource.go", "Go", 199, 0, 0, 0, 0, 0, 30, 229
"/opt/projects/swiftkube/vendor/k8s.io/client-go/applyconfigurations/core/v1/persistentvolumespec.go", "Go", 249, 0, 0, 0, 0, 0, 39, 288
"/opt/projects/swiftkube/vendor/k8s.io/client-go/applyconfigurations/core/v1/persistentvolumestatus.go", "Go", 59, 0, 0, 0, 0, 0, 13, 72
"/opt/projects/swiftkube/vendor/k8s.io/client-go/applyconfigurations/core/v1/photonpersistentdiskvolumesource.go", "Go", 39, 0, 0, 0, 0, 0, 10, 49
"/opt/projects/swiftkube/vendor/k8s.io/client-go/applyconfigurations/core/v1/pod.go", "Go", 228, 0, 0, 0, 0, 0, 31, 259
"/opt/projects/swiftkube/vendor/k8s.io/client-go/applyconfigurations/core/v1/podaffinity.go", "Go", 49, 0, 0, 0, 0, 0, 10, 59
"/opt/projects/swiftkube/vendor/k8s.io/client-go/applyconfigurations/core/v1/podaffinityterm.go", "Go", 60, 0, 0, 0, 0, 0, 13, 73
"/opt/projects/swiftkube/vendor/k8s.io/client-go/applyconfigurations/core/v1/podantiaffinity.go", "Go", 49, 0, 0, 0, 0, 0, 10, 59
"/opt/projects/swiftkube/vendor/k8s.io/client-go/applyconfigurations/core/v1/podcondition.go", "Go", 75, 0, 0, 0, 0, 0, 15, 90
"/opt/projects/swiftkube/vendor/k8s.io/client-go/applyconfigurations/core/v1/poddnsconfig.go", "Go", 56, 0, 0, 0, 0, 0, 11, 67
"/opt/projects/swiftkube/vendor/k8s.io/client-go/applyconfigurations/core/v1/poddnsconfigoption.go", "Go", 39, 0, 0, 0, 0, 0, 10, 49
"/opt/projects/swiftkube/vendor/k8s.io/client-go/applyconfigurations/core/v1/podip.go", "Go", 31, 0, 0, 0, 0, 0, 9, 40
"/opt/projects/swiftkube/vendor/k8s.io/client-go/applyconfigurations/core/v1/podos.go", "Go", 34, 0, 0, 0, 0, 0, 10, 44
"/opt/projects/swiftkube/vendor/k8s.io/client-go/applyconfigurations/core/v1/podreadinessgate.go", "Go", 34, 0, 0, 0, 0, 0, 10, 44
"/opt/projects/swiftkube/vendor/k8s.io/client-go/applyconfigurations/core/v1/podresourceclaim.go", "Go", 39, 0, 0, 0, 0, 0, 10, 49
"/opt/projects/swiftkube/vendor/k8s.io/client-go/applyconfigurations/core/v1/podresourceclaimstatus.go", "Go", 39, 0, 0, 0, 0, 0, 10, 49
"/opt/projects/swiftkube/vendor/k8s.io/client-go/applyconfigurations/core/v1/podschedulinggate.go", "Go", 31, 0, 0, 0, 0, 0, 9, 40
"/opt/projects/swiftkube/vendor/k8s.io/client-go/applyconfigurations/core/v1/podsecuritycontext.go", "Go", 113, 0, 0, 0, 0, 0, 19, 132
"/opt/projects/swiftkube/vendor/k8s.io/client-go/applyconfigurations/core/v1/podspec.go", "Go", 399, 0, 0, 0, 0, 0, 48, 447
"/opt/projects/swiftkube/vendor/k8s.io/client-go/applyconfigurations/core/v1/podstatus.go", "Go", 190, 0, 0, 0, 0, 0, 25, 215
"/opt/projects/swiftkube/vendor/k8s.io/client-go/applyconfigurations/core/v1/podtemplate.go", "Go", 220, 0, 0, 0, 0, 0, 30, 250
"/opt/projects/swiftkube/vendor/k8s.io/client-go/applyconfigurations/core/v1/podtemplatespec.go", "Go", 165, 0, 0, 0, 0, 0, 24, 189
"/opt/projects/swiftkube/vendor/k8s.io/client-go/applyconfigurations/core/v1/portstatus.go", "Go", 50, 0, 0, 0, 0, 0, 12, 62
"/opt/projects/swiftkube/vendor/k8s.io/client-go/applyconfigurations/core/v1/portworxvolumesource.go", "Go", 47, 0, 0, 0, 0, 0, 11, 58
"/opt/projects/swiftkube/vendor/k8s.io/client-go/applyconfigurations/core/v1/preferredschedulingterm.go", "Go", 39, 0, 0, 0, 0, 0, 10, 49
"/opt/projects/swiftkube/vendor/k8s.io/client-go/applyconfigurations/core/v1/probe.go", "Go", 100, 0, 0, 0, 0, 0, 18, 118
"/opt/projects/swiftkube/vendor/k8s.io/client-go/applyconfigurations/core/v1/probehandler.go", "Go", 55, 0, 0, 0, 0, 0, 12, 67
"/opt/projects/swiftkube/vendor/k8s.io/client-go/applyconfigurations/core/v1/projectedvolumesource.go", "Go", 44, 0, 0, 0, 0, 0, 10, 54
"/opt/projects/swiftkube/vendor/k8s.io/client-go/applyconfigurations/core/v1/quobytevolumesource.go", "Go", 71, 0, 0, 0, 0, 0, 14, 85
"/opt/projects/swiftkube/vendor/k8s.io/client-go/applyconfigurations/core/v1/rbdpersistentvolumesource.go", "Go", 89, 0, 0, 0, 0, 0, 16, 105
"/opt/projects/swiftkube/vendor/k8s.io/client-go/applyconfigurations/core/v1/rbdvolumesource.go", "Go", 89, 0, 0, 0, 0, 0, 16, 105
"/opt/projects/swiftkube/vendor/k8s.io/client-go/applyconfigurations/core/v1/replicationcontroller.go", "Go", 228, 0, 0, 0, 0, 0, 31, 259
"/opt/projects/swiftkube/vendor/k8s.io/client-go/applyconfigurations/core/v1/replicationcontrollercondition.go", "Go", 67, 0, 0, 0, 0, 0, 14, 81
"/opt/projects/swiftkube/vendor/k8s.io/client-go/applyconfigurations/core/v1/replicationcontrollerspec.go", "Go", 61, 0, 0, 0, 0, 0, 12, 73
"/opt/projects/swiftkube/vendor/k8s.io/client-go/applyconfigurations/core/v1/replicationcontrollerstatus.go", "Go", 76, 0, 0, 0, 0, 0, 14, 90
"/opt/projects/swiftkube/vendor/k8s.io/client-go/applyconfigurations/core/v1/resourceclaim.go", "Go", 31, 0, 0, 0, 0, 0, 9, 40
"/opt/projects/swiftkube/vendor/k8s.io/client-go/applyconfigurations/core/v1/resourcefieldselector.go", "Go", 50, 0, 0, 0, 0, 0, 12, 62
"/opt/projects/swiftkube/vendor/k8s.io/client-go/applyconfigurations/core/v1/resourcequota.go", "Go", 228, 0, 0, 0, 0, 0, 31, 259
"/opt/projects/swiftkube/vendor/k8s.io/client-go/applyconfigurations/core/v1/resourcequotaspec.go", "Go", 52, 0, 0, 0, 0, 0, 12, 64
"/opt/projects/swiftkube/vendor/k8s.io/client-go/applyconfigurations/core/v1/resourcequotastatus.go", "Go", 42, 0, 0, 0, 0, 0, 11, 53
"/opt/projects/swiftkube/vendor/k8s.io/client-go/applyconfigurations/core/v1/resourcerequirements.go", "Go", 55, 0, 0, 0, 0, 0, 12, 67
"/opt/projects/swiftkube/vendor/k8s.io/client-go/applyconfigurations/core/v1/scaleiopersistentvolumesource.go", "Go", 103, 0, 0, 0, 0, 0, 18, 121
"/opt/projects/swiftkube/vendor/k8s.io/client-go/applyconfigurations/core/v1/scaleiovolumesource.go", "Go", 103, 0, 0, 0, 0, 0, 18, 121
"/opt/projects/swiftkube/vendor/k8s.io/client-go/applyconfigurations/core/v1/scopedresourceselectorrequirement.go", "Go", 52, 0, 0, 0, 0, 0, 12, 64
"/opt/projects/swiftkube/vendor/k8s.io/client-go/applyconfigurations/core/v1/scopeselector.go", "Go", 36, 0, 0, 0, 0, 0, 9, 45
"/opt/projects/swiftkube/vendor/k8s.io/client-go/applyconfigurations/core/v1/seccompprofile.go", "Go", 42, 0, 0, 0, 0, 0, 11, 53
"/opt/projects/swiftkube/vendor/k8s.io/client-go/applyconfigurations/core/v1/secret.go", "Go", 256, 0, 0, 0, 0, 0, 33, 289
"/opt/projects/swiftkube/vendor/k8s.io/client-go/applyconfigurations/core/v1/secretenvsource.go", "Go", 39, 0, 0, 0, 0, 0, 10, 49
"/opt/projects/swiftkube/vendor/k8s.io/client-go/applyconfigurations/core/v1/secretkeyselector.go", "Go", 47, 0, 0, 0, 0, 0, 11, 58
"/opt/projects/swiftkube/vendor/k8s.io/client-go/applyconfigurations/core/v1/secretprojection.go", "Go", 52, 0, 0, 0, 0, 0, 11, 63
"/opt/projects/swiftkube/vendor/k8s.io/client-go/applyconfigurations/core/v1/secretreference.go", "Go", 39, 0, 0, 0, 0, 0, 10, 49
"/opt/projects/swiftkube/vendor/k8s.io/client-go/applyconfigurations/core/v1/secretvolumesource.go", "Go", 60, 0, 0, 0, 0, 0, 12, 72
"/opt/projects/swiftkube/vendor/k8s.io/client-go/applyconfigurations/core/v1/securitycontext.go", "Go", 114, 0, 0, 0, 0, 0, 20, 134
"/opt/projects/swiftkube/vendor/k8s.io/client-go/applyconfigurations/core/v1/selinuxoptions.go", "Go", 55, 0, 0, 0, 0, 0, 12, 67
"/opt/projects/swiftkube/vendor/k8s.io/client-go/applyconfigurations/core/v1/service.go", "Go", 228, 0, 0, 0, 0, 0, 31, 259
"/opt/projects/swiftkube/vendor/k8s.io/client-go/applyconfigurations/core/v1/serviceaccount.go", "Go", 246, 0, 0, 0, 0, 0, 32, 278
"/opt/projects/swiftkube/vendor/k8s.io/client-go/applyconfigurations/core/v1/serviceaccounttokenprojection.go", "Go", 47, 0, 0, 0, 0, 0, 11, 58
"/opt/projects/swiftkube/vendor/k8s.io/client-go/applyconfigurations/core/v1/serviceport.go", "Go", 75, 0, 0, 0, 0, 0, 15, 90
"/opt/projects/swiftkube/vendor/k8s.io/client-go/applyconfigurations/core/v1/servicespec.go", "Go", 197, 0, 0, 0, 0, 0, 28, 225
"/opt/projects/swiftkube/vendor/k8s.io/client-go/applyconfigurations/core/v1/servicestatus.go", "Go", 47, 0, 0, 0, 0, 0, 11, 58
"/opt/projects/swiftkube/vendor/k8s.io/client-go/applyconfigurations/core/v1/sessionaffinityconfig.go", "Go", 31, 0, 0, 0, 0, 0, 9, 40
"/opt/projects/swiftkube/vendor/k8s.io/client-go/applyconfigurations/core/v1/storageospersistentvolumesource.go", "Go", 63, 0, 0, 0, 0, 0, 13, 76
"/opt/projects/swiftkube/vendor/k8s.io/client-go/applyconfigurations/core/v1/storageosvolumesource.go", "Go", 63, 0, 0, 0, 0, 0, 13, 76
"/opt/projects/swiftkube/vendor/k8s.io/client-go/applyconfigurations/core/v1/sysctl.go", "Go", 39, 0, 0, 0, 0, 0, 10, 49
"/opt/projects/swiftkube/vendor/k8s.io/client-go/applyconfigurations/core/v1/taint.go", "Go", 59, 0, 0, 0, 0, 0, 13, 72
"/opt/projects/swiftkube/vendor/k8s.io/client-go/applyconfigurations/core/v1/tcpsocketaction.go", "Go", 42, 0, 0, 0, 0, 0, 11, 53
"/opt/projects/swiftkube/vendor/k8s.io/client-go/applyconfigurations/core/v1/toleration.go", "Go", 66, 0, 0, 0, 0, 0, 14, 80
"/opt/projects/swiftkube/vendor/k8s.io/client-go/applyconfigurations/core/v1/topologyselectorlabelrequirement.go", "Go", 41, 0, 0, 0, 0, 0, 10, 51
"/opt/projects/swiftkube/vendor/k8s.io/client-go/applyconfigurations/core/v1/topologyselectorterm.go", "Go", 36, 0, 0, 0, 0, 0, 9, 45
"/opt/projects/swiftkube/vendor/k8s.io/client-go/applyconfigurations/core/v1/topologyspreadconstraint.go", "Go", 93, 0, 0, 0, 0, 0, 17, 110
"/opt/projects/swiftkube/vendor/k8s.io/client-go/applyconfigurations/core/v1/typedlocalobjectreference.go", "Go", 47, 0, 0, 0, 0, 0, 11, 58
"/opt/projects/swiftkube/vendor/k8s.io/client-go/applyconfigurations/core/v1/typedobjectreference.go", "Go", 55, 0, 0, 0, 0, 0, 12, 67
"/opt/projects/swiftkube/vendor/k8s.io/client-go/applyconfigurations/core/v1/volume.go", "Go", 235, 0, 0, 0, 0, 0, 38, 273
"/opt/projects/swiftkube/vendor/k8s.io/client-go/applyconfigurations/core/v1/volumedevice.go", "Go", 39, 0, 0, 0, 0, 0, 10, 49
"/opt/projects/swiftkube/vendor/k8s.io/client-go/applyconfigurations/core/v1/volumemount.go", "Go", 74, 0, 0, 0, 0, 0, 15, 89
"/opt/projects/swiftkube/vendor/k8s.io/client-go/applyconfigurations/core/v1/volumenodeaffinity.go", "Go", 31, 0, 0, 0, 0, 0, 9, 40
"/opt/projects/swiftkube/vendor/k8s.io/client-go/applyconfigurations/core/v1/volumeprojection.go", "Go", 55, 0, 0, 0, 0, 0, 12, 67
"/opt/projects/swiftkube/vendor/k8s.io/client-go/applyconfigurations/core/v1/volumesource.go", "Go", 255, 0, 0, 0, 0, 0, 37, 292
"/opt/projects/swiftkube/vendor/k8s.io/client-go/applyconfigurations/core/v1/vspherevirtualdiskvolumesource.go", "Go", 55, 0, 0, 0, 0, 0, 12, 67
"/opt/projects/swiftkube/vendor/k8s.io/client-go/applyconfigurations/core/v1/weightedpodaffinityterm.go", "Go", 39, 0, 0, 0, 0, 0, 10, 49
"/opt/projects/swiftkube/vendor/k8s.io/client-go/applyconfigurations/core/v1/windowssecuritycontextoptions.go", "Go", 55, 0, 0, 0, 0, 0, 12, 67
"/opt/projects/swiftkube/vendor/k8s.io/client-go/applyconfigurations/discovery/v1/endpoint.go", "Go", 98, 0, 0, 0, 0, 0, 17, 115
"/opt/projects/swiftkube/vendor/k8s.io/client-go/applyconfigurations/discovery/v1/endpointconditions.go", "Go", 47, 0, 0, 0, 0, 0, 11, 58
"/opt/projects/swiftkube/vendor/k8s.io/client-go/applyconfigurations/discovery/v1/endpointhints.go", "Go", 36, 0, 0, 0, 0, 0, 9, 45
"/opt/projects/swiftkube/vendor/k8s.io/client-go/applyconfigurations/discovery/v1/endpointport.go", "Go", 58, 0, 0, 0, 0, 0, 13, 71
"/opt/projects/swiftkube/vendor/k8s.io/client-go/applyconfigurations/discovery/v1/endpointslice.go", "Go", 246, 0, 0, 0, 0, 0, 32, 278
"/opt/projects/swiftkube/vendor/k8s.io/client-go/applyconfigurations/discovery/v1/forzone.go", "Go", 31, 0, 0, 0, 0, 0, 9, 40
"/opt/projects/swiftkube/vendor/k8s.io/client-go/applyconfigurations/discovery/v1beta1/endpoint.go", "Go", 90, 0, 0, 0, 0, 0, 16, 106
"/opt/projects/swiftkube/vendor/k8s.io/client-go/applyconfigurations/discovery/v1beta1/endpointconditions.go", "Go", 47, 0, 0, 0, 0, 0, 11, 58
"/opt/projects/swiftkube/vendor/k8s.io/client-go/applyconfigurations/discovery/v1beta1/endpointhints.go", "Go", 36, 0, 0, 0, 0, 0, 9, 45
"/opt/projects/swiftkube/vendor/k8s.io/client-go/applyconfigurations/discovery/v1beta1/endpointport.go", "Go", 58, 0, 0, 0, 0, 0, 13, 71
"/opt/projects/swiftkube/vendor/k8s.io/client-go/applyconfigurations/discovery/v1beta1/endpointslice.go", "Go", 246, 0, 0, 0, 0, 0, 32, 278
"/opt/projects/swiftkube/vendor/k8s.io/client-go/applyconfigurations/discovery/v1beta1/forzone.go", "Go", 31, 0, 0, 0, 0, 0, 9, 40
"/opt/projects/swiftkube/vendor/k8s.io/client-go/applyconfigurations/events/v1/event.go", "Go", 325, 0, 0, 0, 0, 0, 43, 368
"/opt/projects/swiftkube/vendor/k8s.io/client-go/applyconfigurations/events/v1/eventseries.go", "Go", 42, 0, 0, 0, 0, 0, 11, 53
"/opt/projects/swiftkube/vendor/k8s.io/client-go/applyconfigurations/events/v1beta1/event.go", "Go", 325, 0, 0, 0, 0, 0, 43, 368
"/opt/projects/swiftkube/vendor/k8s.io/client-go/applyconfigurations/events/v1beta1/eventseries.go", "Go", 42, 0, 0, 0, 0, 0, 11, 53
"/opt/projects/swiftkube/vendor/k8s.io/client-go/applyconfigurations/extensions/v1beta1/daemonset.go", "Go", 228, 0, 0, 0, 0, 0, 31, 259
"/opt/projects/swiftkube/vendor/k8s.io/client-go/applyconfigurations/extensions/v1beta1/daemonsetcondition.go", "Go", 68, 0, 0, 0, 0, 0, 14, 82
"/opt/projects/swiftkube/vendor/k8s.io/client-go/applyconfigurations/extensions/v1beta1/daemonsetspec.go", "Go", 75, 0, 0, 0, 0, 0, 15, 90
"/opt/projects/swiftkube/vendor/k8s.io/client-go/applyconfigurations/extensions/v1beta1/daemonsetstatus.go", "Go", 108, 0, 0, 0, 0, 0, 18, 126
"/opt/projects/swiftkube/vendor/k8s.io/client-go/applyconfigurations/extensions/v1beta1/daemonsetupdatestrategy.go", "Go", 42, 0, 0, 0, 0, 0, 11, 53
"/opt/projects/swiftkube/vendor/k8s.io/client-go/applyconfigurations/extensions/v1beta1/deployment.go", "Go", 228, 0, 0, 0, 0, 0, 31, 259
"/opt/projects/swiftkube/vendor/k8s.io/client-go/applyconfigurations/extensions/v1beta1/deploymentcondition.go", "Go", 76, 0, 0, 0, 0, 0, 15, 91
"/opt/projects/swiftkube/vendor/k8s.io/client-go/applyconfigurations/extensions/v1beta1/deploymentspec.go", "Go", 99, 0, 0, 0, 0, 0, 18, 117
"/opt/projects/swiftkube/vendor/k8s.io/client-go/applyconfigurations/extensions/v1beta1/deploymentstatus.go", "Go", 92, 0, 0, 0, 0, 0, 16, 108
"/opt/projects/swiftkube/vendor/k8s.io/client-go/applyconfigurations/extensions/v1beta1/deploymentstrategy.go", "Go", 42, 0, 0, 0, 0, 0, 11, 53
"/opt/projects/swiftkube/vendor/k8s.io/client-go/applyconfigurations/extensions/v1beta1/httpingresspath.go", "Go", 50, 0, 0, 0, 0, 0, 12, 62
"/opt/projects/swiftkube/vendor/k8s.io/client-go/applyconfigurations/extensions/v1beta1/httpingressrulevalue.go", "Go", 36, 0, 0, 0, 0, 0, 9, 45
"/opt/projects/swiftkube/vendor/k8s.io/client-go/applyconfigurations/extensions/v1beta1/ingress.go", "Go", 228, 0, 0, 0, 0, 0, 31, 259
"/opt/projects/swiftkube/vendor/k8s.io/client-go/applyconfigurations/extensions/v1beta1/ingressbackend.go", "Go", 51, 0, 0, 0, 0, 0, 12, 63
"/opt/projects/swiftkube/vendor/k8s.io/client-go/applyconfigurations/extensions/v1beta1/ingressloadbalanceringress.go", "Go", 52, 0, 0, 0, 0, 0, 11, 63
"/opt/projects/swiftkube/vendor/k8s.io/client-go/applyconfigurations/extensions/v1beta1/ingressloadbalancerstatus.go", "Go", 36, 0, 0, 0, 0, 0, 9, 45
"/opt/projects/swiftkube/vendor/k8s.io/client-go/applyconfigurations/extensions/v1beta1/ingressportstatus.go", "Go", 50, 0, 0, 0, 0, 0, 12, 62
"/opt/projects/swiftkube/vendor/k8s.io/client-go/applyconfigurations/extensions/v1beta1/ingressrule.go", "Go", 39, 0, 0, 0, 0, 0, 10, 49
"/opt/projects/swiftkube/vendor/k8s.io/client-go/applyconfigurations/extensions/v1beta1/ingressrulevalue.go", "Go", 31, 0, 0, 0, 0, 0, 9, 40
"/opt/projects/swiftkube/vendor/k8s.io/client-go/applyconfigurations/extensions/v1beta1/ingressspec.go", "Go", 65, 0, 0, 0, 0, 0, 12, 77
"/opt/projects/swiftkube/vendor/k8s.io/client-go/applyconfigurations/extensions/v1beta1/ingressstatus.go", "Go", 31, 0, 0, 0, 0, 0, 9, 40
"/opt/projects/swiftkube/vendor/k8s.io/client-go/applyconfigurations/extensions/v1beta1/ingresstls.go", "Go", 41, 0, 0, 0, 0, 0, 10, 51
"/opt/projects/swiftkube/vendor/k8s.io/client-go/applyconfigurations/extensions/v1beta1/ipblock.go", "Go", 41, 0, 0, 0, 0, 0, 10, 51
"/opt/projects/swiftkube/vendor/k8s.io/client-go/applyconfigurations/extensions/v1beta1/networkpolicy.go", "Go", 220, 0, 0, 0, 0, 0, 30, 250
"/opt/projects/swiftkube/vendor/k8s.io/client-go/applyconfigurations/extensions/v1beta1/networkpolicyegressrule.go", "Go", 49, 0, 0, 0, 0, 0, 10, 59
"/opt/projects/swiftkube/vendor/k8s.io/client-go/applyconfigurations/extensions/v1beta1/networkpolicyingressrule.go", "Go", 49, 0, 0, 0, 0, 0, 10, 59
"/opt/projects/swiftkube/vendor/k8s.io/client-go/applyconfigurations/extensions/v1beta1/networkpolicypeer.go", "Go", 50, 0, 0, 0, 0, 0, 12, 62
"/opt/projects/swiftkube/vendor/k8s.io/client-go/applyconfigurations/extensions/v1beta1/networkpolicyport.go", "Go", 51, 0, 0, 0, 0, 0, 12, 63
"/opt/projects/swiftkube/vendor/k8s.io/client-go/applyconfigurations/extensions/v1beta1/networkpolicyspec.go", "Go", 71, 0, 0, 0, 0, 0, 13, 84
"/opt/projects/swiftkube/vendor/k8s.io/client-go/applyconfigurations/extensions/v1beta1/replicaset.go", "Go", 228, 0, 0, 0, 0, 0, 31, 259
"/opt/projects/swiftkube/vendor/k8s.io/client-go/applyconfigurations/extensions/v1beta1/replicasetcondition.go", "Go", 68, 0, 0, 0, 0, 0, 14, 82
"/opt/projects/swiftkube/vendor/k8s.io/client-go/applyconfigurations/extensions/v1beta1/replicasetspec.go", "Go", 59, 0, 0, 0, 0, 0, 13, 72
"/opt/projects/swiftkube/vendor/k8s.io/client-go/applyconfigurations/extensions/v1beta1/replicasetstatus.go", "Go", 76, 0, 0, 0, 0, 0, 14, 90
"/opt/projects/swiftkube/vendor/k8s.io/client-go/applyconfigurations/extensions/v1beta1/rollbackconfig.go", "Go", 31, 0, 0, 0, 0, 0, 9, 40
"/opt/projects/swiftkube/vendor/k8s.io/client-go/applyconfigurations/extensions/v1beta1/rollingupdatedaemonset.go", "Go", 42, 0, 0, 0, 0, 0, 11, 53
"/opt/projects/swiftkube/vendor/k8s.io/client-go/applyconfigurations/extensions/v1beta1/rollingupdatedeployment.go", "Go", 42, 0, 0, 0, 0, 0, 11, 53
"/opt/projects/swiftkube/vendor/k8s.io/client-go/applyconfigurations/extensions/v1beta1/scale.go", "Go", 192, 0, 0, 0, 0, 0, 27, 219
"/opt/projects/swiftkube/vendor/k8s.io/client-go/applyconfigurations/flowcontrol/v1alpha1/exemptprioritylevelconfiguration.go", "Go", 39, 0, 0, 0, 0, 0, 10, 49
"/opt/projects/swiftkube/vendor/k8s.io/client-go/applyconfigurations/flowcontrol/v1alpha1/flowdistinguishermethod.go", "Go", 34, 0, 0, 0, 0, 0, 10, 44
"/opt/projects/swiftkube/vendor/k8s.io/client-go/applyconfigurations/flowcontrol/v1alpha1/flowschema.go", "Go", 226, 0, 0, 0, 0, 0, 31, 257
"/opt/projects/swiftkube/vendor/k8s.io/client-go/applyconfigurations/flowcontrol/v1alpha1/flowschemacondition.go", "Go", 67, 0, 0, 0, 0, 0, 14, 81
"/opt/projects/swiftkube/vendor/k8s.io/client-go/applyconfigurations/flowcontrol/v1alpha1/flowschemaspec.go", "Go", 60, 0, 0, 0, 0, 0, 12, 72
"/opt/projects/swiftkube/vendor/k8s.io/client-go/applyconfigurations/flowcontrol/v1alpha1/flowschemastatus.go", "Go", 36, 0, 0, 0, 0, 0, 9, 45
"/opt/projects/swiftkube/vendor/k8s.io/client-go/applyconfigurations/flowcontrol/v1alpha1/groupsubject.go", "Go", 31, 0, 0, 0, 0, 0, 9, 40
"/opt/projects/swiftkube/vendor/k8s.io/client-go/applyconfigurations/flowcontrol/v1alpha1/limitedprioritylevelconfiguration.go", "Go", 55, 0, 0, 0, 0, 0, 12, 67
"/opt/projects/swiftkube/vendor/k8s.io/client-go/applyconfigurations/flowcontrol/v1alpha1/limitresponse.go", "Go", 42, 0, 0, 0, 0, 0, 11, 53
"/opt/projects/swiftkube/vendor/k8s.io/client-go/applyconfigurations/flowcontrol/v1alpha1/nonresourcepolicyrule.go", "Go", 43, 0, 0, 0, 0, 0, 10, 53
"/opt/projects/swiftkube/vendor/k8s.io/client-go/applyconfigurations/flowcontrol/v1alpha1/policyruleswithsubjects.go", "Go", 62, 0, 0, 0, 0, 0, 11, 73
"/opt/projects/swiftkube/vendor/k8s.io/client-go/applyconfigurations/flowcontrol/v1alpha1/prioritylevelconfiguration.go", "Go", 226, 0, 0, 0, 0, 0, 31, 257
"/opt/projects/swiftkube/vendor/k8s.io/client-go/applyconfigurations/flowcontrol/v1alpha1/prioritylevelconfigurationcondition.go", "Go", 67, 0, 0, 0, 0, 0, 14, 81
"/opt/projects/swiftkube/vendor/k8s.io/client-go/applyconfigurations/flowcontrol/v1alpha1/prioritylevelconfigurationreference.go", "Go", 31, 0, 0, 0, 0, 0, 9, 40
"/opt/projects/swiftkube/vendor/k8s.io/client-go/applyconfigurations/flowcontrol/v1alpha1/prioritylevelconfigurationspec.go", "Go", 50, 0, 0, 0, 0, 0, 12, 62
"/opt/projects/swiftkube/vendor/k8s.io/client-go/applyconfigurations/flowcontrol/v1alpha1/prioritylevelconfigurationstatus.go", "Go", 36, 0, 0, 0, 0, 0, 9, 45
"/opt/projects/swiftkube/vendor/k8s.io/client-go/applyconfigurations/flowcontrol/v1alpha1/queuingconfiguration.go", "Go", 47, 0, 0, 0, 0, 0, 11, 58
"/opt/projects/swiftkube/vendor/k8s.io/client-go/applyconfigurations/flowcontrol/v1alpha1/resourcepolicyrule.go", "Go", 71, 0, 0, 0, 0, 0, 13, 84
"/opt/projects/swiftkube/vendor/k8s.io/client-go/applyconfigurations/flowcontrol/v1alpha1/serviceaccountsubject.go", "Go", 39, 0, 0, 0, 0, 0, 10, 49
"/opt/projects/swiftkube/vendor/k8s.io/client-go/applyconfigurations/flowcontrol/v1alpha1/subject.go", "Go", 58, 0, 0, 0, 0, 0, 13, 71
"/opt/projects/swiftkube/vendor/k8s.io/client-go/applyconfigurations/flowcontrol/v1alpha1/usersubject.go", "Go", 31, 0, 0, 0, 0, 0, 9, 40
"/opt/projects/swiftkube/vendor/k8s.io/client-go/applyconfigurations/flowcontrol/v1beta1/exemptprioritylevelconfiguration.go", "Go", 39, 0, 0, 0, 0, 0, 10, 49
"/opt/projects/swiftkube/vendor/k8s.io/client-go/applyconfigurations/flowcontrol/v1beta1/flowdistinguishermethod.go", "Go", 34, 0, 0, 0, 0, 0, 10, 44
"/opt/projects/swiftkube/vendor/k8s.io/client-go/applyconfigurations/flowcontrol/v1beta1/flowschema.go", "Go", 226, 0, 0, 0, 0, 0, 31, 257
"/opt/projects/swiftkube/vendor/k8s.io/client-go/applyconfigurations/flowcontrol/v1beta1/flowschemacondition.go", "Go", 67, 0, 0, 0, 0, 0, 14, 81
"/opt/projects/swiftkube/vendor/k8s.io/client-go/applyconfigurations/flowcontrol/v1beta1/flowschemaspec.go", "Go", 60, 0, 0, 0, 0, 0, 12, 72
"/opt/projects/swiftkube/vendor/k8s.io/client-go/applyconfigurations/flowcontrol/v1beta1/flowschemastatus.go", "Go", 36, 0, 0, 0, 0, 0, 9, 45
"/opt/projects/swiftkube/vendor/k8s.io/client-go/applyconfigurations/flowcontrol/v1beta1/groupsubject.go", "Go", 31, 0, 0, 0, 0, 0, 9, 40
"/opt/projects/swiftkube/vendor/k8s.io/client-go/applyconfigurations/flowcontrol/v1beta1/limitedprioritylevelconfiguration.go", "Go", 55, 0, 0, 0, 0, 0, 12, 67
"/opt/projects/swiftkube/vendor/k8s.io/client-go/applyconfigurations/flowcontrol/v1beta1/limitresponse.go", "Go", 42, 0, 0, 0, 0, 0, 11, 53
"/opt/projects/swiftkube/vendor/k8s.io/client-go/applyconfigurations/flowcontrol/v1beta1/nonresourcepolicyrule.go", "Go", 43, 0, 0, 0, 0, 0, 10, 53
"/opt/projects/swiftkube/vendor/k8s.io/client-go/applyconfigurations/flowcontrol/v1beta1/policyruleswithsubjects.go", "Go", 62, 0, 0, 0, 0, 0, 11, 73
"/opt/projects/swiftkube/vendor/k8s.io/client-go/applyconfigurations/flowcontrol/v1beta1/prioritylevelconfiguration.go", "Go", 226, 0, 0, 0, 0, 0, 31, 257
"/opt/projects/swiftkube/vendor/k8s.io/client-go/applyconfigurations/flowcontrol/v1beta1/prioritylevelconfigurationcondition.go", "Go", 67, 0, 0, 0, 0, 0, 14, 81
"/opt/projects/swiftkube/vendor/k8s.io/client-go/applyconfigurations/flowcontrol/v1beta1/prioritylevelconfigurationreference.go", "Go", 31, 0, 0, 0, 0, 0, 9, 40
"/opt/projects/swiftkube/vendor/k8s.io/client-go/applyconfigurations/flowcontrol/v1beta1/prioritylevelconfigurationspec.go", "Go", 50, 0, 0, 0, 0, 0, 12, 62
"/opt/projects/swiftkube/vendor/k8s.io/client-go/applyconfigurations/flowcontrol/v1beta1/prioritylevelconfigurationstatus.go", "Go", 36, 0, 0, 0, 0, 0, 9, 45
"/opt/projects/swiftkube/vendor/k8s.io/client-go/applyconfigurations/flowcontrol/v1beta1/queuingconfiguration.go", "Go", 47, 0, 0, 0, 0, 0, 11, 58
"/opt/projects/swiftkube/vendor/k8s.io/client-go/applyconfigurations/flowcontrol/v1beta1/resourcepolicyrule.go", "Go", 71, 0, 0, 0, 0, 0, 13, 84
"/opt/projects/swiftkube/vendor/k8s.io/client-go/applyconfigurations/flowcontrol/v1beta1/serviceaccountsubject.go", "Go", 39, 0, 0, 0, 0, 0, 10, 49
"/opt/projects/swiftkube/vendor/k8s.io/client-go/applyconfigurations/flowcontrol/v1beta1/subject.go", "Go", 58, 0, 0, 0, 0, 0, 13, 71
"/opt/projects/swiftkube/vendor/k8s.io/client-go/applyconfigurations/flowcontrol/v1beta1/usersubject.go", "Go", 31, 0, 0, 0, 0, 0, 9, 40
"/opt/projects/swiftkube/vendor/k8s.io/client-go/applyconfigurations/flowcontrol/v1beta2/exemptprioritylevelconfiguration.go", "Go", 39, 0, 0, 0, 0, 0, 10, 49
"/opt/projects/swiftkube/vendor/k8s.io/client-go/applyconfigurations/flowcontrol/v1beta2/flowdistinguishermethod.go", "Go", 34, 0, 0, 0, 0, 0, 10, 44
"/opt/projects/swiftkube/vendor/k8s.io/client-go/applyconfigurations/flowcontrol/v1beta2/flowschema.go", "Go", 226, 0, 0, 0, 0, 0, 31, 257
"/opt/projects/swiftkube/vendor/k8s.io/client-go/applyconfigurations/flowcontrol/v1beta2/flowschemacondition.go", "Go", 67, 0, 0, 0, 0, 0, 14, 81
"/opt/projects/swiftkube/vendor/k8s.io/client-go/applyconfigurations/flowcontrol/v1beta2/flowschemaspec.go", "Go", 60, 0, 0, 0, 0, 0, 12, 72
"/opt/projects/swiftkube/vendor/k8s.io/client-go/applyconfigurations/flowcontrol/v1beta2/flowschemastatus.go", "Go", 36, 0, 0, 0, 0, 0, 9, 45
"/opt/projects/swiftkube/vendor/k8s.io/client-go/applyconfigurations/flowcontrol/v1beta2/groupsubject.go", "Go", 31, 0, 0, 0, 0, 0, 9, 40
"/opt/projects/swiftkube/vendor/k8s.io/client-go/applyconfigurations/flowcontrol/v1beta2/limitedprioritylevelconfiguration.go", "Go", 55, 0, 0, 0, 0, 0, 12, 67
"/opt/projects/swiftkube/vendor/k8s.io/client-go/applyconfigurations/flowcontrol/v1beta2/limitresponse.go", "Go", 42, 0, 0, 0, 0, 0, 11, 53
"/opt/projects/swiftkube/vendor/k8s.io/client-go/applyconfigurations/flowcontrol/v1beta2/nonresourcepolicyrule.go", "Go", 43, 0, 0, 0, 0, 0, 10, 53
"/opt/projects/swiftkube/vendor/k8s.io/client-go/applyconfigurations/flowcontrol/v1beta2/policyruleswithsubjects.go", "Go", 62, 0, 0, 0, 0, 0, 11, 73
"/opt/projects/swiftkube/vendor/k8s.io/client-go/applyconfigurations/flowcontrol/v1beta2/prioritylevelconfiguration.go", "Go", 226, 0, 0, 0, 0, 0, 31, 257
"/opt/projects/swiftkube/vendor/k8s.io/client-go/applyconfigurations/flowcontrol/v1beta2/prioritylevelconfigurationcondition.go", "Go", 67, 0, 0, 0, 0, 0, 14, 81
"/opt/projects/swiftkube/vendor/k8s.io/client-go/applyconfigurations/flowcontrol/v1beta2/prioritylevelconfigurationreference.go", "Go", 31, 0, 0, 0, 0, 0, 9, 40
"/opt/projects/swiftkube/vendor/k8s.io/client-go/applyconfigurations/flowcontrol/v1beta2/prioritylevelconfigurationspec.go", "Go", 50, 0, 0, 0, 0, 0, 12, 62
"/opt/projects/swiftkube/vendor/k8s.io/client-go/applyconfigurations/flowcontrol/v1beta2/prioritylevelconfigurationstatus.go", "Go", 36, 0, 0, 0, 0, 0, 9, 45
"/opt/projects/swiftkube/vendor/k8s.io/client-go/applyconfigurations/flowcontrol/v1beta2/queuingconfiguration.go", "Go", 47, 0, 0, 0, 0, 0, 11, 58
"/opt/projects/swiftkube/vendor/k8s.io/client-go/applyconfigurations/flowcontrol/v1beta2/resourcepolicyrule.go", "Go", 71, 0, 0, 0, 0, 0, 13, 84
"/opt/projects/swiftkube/vendor/k8s.io/client-go/applyconfigurations/flowcontrol/v1beta2/serviceaccountsubject.go", "Go", 39, 0, 0, 0, 0, 0, 10, 49
"/opt/projects/swiftkube/vendor/k8s.io/client-go/applyconfigurations/flowcontrol/v1beta2/subject.go", "Go", 58, 0, 0, 0, 0, 0, 13, 71
"/opt/projects/swiftkube/vendor/k8s.io/client-go/applyconfigurations/flowcontrol/v1beta2/usersubject.go", "Go", 31, 0, 0, 0, 0, 0, 9, 40
"/opt/projects/swiftkube/vendor/k8s.io/client-go/applyconfigurations/flowcontrol/v1beta3/exemptprioritylevelconfiguration.go", "Go", 39, 0, 0, 0, 0, 0, 10, 49
"/opt/projects/swiftkube/vendor/k8s.io/client-go/applyconfigurations/flowcontrol/v1beta3/flowdistinguishermethod.go", "Go", 34, 0, 0, 0, 0, 0, 10, 44
"/opt/projects/swiftkube/vendor/k8s.io/client-go/applyconfigurations/flowcontrol/v1beta3/flowschema.go", "Go", 226, 0, 0, 0, 0, 0, 31, 257
"/opt/projects/swiftkube/vendor/k8s.io/client-go/applyconfigurations/flowcontrol/v1beta3/flowschemacondition.go", "Go", 67, 0, 0, 0, 0, 0, 14, 81
"/opt/projects/swiftkube/vendor/k8s.io/client-go/applyconfigurations/flowcontrol/v1beta3/flowschemaspec.go", "Go", 60, 0, 0, 0, 0, 0, 12, 72
"/opt/projects/swiftkube/vendor/k8s.io/client-go/applyconfigurations/flowcontrol/v1beta3/flowschemastatus.go", "Go", 36, 0, 0, 0, 0, 0, 9, 45
"/opt/projects/swiftkube/vendor/k8s.io/client-go/applyconfigurations/flowcontrol/v1beta3/groupsubject.go", "Go", 31, 0, 0, 0, 0, 0, 9, 40
"/opt/projects/swiftkube/vendor/k8s.io/client-go/applyconfigurations/flowcontrol/v1beta3/limitedprioritylevelconfiguration.go", "Go", 55, 0, 0, 0, 0, 0, 12, 67
"/opt/projects/swiftkube/vendor/k8s.io/client-go/applyconfigurations/flowcontrol/v1beta3/limitresponse.go", "Go", 42, 0, 0, 0, 0, 0, 11, 53
"/opt/projects/swiftkube/vendor/k8s.io/client-go/applyconfigurations/flowcontrol/v1beta3/nonresourcepolicyrule.go", "Go", 43, 0, 0, 0, 0, 0, 10, 53
"/opt/projects/swiftkube/vendor/k8s.io/client-go/applyconfigurations/flowcontrol/v1beta3/policyruleswithsubjects.go", "Go", 62, 0, 0, 0, 0, 0, 11, 73
"/opt/projects/swiftkube/vendor/k8s.io/client-go/applyconfigurations/flowcontrol/v1beta3/prioritylevelconfiguration.go", "Go", 226, 0, 0, 0, 0, 0, 31, 257
"/opt/projects/swiftkube/vendor/k8s.io/client-go/applyconfigurations/flowcontrol/v1beta3/prioritylevelconfigurationcondition.go", "Go", 67, 0, 0, 0, 0, 0, 14, 81
"/opt/projects/swiftkube/vendor/k8s.io/client-go/applyconfigurations/flowcontrol/v1beta3/prioritylevelconfigurationreference.go", "Go", 31, 0, 0, 0, 0, 0, 9, 40
"/opt/projects/swiftkube/vendor/k8s.io/client-go/applyconfigurations/flowcontrol/v1beta3/prioritylevelconfigurationspec.go", "Go", 50, 0, 0, 0, 0, 0, 12, 62
"/opt/projects/swiftkube/vendor/k8s.io/client-go/applyconfigurations/flowcontrol/v1beta3/prioritylevelconfigurationstatus.go", "Go", 36, 0, 0, 0, 0, 0, 9, 45
"/opt/projects/swiftkube/vendor/k8s.io/client-go/applyconfigurations/flowcontrol/v1beta3/queuingconfiguration.go", "Go", 47, 0, 0, 0, 0, 0, 11, 58
"/opt/projects/swiftkube/vendor/k8s.io/client-go/applyconfigurations/flowcontrol/v1beta3/resourcepolicyrule.go", "Go", 71, 0, 0, 0, 0, 0, 13, 84
"/opt/projects/swiftkube/vendor/k8s.io/client-go/applyconfigurations/flowcontrol/v1beta3/serviceaccountsubject.go", "Go", 39, 0, 0, 0, 0, 0, 10, 49
"/opt/projects/swiftkube/vendor/k8s.io/client-go/applyconfigurations/flowcontrol/v1beta3/subject.go", "Go", 58, 0, 0, 0, 0, 0, 13, 71
"/opt/projects/swiftkube/vendor/k8s.io/client-go/applyconfigurations/flowcontrol/v1beta3/usersubject.go", "Go", 31, 0, 0, 0, 0, 0, 9, 40
"/opt/projects/swiftkube/vendor/k8s.io/client-go/applyconfigurations/internal/internal.go", "Go", 13056, 0, 0, 0, 0, 0, 10, 13066
"/opt/projects/swiftkube/vendor/k8s.io/client-go/applyconfigurations/meta/v1/condition.go", "Go", 74, 0, 0, 0, 0, 0, 15, 89
"/opt/projects/swiftkube/vendor/k8s.io/client-go/applyconfigurations/meta/v1/deleteoptions.go", "Go", 86, 0, 0, 0, 0, 0, 16, 102
"/opt/projects/swiftkube/vendor/k8s.io/client-go/applyconfigurations/meta/v1/labelselector.go", "Go", 50, 0, 0, 0, 0, 0, 10, 60
"/opt/projects/swiftkube/vendor/k8s.io/client-go/applyconfigurations/meta/v1/labelselectorrequirement.go", "Go", 52, 0, 0, 0, 0, 0, 12, 64
"/opt/projects/swiftkube/vendor/k8s.io/client-go/applyconfigurations/meta/v1/managedfieldsentry.go", "Go", 82, 0, 0, 0, 0, 0, 16, 98
"/opt/projects/swiftkube/vendor/k8s.io/client-go/applyconfigurations/meta/v1/objectmeta.go", "Go", 150, 0, 0, 0, 0, 0, 22, 172
"/opt/projects/swiftkube/vendor/k8s.io/client-go/applyconfigurations/meta/v1/ownerreference.go", "Go", 74, 0, 0, 0, 0, 0, 15, 89
"/opt/projects/swiftkube/vendor/k8s.io/client-go/applyconfigurations/meta/v1/preconditions.go", "Go", 42, 0, 0, 0, 0, 0, 11, 53
"/opt/projects/swiftkube/vendor/k8s.io/client-go/applyconfigurations/meta/v1/typemeta.go", "Go", 39, 0, 0, 0, 0, 0, 10, 49
"/opt/projects/swiftkube/vendor/k8s.io/client-go/applyconfigurations/meta/v1/unstructured.go", "Go", 119, 0, 0, 0, 0, 0, 19, 138
"/opt/projects/swiftkube/vendor/k8s.io/client-go/applyconfigurations/networking/v1/httpingresspath.go", "Go", 50, 0, 0, 0, 0, 0, 12, 62
"/opt/projects/swiftkube/vendor/k8s.io/client-go/applyconfigurations/networking/v1/httpingressrulevalue.go", "Go", 36, 0, 0, 0, 0, 0, 9, 45
"/opt/projects/swiftkube/vendor/k8s.io/client-go/applyconfigurations/networking/v1/ingress.go", "Go", 228, 0, 0, 0, 0, 0, 31, 259
"/opt/projects/swiftkube/vendor/k8s.io/client-go/applyconfigurations/networking/v1/ingressbackend.go", "Go", 42, 0, 0, 0, 0, 0, 11, 53
"/opt/projects/swiftkube/vendor/k8s.io/client-go/applyconfigurations/networking/v1/ingressclass.go", "Go", 218, 0, 0, 0, 0, 0, 30, 248
"/opt/projects/swiftkube/vendor/k8s.io/client-go/applyconfigurations/networking/v1/ingressclassparametersreference.go", "Go", 63, 0, 0, 0, 0, 0, 13, 76
"/opt/projects/swiftkube/vendor/k8s.io/client-go/applyconfigurations/networking/v1/ingressclassspec.go", "Go", 39, 0, 0, 0, 0, 0, 10, 49
"/opt/projects/swiftkube/vendor/k8s.io/client-go/applyconfigurations/networking/v1/ingressloadbalanceringress.go", "Go", 52, 0, 0, 0, 0, 0, 11, 63
"/opt/projects/swiftkube/vendor/k8s.io/client-go/applyconfigurations/networking/v1/ingressloadbalancerstatus.go", "Go", 36, 0, 0, 0, 0, 0, 9, 45
"/opt/projects/swiftkube/vendor/k8s.io/client-go/applyconfigurations/networking/v1/ingressportstatus.go", "Go", 50, 0, 0, 0, 0, 0, 12, 62
"/opt/projects/swiftkube/vendor/k8s.io/client-go/applyconfigurations/networking/v1/ingressrule.go", "Go", 39, 0, 0, 0, 0, 0, 10, 49
"/opt/projects/swiftkube/vendor/k8s.io/client-go/applyconfigurations/networking/v1/ingressrulevalue.go", "Go", 31, 0, 0, 0, 0, 0, 9, 40
"/opt/projects/swiftkube/vendor/k8s.io/client-go/applyconfigurations/networking/v1/ingressservicebackend.go", "Go", 39, 0, 0, 0, 0, 0, 10, 49
"/opt/projects/swiftkube/vendor/k8s.io/client-go/applyconfigurations/networking/v1/ingressspec.go", "Go", 65, 0, 0, 0, 0, 0, 12, 77
"/opt/projects/swiftkube/vendor/k8s.io/client-go/applyconfigurations/networking/v1/ingressstatus.go", "Go", 31, 0, 0, 0, 0, 0, 9, 40
"/opt/projects/swiftkube/vendor/k8s.io/client-go/applyconfigurations/networking/v1/ingresstls.go", "Go", 41, 0, 0, 0, 0, 0, 10, 51
"/opt/projects/swiftkube/vendor/k8s.io/client-go/applyconfigurations/networking/v1/ipblock.go", "Go", 41, 0, 0, 0, 0, 0, 10, 51
"/opt/projects/swiftkube/vendor/k8s.io/client-go/applyconfigurations/networking/v1/networkpolicy.go", "Go", 220, 0, 0, 0, 0, 0, 30, 250
"/opt/projects/swiftkube/vendor/k8s.io/client-go/applyconfigurations/networking/v1/networkpolicyegressrule.go", "Go", 49, 0, 0, 0, 0, 0, 10, 59
"/opt/projects/swiftkube/vendor/k8s.io/client-go/applyconfigurations/networking/v1/networkpolicyingressrule.go", "Go", 49, 0, 0, 0, 0, 0, 10, 59
"/opt/projects/swiftkube/vendor/k8s.io/client-go/applyconfigurations/networking/v1/networkpolicypeer.go", "Go", 50, 0, 0, 0, 0, 0, 12, 62
"/opt/projects/swiftkube/vendor/k8s.io/client-go/applyconfigurations/networking/v1/networkpolicyport.go", "Go", 51, 0, 0, 0, 0, 0, 12, 63
"/opt/projects/swiftkube/vendor/k8s.io/client-go/applyconfigurations/networking/v1/networkpolicyspec.go", "Go", 71, 0, 0, 0, 0, 0, 13, 84
"/opt/projects/swiftkube/vendor/k8s.io/client-go/applyconfigurations/networking/v1/servicebackendport.go", "Go", 39, 0, 0, 0, 0, 0, 10, 49
"/opt/projects/swiftkube/vendor/k8s.io/client-go/applyconfigurations/networking/v1alpha1/clustercidr.go", "Go", 218, 0, 0, 0, 0, 0, 30, 248
"/opt/projects/swiftkube/vendor/k8s.io/client-go/applyconfigurations/networking/v1alpha1/clustercidrspec.go", "Go", 58, 0, 0, 0, 0, 0, 13, 71
"/opt/projects/swiftkube/vendor/k8s.io/client-go/applyconfigurations/networking/v1alpha1/ipaddress.go", "Go", 218, 0, 0, 0, 0, 0, 30, 248
"/opt/projects/swiftkube/vendor/k8s.io/client-go/applyconfigurations/networking/v1alpha1/ipaddressspec.go", "Go", 31, 0, 0, 0, 0, 0, 9, 40
"/opt/projects/swiftkube/vendor/k8s.io/client-go/applyconfigurations/networking/v1alpha1/parentreference.go", "Go", 66, 0, 0, 0, 0, 0, 14, 80
"/opt/projects/swiftkube/vendor/k8s.io/client-go/applyconfigurations/networking/v1beta1/httpingresspath.go", "Go", 50, 0, 0, 0, 0, 0, 12, 62
"/opt/projects/swiftkube/vendor/k8s.io/client-go/applyconfigurations/networking/v1beta1/httpingressrulevalue.go", "Go", 36, 0, 0, 0, 0, 0, 9, 45
"/opt/projects/swiftkube/vendor/k8s.io/client-go/applyconfigurations/networking/v1beta1/ingress.go", "Go", 228, 0, 0, 0, 0, 0, 31, 259
"/opt/projects/swiftkube/vendor/k8s.io/client-go/applyconfigurations/networking/v1beta1/ingressbackend.go", "Go", 51, 0, 0, 0, 0, 0, 12, 63
"/opt/projects/swiftkube/vendor/k8s.io/client-go/applyconfigurations/networking/v1beta1/ingressclass.go", "Go", 218, 0, 0, 0, 0, 0, 30, 248
"/opt/projects/swiftkube/vendor/k8s.io/client-go/applyconfigurations/networking/v1beta1/ingressclassparametersreference.go", "Go", 63, 0, 0, 0, 0, 0, 13, 76
"/opt/projects/swiftkube/vendor/k8s.io/client-go/applyconfigurations/networking/v1beta1/ingressclassspec.go", "Go", 39, 0, 0, 0, 0, 0, 10, 49
"/opt/projects/swiftkube/vendor/k8s.io/client-go/applyconfigurations/networking/v1beta1/ingressloadbalanceringress.go", "Go", 52, 0, 0, 0, 0, 0, 11, 63
"/opt/projects/swiftkube/vendor/k8s.io/client-go/applyconfigurations/networking/v1beta1/ingressloadbalancerstatus.go", "Go", 36, 0, 0, 0, 0, 0, 9, 45
"/opt/projects/swiftkube/vendor/k8s.io/client-go/applyconfigurations/networking/v1beta1/ingressportstatus.go", "Go", 50, 0, 0, 0, 0, 0, 12, 62
"/opt/projects/swiftkube/vendor/k8s.io/client-go/applyconfigurations/networking/v1beta1/ingressrule.go", "Go", 39, 0, 0, 0, 0, 0, 10, 49
"/opt/projects/swiftkube/vendor/k8s.io/client-go/applyconfigurations/networking/v1beta1/ingressrulevalue.go", "Go", 31, 0, 0, 0, 0, 0, 9, 40
"/opt/projects/swiftkube/vendor/k8s.io/client-go/applyconfigurations/networking/v1beta1/ingressspec.go", "Go", 65, 0, 0, 0, 0, 0, 12, 77
"/opt/projects/swiftkube/vendor/k8s.io/client-go/applyconfigurations/networking/v1beta1/ingressstatus.go", "Go", 31, 0, 0, 0, 0, 0, 9, 40
"/opt/projects/swiftkube/vendor/k8s.io/client-go/applyconfigurations/networking/v1beta1/ingresstls.go", "Go", 41, 0, 0, 0, 0, 0, 10, 51
"/opt/projects/swiftkube/vendor/k8s.io/client-go/applyconfigurations/node/v1/overhead.go", "Go", 34, 0, 0, 0, 0, 0, 10, 44
"/opt/projects/swiftkube/vendor/k8s.io/client-go/applyconfigurations/node/v1/runtimeclass.go", "Go", 234, 0, 0, 0, 0, 0, 32, 266
"/opt/projects/swiftkube/vendor/k8s.io/client-go/applyconfigurations/node/v1/scheduling.go", "Go", 53, 0, 0, 0, 0, 0, 11, 64
"/opt/projects/swiftkube/vendor/k8s.io/client-go/applyconfigurations/node/v1alpha1/overhead.go", "Go", 34, 0, 0, 0, 0, 0, 10, 44
"/opt/projects/swiftkube/vendor/k8s.io/client-go/applyconfigurations/node/v1alpha1/runtimeclass.go", "Go", 218, 0, 0, 0, 0, 0, 30, 248
"/opt/projects/swiftkube/vendor/k8s.io/client-go/applyconfigurations/node/v1alpha1/runtimeclassspec.go", "Go", 47, 0, 0, 0, 0, 0, 11, 58
"/opt/projects/swiftkube/vendor/k8s.io/client-go/applyconfigurations/node/v1alpha1/scheduling.go", "Go", 53, 0, 0, 0, 0, 0, 11, 64
"/opt/projects/swiftkube/vendor/k8s.io/client-go/applyconfigurations/node/v1beta1/overhead.go", "Go", 34, 0, 0, 0, 0, 0, 10, 44
"/opt/projects/swiftkube/vendor/k8s.io/client-go/applyconfigurations/node/v1beta1/runtimeclass.go", "Go", 234, 0, 0, 0, 0, 0, 32, 266
"/opt/projects/swiftkube/vendor/k8s.io/client-go/applyconfigurations/node/v1beta1/scheduling.go", "Go", 53, 0, 0, 0, 0, 0, 11, 64
"/opt/projects/swiftkube/vendor/k8s.io/client-go/applyconfigurations/policy/v1/eviction.go", "Go", 220, 0, 0, 0, 0, 0, 30, 250
"/opt/projects/swiftkube/vendor/k8s.io/client-go/applyconfigurations/policy/v1/poddisruptionbudget.go", "Go", 228, 0, 0, 0, 0, 0, 31, 259
"/opt/projects/swiftkube/vendor/k8s.io/client-go/applyconfigurations/policy/v1/poddisruptionbudgetspec.go", "Go", 60, 0, 0, 0, 0, 0, 13, 73
"/opt/projects/swiftkube/vendor/k8s.io/client-go/applyconfigurations/policy/v1/poddisruptionbudgetstatus.go", "Go", 94, 0, 0, 0, 0, 0, 16, 110
"/opt/projects/swiftkube/vendor/k8s.io/client-go/applyconfigurations/policy/v1beta1/allowedcsidriver.go", "Go", 31, 0, 0, 0, 0, 0, 9, 40
"/opt/projects/swiftkube/vendor/k8s.io/client-go/applyconfigurations/policy/v1beta1/allowedflexvolume.go", "Go", 31, 0, 0, 0, 0, 0, 9, 40
"/opt/projects/swiftkube/vendor/k8s.io/client-go/applyconfigurations/policy/v1beta1/allowedhostpath.go", "Go", 39, 0, 0, 0, 0, 0, 10, 49
"/opt/projects/swiftkube/vendor/k8s.io/client-go/applyconfigurations/policy/v1beta1/eviction.go", "Go", 220, 0, 0, 0, 0, 0, 30, 250
"/opt/projects/swiftkube/vendor/k8s.io/client-go/applyconfigurations/policy/v1beta1/fsgroupstrategyoptions.go", "Go", 47, 0, 0, 0, 0, 0, 11, 58
"/opt/projects/swiftkube/vendor/k8s.io/client-go/applyconfigurations/policy/v1beta1/hostportrange.go", "Go", 39, 0, 0, 0, 0, 0, 10, 49
"/opt/projects/swiftkube/vendor/k8s.io/client-go/applyconfigurations/policy/v1beta1/idrange.go", "Go", 39, 0, 0, 0, 0, 0, 10, 49
"/opt/projects/swiftkube/vendor/k8s.io/client-go/applyconfigurations/policy/v1beta1/poddisruptionbudget.go", "Go", 228, 0, 0, 0, 0, 0, 31, 259
"/opt/projects/swiftkube/vendor/k8s.io/client-go/applyconfigurations/policy/v1beta1/poddisruptionbudgetspec.go", "Go", 60, 0, 0, 0, 0, 0, 13, 73
"/opt/projects/swiftkube/vendor/k8s.io/client-go/applyconfigurations/policy/v1beta1/poddisruptionbudgetstatus.go", "Go", 94, 0, 0, 0, 0, 0, 16, 110
"/opt/projects/swiftkube/vendor/k8s.io/client-go/applyconfigurations/policy/v1beta1/podsecuritypolicy.go", "Go", 218, 0, 0, 0, 0, 0, 30, 248
"/opt/projects/swiftkube/vendor/k8s.io/client-go/applyconfigurations/policy/v1beta1/podsecuritypolicyspec.go", "Go", 253, 0, 0, 0, 0, 0, 33, 286
"/opt/projects/swiftkube/vendor/k8s.io/client-go/applyconfigurations/policy/v1beta1/runasgroupstrategyoptions.go", "Go", 47, 0, 0, 0, 0, 0, 11, 58
"/opt/projects/swiftkube/vendor/k8s.io/client-go/applyconfigurations/policy/v1beta1/runasuserstrategyoptions.go", "Go", 47, 0, 0, 0, 0, 0, 11, 58
"/opt/projects/swiftkube/vendor/k8s.io/client-go/applyconfigurations/policy/v1beta1/runtimeclassstrategyoptions.go", "Go", 41, 0, 0, 0, 0, 0, 10, 51
"/opt/projects/swiftkube/vendor/k8s.io/client-go/applyconfigurations/policy/v1beta1/selinuxstrategyoptions.go", "Go", 43, 0, 0, 0, 0, 0, 11, 54
"/opt/projects/swiftkube/vendor/k8s.io/client-go/applyconfigurations/policy/v1beta1/supplementalgroupsstrategyoptions.go", "Go", 47, 0, 0, 0, 0, 0, 11, 58
"/opt/projects/swiftkube/vendor/k8s.io/client-go/applyconfigurations/rbac/v1/aggregationrule.go", "Go", 39, 0, 0, 0, 0, 0, 10, 49
"/opt/projects/swiftkube/vendor/k8s.io/client-go/applyconfigurations/rbac/v1/clusterrole.go", "Go", 231, 0, 0, 0, 0, 0, 31, 262
"/opt/projects/swiftkube/vendor/k8s.io/client-go/applyconfigurations/rbac/v1/clusterrolebinding.go", "Go", 231, 0, 0, 0, 0, 0, 31, 262
"/opt/projects/swiftkube/vendor/k8s.io/client-go/applyconfigurations/rbac/v1/policyrule.go", "Go", 73, 0, 0, 0, 0, 0, 13, 86
"/opt/projects/swiftkube/vendor/k8s.io/client-go/applyconfigurations/rbac/v1/role.go", "Go", 225, 0, 0, 0, 0, 0, 30, 255
"/opt/projects/swiftkube/vendor/k8s.io/client-go/applyconfigurations/rbac/v1/rolebinding.go", "Go", 233, 0, 0, 0, 0, 0, 31, 264
"/opt/projects/swiftkube/vendor/k8s.io/client-go/applyconfigurations/rbac/v1/roleref.go", "Go", 47, 0, 0, 0, 0, 0, 11, 58
"/opt/projects/swiftkube/vendor/k8s.io/client-go/applyconfigurations/rbac/v1/subject.go", "Go", 55, 0, 0, 0, 0, 0, 12, 67
"/opt/projects/swiftkube/vendor/k8s.io/client-go/applyconfigurations/rbac/v1alpha1/aggregationrule.go", "Go", 39, 0, 0, 0, 0, 0, 10, 49
"/opt/projects/swiftkube/vendor/k8s.io/client-go/applyconfigurations/rbac/v1alpha1/clusterrole.go", "Go", 231, 0, 0, 0, 0, 0, 31, 262
"/opt/projects/swiftkube/vendor/k8s.io/client-go/applyconfigurations/rbac/v1alpha1/clusterrolebinding.go", "Go", 231, 0, 0, 0, 0, 0, 31, 262
"/opt/projects/swiftkube/vendor/k8s.io/client-go/applyconfigurations/rbac/v1alpha1/policyrule.go", "Go", 73, 0, 0, 0, 0, 0, 13, 86
"/opt/projects/swiftkube/vendor/k8s.io/client-go/applyconfigurations/rbac/v1alpha1/role.go", "Go", 225, 0, 0, 0, 0, 0, 30, 255
"/opt/projects/swiftkube/vendor/k8s.io/client-go/applyconfigurations/rbac/v1alpha1/rolebinding.go", "Go", 233, 0, 0, 0, 0, 0, 31, 264
"/opt/projects/swiftkube/vendor/k8s.io/client-go/applyconfigurations/rbac/v1alpha1/roleref.go", "Go", 47, 0, 0, 0, 0, 0, 11, 58
"/opt/projects/swiftkube/vendor/k8s.io/client-go/applyconfigurations/rbac/v1alpha1/subject.go", "Go", 55, 0, 0, 0, 0, 0, 12, 67
"/opt/projects/swiftkube/vendor/k8s.io/client-go/applyconfigurations/rbac/v1beta1/aggregationrule.go", "Go", 39, 0, 0, 0, 0, 0, 10, 49
"/opt/projects/swiftkube/vendor/k8s.io/client-go/applyconfigurations/rbac/v1beta1/clusterrole.go", "Go", 231, 0, 0, 0, 0, 0, 31, 262
"/opt/projects/swiftkube/vendor/k8s.io/client-go/applyconfigurations/rbac/v1beta1/clusterrolebinding.go", "Go", 231, 0, 0, 0, 0, 0, 31, 262
"/opt/projects/swiftkube/vendor/k8s.io/client-go/applyconfigurations/rbac/v1beta1/policyrule.go", "Go", 73, 0, 0, 0, 0, 0, 13, 86
"/opt/projects/swiftkube/vendor/k8s.io/client-go/applyconfigurations/rbac/v1beta1/role.go", "Go", 225, 0, 0, 0, 0, 0, 30, 255
"/opt/projects/swiftkube/vendor/k8s.io/client-go/applyconfigurations/rbac/v1beta1/rolebinding.go", "Go", 233, 0, 0, 0, 0, 0, 31, 264
"/opt/projects/swiftkube/vendor/k8s.io/client-go/applyconfigurations/rbac/v1beta1/roleref.go", "Go", 47, 0, 0, 0, 0, 0, 11, 58
"/opt/projects/swiftkube/vendor/k8s.io/client-go/applyconfigurations/rbac/v1beta1/subject.go", "Go", 55, 0, 0, 0, 0, 0, 12, 67
"/opt/projects/swiftkube/vendor/k8s.io/client-go/applyconfigurations/resource/v1alpha2/allocationresult.go", "Go", 55, 0, 0, 0, 0, 0, 12, 67
"/opt/projects/swiftkube/vendor/k8s.io/client-go/applyconfigurations/resource/v1alpha2/podschedulingcontext.go", "Go", 228, 0, 0, 0, 0, 0, 31, 259
"/opt/projects/swiftkube/vendor/k8s.io/client-go/applyconfigurations/resource/v1alpha2/podschedulingcontextspec.go", "Go", 41, 0, 0, 0, 0, 0, 10, 51
"/opt/projects/swiftkube/vendor/k8s.io/client-go/applyconfigurations/resource/v1alpha2/podschedulingcontextstatus.go", "Go", 36, 0, 0, 0, 0, 0, 9, 45
"/opt/projects/swiftkube/vendor/k8s.io/client-go/applyconfigurations/resource/v1alpha2/resourceclaim.go", "Go", 228, 0, 0, 0, 0, 0, 31, 259
"/opt/projects/swiftkube/vendor/k8s.io/client-go/applyconfigurations/resource/v1alpha2/resourceclaimconsumerreference.go", "Go", 58, 0, 0, 0, 0, 0, 13, 71
"/opt/projects/swiftkube/vendor/k8s.io/client-go/applyconfigurations/resource/v1alpha2/resourceclaimparametersreference.go", "Go", 47, 0, 0, 0, 0, 0, 11, 58
"/opt/projects/swiftkube/vendor/k8s.io/client-go/applyconfigurations/resource/v1alpha2/resourceclaimschedulingstatus.go", "Go", 41, 0, 0, 0, 0, 0, 10, 51
"/opt/projects/swiftkube/vendor/k8s.io/client-go/applyconfigurations/resource/v1alpha2/resourceclaimspec.go", "Go", 50, 0, 0, 0, 0, 0, 12, 62
"/opt/projects/swiftkube/vendor/k8s.io/client-go/applyconfigurations/resource/v1alpha2/resourceclaimstatus.go", "Go", 60, 0, 0, 0, 0, 0, 12, 72
"/opt/projects/swiftkube/vendor/k8s.io/client-go/applyconfigurations/resource/v1alpha2/resourceclaimtemplate.go", "Go", 220, 0, 0, 0, 0, 0, 30, 250
"/opt/projects/swiftkube/vendor/k8s.io/client-go/applyconfigurations/resource/v1alpha2/resourceclaimtemplatespec.go", "Go", 165, 0, 0, 0, 0, 0, 24, 189
"/opt/projects/swiftkube/vendor/k8s.io/client-go/applyconfigurations/resource/v1alpha2/resourceclass.go", "Go", 235, 0, 0, 0, 0, 0, 32, 267
"/opt/projects/swiftkube/vendor/k8s.io/client-go/applyconfigurations/resource/v1alpha2/resourceclassparametersreference.go", "Go", 55, 0, 0, 0, 0, 0, 12, 67
"/opt/projects/swiftkube/vendor/k8s.io/client-go/applyconfigurations/resource/v1alpha2/resourcehandle.go", "Go", 39, 0, 0, 0, 0, 0, 10, 49
"/opt/projects/swiftkube/vendor/k8s.io/client-go/applyconfigurations/scheduling/v1/priorityclass.go", "Go", 243, 0, 0, 0, 0, 0, 33, 276
"/opt/projects/swiftkube/vendor/k8s.io/client-go/applyconfigurations/scheduling/v1alpha1/priorityclass.go", "Go", 243, 0, 0, 0, 0, 0, 33, 276
"/opt/projects/swiftkube/vendor/k8s.io/client-go/applyconfigurations/scheduling/v1beta1/priorityclass.go", "Go", 243, 0, 0, 0, 0, 0, 33, 276
"/opt/projects/swiftkube/vendor/k8s.io/client-go/applyconfigurations/storage/v1/csidriver.go", "Go", 218, 0, 0, 0, 0, 0, 30, 248
"/opt/projects/swiftkube/vendor/k8s.io/client-go/applyconfigurations/storage/v1/csidriverspec.go", "Go", 97, 0, 0, 0, 0, 0, 17, 114
"/opt/projects/swiftkube/vendor/k8s.io/client-go/applyconfigurations/storage/v1/csinode.go", "Go", 218, 0, 0, 0, 0, 0, 30, 248
"/opt/projects/swiftkube/vendor/k8s.io/client-go/applyconfigurations/storage/v1/csinodedriver.go", "Go", 57, 0, 0, 0, 0, 0, 12, 69
"/opt/projects/swiftkube/vendor/k8s.io/client-go/applyconfigurations/storage/v1/csinodespec.go", "Go", 36, 0, 0, 0, 0, 0, 9, 45
"/opt/projects/swiftkube/vendor/k8s.io/client-go/applyconfigurations/storage/v1/csistoragecapacity.go", "Go", 245, 0, 0, 0, 0, 0, 33, 278
"/opt/projects/swiftkube/vendor/k8s.io/client-go/applyconfigurations/storage/v1/storageclass.go", "Go", 281, 0, 0, 0, 0, 0, 36, 317
"/opt/projects/swiftkube/vendor/k8s.io/client-go/applyconfigurations/storage/v1/tokenrequest.go", "Go", 39, 0, 0, 0, 0, 0, 10, 49
"/opt/projects/swiftkube/vendor/k8s.io/client-go/applyconfigurations/storage/v1/volumeattachment.go", "Go", 226, 0, 0, 0, 0, 0, 31, 257
"/opt/projects/swiftkube/vendor/k8s.io/client-go/applyconfigurations/storage/v1/volumeattachmentsource.go", "Go", 42, 0, 0, 0, 0, 0, 11, 53
"/opt/projects/swiftkube/vendor/k8s.io/client-go/applyconfigurations/storage/v1/volumeattachmentspec.go", "Go", 47, 0, 0, 0, 0, 0, 11, 58
"/opt/projects/swiftkube/vendor/k8s.io/client-go/applyconfigurations/storage/v1/volumeattachmentstatus.go", "Go", 61, 0, 0, 0, 0, 0, 12, 73
"/opt/projects/swiftkube/vendor/k8s.io/client-go/applyconfigurations/storage/v1/volumeerror.go", "Go", 42, 0, 0, 0, 0, 0, 11, 53
"/opt/projects/swiftkube/vendor/k8s.io/client-go/applyconfigurations/storage/v1/volumenoderesources.go", "Go", 31, 0, 0, 0, 0, 0, 9, 40
"/opt/projects/swiftkube/vendor/k8s.io/client-go/applyconfigurations/storage/v1alpha1/csistoragecapacity.go", "Go", 245, 0, 0, 0, 0, 0, 33, 278
"/opt/projects/swiftkube/vendor/k8s.io/client-go/applyconfigurations/storage/v1alpha1/volumeattachment.go", "Go", 226, 0, 0, 0, 0, 0, 31, 257
"/opt/projects/swiftkube/vendor/k8s.io/client-go/applyconfigurations/storage/v1alpha1/volumeattachmentsource.go", "Go", 42, 0, 0, 0, 0, 0, 11, 53
"/opt/projects/swiftkube/vendor/k8s.io/client-go/applyconfigurations/storage/v1alpha1/volumeattachmentspec.go", "Go", 47, 0, 0, 0, 0, 0, 11, 58
"/opt/projects/swiftkube/vendor/k8s.io/client-go/applyconfigurations/storage/v1alpha1/volumeattachmentstatus.go", "Go", 61, 0, 0, 0, 0, 0, 12, 73
"/opt/projects/swiftkube/vendor/k8s.io/client-go/applyconfigurations/storage/v1alpha1/volumeerror.go", "Go", 42, 0, 0, 0, 0, 0, 11, 53
"/opt/projects/swiftkube/vendor/k8s.io/client-go/applyconfigurations/storage/v1beta1/csidriver.go", "Go", 218, 0, 0, 0, 0, 0, 30, 248
"/opt/projects/swiftkube/vendor/k8s.io/client-go/applyconfigurations/storage/v1beta1/csidriverspec.go", "Go", 97, 0, 0, 0, 0, 0, 17, 114
"/opt/projects/swiftkube/vendor/k8s.io/client-go/applyconfigurations/storage/v1beta1/csinode.go", "Go", 218, 0, 0, 0, 0, 0, 30, 248
"/opt/projects/swiftkube/vendor/k8s.io/client-go/applyconfigurations/storage/v1beta1/csinodedriver.go", "Go", 57, 0, 0, 0, 0, 0, 12, 69
"/opt/projects/swiftkube/vendor/k8s.io/client-go/applyconfigurations/storage/v1beta1/csinodespec.go", "Go", 36, 0, 0, 0, 0, 0, 9, 45
"/opt/projects/swiftkube/vendor/k8s.io/client-go/applyconfigurations/storage/v1beta1/csistoragecapacity.go", "Go", 245, 0, 0, 0, 0, 0, 33, 278
"/opt/projects/swiftkube/vendor/k8s.io/client-go/applyconfigurations/storage/v1beta1/storageclass.go", "Go", 281, 0, 0, 0, 0, 0, 36, 317
"/opt/projects/swiftkube/vendor/k8s.io/client-go/applyconfigurations/storage/v1beta1/tokenrequest.go", "Go", 39, 0, 0, 0, 0, 0, 10, 49
"/opt/projects/swiftkube/vendor/k8s.io/client-go/applyconfigurations/storage/v1beta1/volumeattachment.go", "Go", 226, 0, 0, 0, 0, 0, 31, 257
"/opt/projects/swiftkube/vendor/k8s.io/client-go/applyconfigurations/storage/v1beta1/volumeattachmentsource.go", "Go", 42, 0, 0, 0, 0, 0, 11, 53
"/opt/projects/swiftkube/vendor/k8s.io/client-go/applyconfigurations/storage/v1beta1/volumeattachmentspec.go", "Go", 47, 0, 0, 0, 0, 0, 11, 58
"/opt/projects/swiftkube/vendor/k8s.io/client-go/applyconfigurations/storage/v1beta1/volumeattachmentstatus.go", "Go", 61, 0, 0, 0, 0, 0, 12, 73
"/opt/projects/swiftkube/vendor/k8s.io/client-go/applyconfigurations/storage/v1beta1/volumeerror.go", "Go", 42, 0, 0, 0, 0, 0, 11, 53
"/opt/projects/swiftkube/vendor/k8s.io/client-go/applyconfigurations/storage/v1beta1/volumenoderesources.go", "Go", 31, 0, 0, 0, 0, 0, 9, 40
"/opt/projects/swiftkube/vendor/k8s.io/client-go/discovery/aggregated_discovery.go", "Go", 143, 0, 0, 0, 0, 0, 14, 157
"/opt/projects/swiftkube/vendor/k8s.io/client-go/discovery/cached/disk/cached_discovery.go", "Go", 272, 0, 0, 0, 0, 0, 54, 326
"/opt/projects/swiftkube/vendor/k8s.io/client-go/discovery/cached/disk/round_tripper.go", "Go", 101, 0, 0, 0, 0, 0, 20, 121
"/opt/projects/swiftkube/vendor/k8s.io/client-go/discovery/cached/memory/memcache.go", "Go", 288, 0, 0, 0, 0, 0, 45, 333
"/opt/projects/swiftkube/vendor/k8s.io/client-go/discovery/discovery_client.go", "Go", 684, 0, 0, 0, 0, 0, 78, 762
"/opt/projects/swiftkube/vendor/k8s.io/client-go/discovery/doc.go", "Go", 15, 0, 0, 0, 0, 0, 5, 20
"/opt/projects/swiftkube/vendor/k8s.io/client-go/discovery/fake/discovery.go", "Go", 147, 0, 0, 0, 0, 0, 28, 175
"/opt/projects/swiftkube/vendor/k8s.io/client-go/discovery/helper.go", "Go", 125, 0, 0, 0, 0, 0, 22, 147
"/opt/projects/swiftkube/vendor/k8s.io/client-go/dynamic/dynamicinformer/informer.go", "Go", 159, 0, 0, 0, 0, 0, 30, 189
"/opt/projects/swiftkube/vendor/k8s.io/client-go/dynamic/dynamicinformer/interface.go", "Go", 43, 0, 0, 0, 0, 0, 11, 54
"/opt/projects/swiftkube/vendor/k8s.io/client-go/dynamic/dynamiclister/interface.go", "Go", 33, 0, 0, 0, 0, 0, 8, 41
"/opt/projects/swiftkube/vendor/k8s.io/client-go/dynamic/dynamiclister/lister.go", "Go", 77, 0, 0, 0, 0, 0, 15, 92
"/opt/projects/swiftkube/vendor/k8s.io/client-go/dynamic/dynamiclister/shim.go", "Go", 71, 0, 0, 0, 0, 0, 17, 88
"/opt/projects/swiftkube/vendor/k8s.io/client-go/dynamic/interface.go", "Go", 52, 0, 0, 0, 0, 0, 12, 64
"/opt/projects/swiftkube/vendor/k8s.io/client-go/dynamic/scheme.go", "Go", 91, 0, 0, 0, 0, 0, 18, 109
"/opt/projects/swiftkube/vendor/k8s.io/client-go/dynamic/simple.go", "Go", 393, 0, 0, 0, 0, 0, 45, 438
"/opt/projects/swiftkube/vendor/k8s.io/client-go/informers/admissionregistration/interface.go", "Go", 50, 0, 0, 0, 0, 0, 13, 63
"/opt/projects/swiftkube/vendor/k8s.io/client-go/informers/admissionregistration/v1/interface.go", "Go", 41, 0, 0, 0, 0, 0, 12, 53
"/opt/projects/swiftkube/vendor/k8s.io/client-go/informers/admissionregistration/v1/mutatingwebhookconfiguration.go", "Go", 75, 0, 0, 0, 0, 0, 15, 90
"/opt/projects/swiftkube/vendor/k8s.io/client-go/informers/admissionregistration/v1/validatingwebhookconfiguration.go", "Go", 75, 0, 0, 0, 0, 0, 15, 90
"/opt/projects/swiftkube/vendor/k8s.io/client-go/informers/admissionregistration/v1alpha1/interface.go", "Go", 41, 0, 0, 0, 0, 0, 12, 53
"/opt/projects/swiftkube/vendor/k8s.io/client-go/informers/admissionregistration/v1alpha1/validatingadmissionpolicy.go", "Go", 75, 0, 0, 0, 0, 0, 15, 90
"/opt/projects/swiftkube/vendor/k8s.io/client-go/informers/admissionregistration/v1alpha1/validatingadmissionpolicybinding.go", "Go", 75, 0, 0, 0, 0, 0, 15, 90
"/opt/projects/swiftkube/vendor/k8s.io/client-go/informers/admissionregistration/v1beta1/interface.go", "Go", 53, 0, 0, 0, 0, 0, 14, 67
"/opt/projects/swiftkube/vendor/k8s.io/client-go/informers/admissionregistration/v1beta1/mutatingwebhookconfiguration.go", "Go", 75, 0, 0, 0, 0, 0, 15, 90
"/opt/projects/swiftkube/vendor/k8s.io/client-go/informers/admissionregistration/v1beta1/validatingadmissionpolicy.go", "Go", 75, 0, 0, 0, 0, 0, 15, 90
"/opt/projects/swiftkube/vendor/k8s.io/client-go/informers/admissionregistration/v1beta1/validatingadmissionpolicybinding.go", "Go", 75, 0, 0, 0, 0, 0, 15, 90
"/opt/projects/swiftkube/vendor/k8s.io/client-go/informers/admissionregistration/v1beta1/validatingwebhookconfiguration.go", "Go", 75, 0, 0, 0, 0, 0, 15, 90
"/opt/projects/swiftkube/vendor/k8s.io/client-go/informers/apiserverinternal/interface.go", "Go", 36, 0, 0, 0, 0, 0, 11, 47
"/opt/projects/swiftkube/vendor/k8s.io/client-go/informers/apiserverinternal/v1alpha1/interface.go", "Go", 35, 0, 0, 0, 0, 0, 11, 46
"/opt/projects/swiftkube/vendor/k8s.io/client-go/informers/apiserverinternal/v1alpha1/storageversion.go", "Go", 75, 0, 0, 0, 0, 0, 15, 90
"/opt/projects/swiftkube/vendor/k8s.io/client-go/informers/apps/interface.go", "Go", 50, 0, 0, 0, 0, 0, 13, 63
"/opt/projects/swiftkube/vendor/k8s.io/client-go/informers/apps/v1/controllerrevision.go", "Go", 76, 0, 0, 0, 0, 0, 15, 91
"/opt/projects/swiftkube/vendor/k8s.io/client-go/informers/apps/v1/daemonset.go", "Go", 76, 0, 0, 0, 0, 0, 15, 91
"/opt/projects/swiftkube/vendor/k8s.io/client-go/informers/apps/v1/deployment.go", "Go", 76, 0, 0, 0, 0, 0, 15, 91
"/opt/projects/swiftkube/vendor/k8s.io/client-go/informers/apps/v1/interface.go", "Go", 59, 0, 0, 0, 0, 0, 15, 74
"/opt/projects/swiftkube/vendor/k8s.io/client-go/informers/apps/v1/replicaset.go", "Go", 76, 0, 0, 0, 0, 0, 15, 91
"/opt/projects/swiftkube/vendor/k8s.io/client-go/informers/apps/v1/statefulset.go", "Go", 76, 0, 0, 0, 0, 0, 15, 91
"/opt/projects/swiftkube/vendor/k8s.io/client-go/informers/apps/v1beta1/controllerrevision.go", "Go", 76, 0, 0, 0, 0, 0, 15, 91
"/opt/projects/swiftkube/vendor/k8s.io/client-go/informers/apps/v1beta1/deployment.go", "Go", 76, 0, 0, 0, 0, 0, 15, 91
"/opt/projects/swiftkube/vendor/k8s.io/client-go/informers/apps/v1beta1/interface.go", "Go", 47, 0, 0, 0, 0, 0, 13, 60
"/opt/projects/swiftkube/vendor/k8s.io/client-go/informers/apps/v1beta1/statefulset.go", "Go", 76, 0, 0, 0, 0, 0, 15, 91
"/opt/projects/swiftkube/vendor/k8s.io/client-go/informers/apps/v1beta2/controllerrevision.go", "Go", 76, 0, 0, 0, 0, 0, 15, 91
"/opt/projects/swiftkube/vendor/k8s.io/client-go/informers/apps/v1beta2/daemonset.go", "Go", 76, 0, 0, 0, 0, 0, 15, 91
"/opt/projects/swiftkube/vendor/k8s.io/client-go/informers/apps/v1beta2/deployment.go", "Go", 76, 0, 0, 0, 0, 0, 15, 91
"/opt/projects/swiftkube/vendor/k8s.io/client-go/informers/apps/v1beta2/interface.go", "Go", 59, 0, 0, 0, 0, 0, 15, 74
"/opt/projects/swiftkube/vendor/k8s.io/client-go/informers/apps/v1beta2/replicaset.go", "Go", 76, 0, 0, 0, 0, 0, 15, 91
"/opt/projects/swiftkube/vendor/k8s.io/client-go/informers/apps/v1beta2/statefulset.go", "Go", 76, 0, 0, 0, 0, 0, 15, 91
"/opt/projects/swiftkube/vendor/k8s.io/client-go/informers/autoscaling/interface.go", "Go", 57, 0, 0, 0, 0, 0, 14, 71
"/opt/projects/swiftkube/vendor/k8s.io/client-go/informers/autoscaling/v1/horizontalpodautoscaler.go", "Go", 76, 0, 0, 0, 0, 0, 15, 91
"/opt/projects/swiftkube/vendor/k8s.io/client-go/informers/autoscaling/v1/interface.go", "Go", 35, 0, 0, 0, 0, 0, 11, 46
"/opt/projects/swiftkube/vendor/k8s.io/client-go/informers/autoscaling/v2/horizontalpodautoscaler.go", "Go", 76, 0, 0, 0, 0, 0, 15, 91
"/opt/projects/swiftkube/vendor/k8s.io/client-go/informers/autoscaling/v2/interface.go", "Go", 35, 0, 0, 0, 0, 0, 11, 46
"/opt/projects/swiftkube/vendor/k8s.io/client-go/informers/autoscaling/v2beta1/horizontalpodautoscaler.go", "Go", 76, 0, 0, 0, 0, 0, 15, 91
"/opt/projects/swiftkube/vendor/k8s.io/client-go/informers/autoscaling/v2beta1/interface.go", "Go", 35, 0, 0, 0, 0, 0, 11, 46
"/opt/projects/swiftkube/vendor/k8s.io/client-go/informers/autoscaling/v2beta2/horizontalpodautoscaler.go", "Go", 76, 0, 0, 0, 0, 0, 15, 91
"/opt/projects/swiftkube/vendor/k8s.io/client-go/informers/autoscaling/v2beta2/interface.go", "Go", 35, 0, 0, 0, 0, 0, 11, 46
"/opt/projects/swiftkube/vendor/k8s.io/client-go/informers/batch/interface.go", "Go", 43, 0, 0, 0, 0, 0, 12, 55
"/opt/projects/swiftkube/vendor/k8s.io/client-go/informers/batch/v1/cronjob.go", "Go", 76, 0, 0, 0, 0, 0, 15, 91
"/opt/projects/swiftkube/vendor/k8s.io/client-go/informers/batch/v1/interface.go", "Go", 41, 0, 0, 0, 0, 0, 12, 53
"/opt/projects/swiftkube/vendor/k8s.io/client-go/informers/batch/v1/job.go", "Go", 76, 0, 0, 0, 0, 0, 15, 91
"/opt/projects/swiftkube/vendor/k8s.io/client-go/informers/batch/v1beta1/cronjob.go", "Go", 76, 0, 0, 0, 0, 0, 15, 91
"/opt/projects/swiftkube/vendor/k8s.io/client-go/informers/batch/v1beta1/interface.go", "Go", 35, 0, 0, 0, 0, 0, 11, 46
"/opt/projects/swiftkube/vendor/k8s.io/client-go/informers/certificates/interface.go", "Go", 50, 0, 0, 0, 0, 0, 13, 63
"/opt/projects/swiftkube/vendor/k8s.io/client-go/informers/certificates/v1/certificatesigningrequest.go", "Go", 75, 0, 0, 0, 0, 0, 15, 90
"/opt/projects/swiftkube/vendor/k8s.io/client-go/informers/certificates/v1/interface.go", "Go", 35, 0, 0, 0, 0, 0, 11, 46
"/opt/projects/swiftkube/vendor/k8s.io/client-go/informers/certificates/v1alpha1/clustertrustbundle.go", "Go", 75, 0, 0, 0, 0, 0, 15, 90
"/opt/projects/swiftkube/vendor/k8s.io/client-go/informers/certificates/v1alpha1/interface.go", "Go", 35, 0, 0, 0, 0, 0, 11, 46
"/opt/projects/swiftkube/vendor/k8s.io/client-go/informers/certificates/v1beta1/certificatesigningrequest.go", "Go", 75, 0, 0, 0, 0, 0, 15, 90
"/opt/projects/swiftkube/vendor/k8s.io/client-go/informers/certificates/v1beta1/interface.go", "Go", 35, 0, 0, 0, 0, 0, 11, 46
"/opt/projects/swiftkube/vendor/k8s.io/client-go/informers/coordination/interface.go", "Go", 43, 0, 0, 0, 0, 0, 12, 55
"/opt/projects/swiftkube/vendor/k8s.io/client-go/informers/coordination/v1/interface.go", "Go", 35, 0, 0, 0, 0, 0, 11, 46
"/opt/projects/swiftkube/vendor/k8s.io/client-go/informers/coordination/v1/lease.go", "Go", 76, 0, 0, 0, 0, 0, 15, 91
"/opt/projects/swiftkube/vendor/k8s.io/client-go/informers/coordination/v1beta1/interface.go", "Go", 35, 0, 0, 0, 0, 0, 11, 46
"/opt/projects/swiftkube/vendor/k8s.io/client-go/informers/coordination/v1beta1/lease.go", "Go", 76, 0, 0, 0, 0, 0, 15, 91
"/opt/projects/swiftkube/vendor/k8s.io/client-go/informers/core/interface.go", "Go", 36, 0, 0, 0, 0, 0, 11, 47
"/opt/projects/swiftkube/vendor/k8s.io/client-go/informers/core/v1/componentstatus.go", "Go", 75, 0, 0, 0, 0, 0, 15, 90
"/opt/projects/swiftkube/vendor/k8s.io/client-go/informers/core/v1/configmap.go", "Go", 76, 0, 0, 0, 0, 0, 15, 91
"/opt/projects/swiftkube/vendor/k8s.io/client-go/informers/core/v1/endpoints.go", "Go", 76, 0, 0, 0, 0, 0, 15, 91
"/opt/projects/swiftkube/vendor/k8s.io/client-go/informers/core/v1/event.go", "Go", 76, 0, 0, 0, 0, 0, 15, 91
"/opt/projects/swiftkube/vendor/k8s.io/client-go/informers/core/v1/interface.go", "Go", 125, 0, 0, 0, 0, 0, 26, 151
"/opt/projects/swiftkube/vendor/k8s.io/client-go/informers/core/v1/limitrange.go", "Go", 76, 0, 0, 0, 0, 0, 15, 91
"/opt/projects/swiftkube/vendor/k8s.io/client-go/informers/core/v1/namespace.go", "Go", 75, 0, 0, 0, 0, 0, 15, 90
"/opt/projects/swiftkube/vendor/k8s.io/client-go/informers/core/v1/node.go", "Go", 75, 0, 0, 0, 0, 0, 15, 90
"/opt/projects/swiftkube/vendor/k8s.io/client-go/informers/core/v1/persistentvolume.go", "Go", 75, 0, 0, 0, 0, 0, 15, 90
"/opt/projects/swiftkube/vendor/k8s.io/client-go/informers/core/v1/persistentvolumeclaim.go", "Go", 76, 0, 0, 0, 0, 0, 15, 91
"/opt/projects/swiftkube/vendor/k8s.io/client-go/informers/core/v1/pod.go", "Go", 76, 0, 0, 0, 0, 0, 15, 91
"/opt/projects/swiftkube/vendor/k8s.io/client-go/informers/core/v1/podtemplate.go", "Go", 76, 0, 0, 0, 0, 0, 15, 91
"/opt/projects/swiftkube/vendor/k8s.io/client-go/informers/core/v1/replicationcontroller.go", "Go", 76, 0, 0, 0, 0, 0, 15, 91
"/opt/projects/swiftkube/vendor/k8s.io/client-go/informers/core/v1/resourcequota.go", "Go", 76, 0, 0, 0, 0, 0, 15, 91
"/opt/projects/swiftkube/vendor/k8s.io/client-go/informers/core/v1/secret.go", "Go", 76, 0, 0, 0, 0, 0, 15, 91
"/opt/projects/swiftkube/vendor/k8s.io/client-go/informers/core/v1/service.go", "Go", 76, 0, 0, 0, 0, 0, 15, 91
"/opt/projects/swiftkube/vendor/k8s.io/client-go/informers/core/v1/serviceaccount.go", "Go", 76, 0, 0, 0, 0, 0, 15, 91
"/opt/projects/swiftkube/vendor/k8s.io/client-go/informers/discovery/interface.go", "Go", 43, 0, 0, 0, 0, 0, 12, 55
"/opt/projects/swiftkube/vendor/k8s.io/client-go/informers/discovery/v1/endpointslice.go", "Go", 76, 0, 0, 0, 0, 0, 15, 91
"/opt/projects/swiftkube/vendor/k8s.io/client-go/informers/discovery/v1/interface.go", "Go", 35, 0, 0, 0, 0, 0, 11, 46
"/opt/projects/swiftkube/vendor/k8s.io/client-go/informers/discovery/v1beta1/endpointslice.go", "Go", 76, 0, 0, 0, 0, 0, 15, 91
"/opt/projects/swiftkube/vendor/k8s.io/client-go/informers/discovery/v1beta1/interface.go", "Go", 35, 0, 0, 0, 0, 0, 11, 46
"/opt/projects/swiftkube/vendor/k8s.io/client-go/informers/doc.go", "Go", 14, 0, 0, 0, 0, 0, 5, 19
"/opt/projects/swiftkube/vendor/k8s.io/client-go/informers/events/interface.go", "Go", 43, 0, 0, 0, 0, 0, 12, 55
"/opt/projects/swiftkube/vendor/k8s.io/client-go/informers/events/v1/event.go", "Go", 76, 0, 0, 0, 0, 0, 15, 91
"/opt/projects/swiftkube/vendor/k8s.io/client-go/informers/events/v1/interface.go", "Go", 35, 0, 0, 0, 0, 0, 11, 46
"/opt/projects/swiftkube/vendor/k8s.io/client-go/informers/events/v1beta1/event.go", "Go", 76, 0, 0, 0, 0, 0, 15, 91
"/opt/projects/swiftkube/vendor/k8s.io/client-go/informers/events/v1beta1/interface.go", "Go", 35, 0, 0, 0, 0, 0, 11, 46
"/opt/projects/swiftkube/vendor/k8s.io/client-go/informers/extensions/interface.go", "Go", 36, 0, 0, 0, 0, 0, 11, 47
"/opt/projects/swiftkube/vendor/k8s.io/client-go/informers/extensions/v1beta1/daemonset.go", "Go", 76, 0, 0, 0, 0, 0, 15, 91
"/opt/projects/swiftkube/vendor/k8s.io/client-go/informers/extensions/v1beta1/deployment.go", "Go", 76, 0, 0, 0, 0, 0, 15, 91
"/opt/projects/swiftkube/vendor/k8s.io/client-go/informers/extensions/v1beta1/ingress.go", "Go", 76, 0, 0, 0, 0, 0, 15, 91
"/opt/projects/swiftkube/vendor/k8s.io/client-go/informers/extensions/v1beta1/interface.go", "Go", 59, 0, 0, 0, 0, 0, 15, 74
"/opt/projects/swiftkube/vendor/k8s.io/client-go/informers/extensions/v1beta1/networkpolicy.go", "Go", 76, 0, 0, 0, 0, 0, 15, 91
"/opt/projects/swiftkube/vendor/k8s.io/client-go/informers/extensions/v1beta1/replicaset.go", "Go", 76, 0, 0, 0, 0, 0, 15, 91
"/opt/projects/swiftkube/vendor/k8s.io/client-go/informers/factory.go", "Go", 302, 0, 0, 0, 0, 0, 58, 360
"/opt/projects/swiftkube/vendor/k8s.io/client-go/informers/flowcontrol/interface.go", "Go", 57, 0, 0, 0, 0, 0, 14, 71
"/opt/projects/swiftkube/vendor/k8s.io/client-go/informers/flowcontrol/v1alpha1/flowschema.go", "Go", 75, 0, 0, 0, 0, 0, 15, 90
"/opt/projects/swiftkube/vendor/k8s.io/client-go/informers/flowcontrol/v1alpha1/interface.go", "Go", 41, 0, 0, 0, 0, 0, 12, 53
"/opt/projects/swiftkube/vendor/k8s.io/client-go/informers/flowcontrol/v1alpha1/prioritylevelconfiguration.go", "Go", 75, 0, 0, 0, 0, 0, 15, 90
"/opt/projects/swiftkube/vendor/k8s.io/client-go/informers/flowcontrol/v1beta1/flowschema.go", "Go", 75, 0, 0, 0, 0, 0, 15, 90
"/opt/projects/swiftkube/vendor/k8s.io/client-go/informers/flowcontrol/v1beta1/interface.go", "Go", 41, 0, 0, 0, 0, 0, 12, 53
"/opt/projects/swiftkube/vendor/k8s.io/client-go/informers/flowcontrol/v1beta1/prioritylevelconfiguration.go", "Go", 75, 0, 0, 0, 0, 0, 15, 90
"/opt/projects/swiftkube/vendor/k8s.io/client-go/informers/flowcontrol/v1beta2/flowschema.go", "Go", 75, 0, 0, 0, 0, 0, 15, 90
"/opt/projects/swiftkube/vendor/k8s.io/client-go/informers/flowcontrol/v1beta2/interface.go", "Go", 41, 0, 0, 0, 0, 0, 12, 53
"/opt/projects/swiftkube/vendor/k8s.io/client-go/informers/flowcontrol/v1beta2/prioritylevelconfiguration.go", "Go", 75, 0, 0, 0, 0, 0, 15, 90
"/opt/projects/swiftkube/vendor/k8s.io/client-go/informers/flowcontrol/v1beta3/flowschema.go", "Go", 75, 0, 0, 0, 0, 0, 15, 90
"/opt/projects/swiftkube/vendor/k8s.io/client-go/informers/flowcontrol/v1beta3/interface.go", "Go", 41, 0, 0, 0, 0, 0, 12, 53
"/opt/projects/swiftkube/vendor/k8s.io/client-go/informers/flowcontrol/v1beta3/prioritylevelconfiguration.go", "Go", 75, 0, 0, 0, 0, 0, 15, 90
"/opt/projects/swiftkube/vendor/k8s.io/client-go/informers/generic.go", "Go", 358, 0, 0, 0, 0, 0, 60, 418
"/opt/projects/swiftkube/vendor/k8s.io/client-go/informers/internalinterfaces/factory_interfaces.go", "Go", 30, 0, 0, 0, 0, 0, 11, 41
"/opt/projects/swiftkube/vendor/k8s.io/client-go/informers/networking/interface.go", "Go", 50, 0, 0, 0, 0, 0, 13, 63
"/opt/projects/swiftkube/vendor/k8s.io/client-go/informers/networking/v1/ingress.go", "Go", 76, 0, 0, 0, 0, 0, 15, 91
"/opt/projects/swiftkube/vendor/k8s.io/client-go/informers/networking/v1/ingressclass.go", "Go", 75, 0, 0, 0, 0, 0, 15, 90
"/opt/projects/swiftkube/vendor/k8s.io/client-go/informers/networking/v1/interface.go", "Go", 47, 0, 0, 0, 0, 0, 13, 60
"/opt/projects/swiftkube/vendor/k8s.io/client-go/informers/networking/v1/networkpolicy.go", "Go", 76, 0, 0, 0, 0, 0, 15, 91
"/opt/projects/swiftkube/vendor/k8s.io/client-go/informers/networking/v1alpha1/clustercidr.go", "Go", 75, 0, 0, 0, 0, 0, 15, 90
"/opt/projects/swiftkube/vendor/k8s.io/client-go/informers/networking/v1alpha1/interface.go", "Go", 41, 0, 0, 0, 0, 0, 12, 53
"/opt/projects/swiftkube/vendor/k8s.io/client-go/informers/networking/v1alpha1/ipaddress.go", "Go", 75, 0, 0, 0, 0, 0, 15, 90
"/opt/projects/swiftkube/vendor/k8s.io/client-go/informers/networking/v1beta1/ingress.go", "Go", 76, 0, 0, 0, 0, 0, 15, 91
"/opt/projects/swiftkube/vendor/k8s.io/client-go/informers/networking/v1beta1/ingressclass.go", "Go", 75, 0, 0, 0, 0, 0, 15, 90
"/opt/projects/swiftkube/vendor/k8s.io/client-go/informers/networking/v1beta1/interface.go", "Go", 41, 0, 0, 0, 0, 0, 12, 53
"/opt/projects/swiftkube/vendor/k8s.io/client-go/informers/node/interface.go", "Go", 50, 0, 0, 0, 0, 0, 13, 63
"/opt/projects/swiftkube/vendor/k8s.io/client-go/informers/node/v1/interface.go", "Go", 35, 0, 0, 0, 0, 0, 11, 46
"/opt/projects/swiftkube/vendor/k8s.io/client-go/informers/node/v1/runtimeclass.go", "Go", 75, 0, 0, 0, 0, 0, 15, 90
"/opt/projects/swiftkube/vendor/k8s.io/client-go/informers/node/v1alpha1/interface.go", "Go", 35, 0, 0, 0, 0, 0, 11, 46
"/opt/projects/swiftkube/vendor/k8s.io/client-go/informers/node/v1alpha1/runtimeclass.go", "Go", 75, 0, 0, 0, 0, 0, 15, 90
"/opt/projects/swiftkube/vendor/k8s.io/client-go/informers/node/v1beta1/interface.go", "Go", 35, 0, 0, 0, 0, 0, 11, 46
"/opt/projects/swiftkube/vendor/k8s.io/client-go/informers/node/v1beta1/runtimeclass.go", "Go", 75, 0, 0, 0, 0, 0, 15, 90
"/opt/projects/swiftkube/vendor/k8s.io/client-go/informers/policy/interface.go", "Go", 43, 0, 0, 0, 0, 0, 12, 55
"/opt/projects/swiftkube/vendor/k8s.io/client-go/informers/policy/v1/interface.go", "Go", 35, 0, 0, 0, 0, 0, 11, 46
"/opt/projects/swiftkube/vendor/k8s.io/client-go/informers/policy/v1/poddisruptionbudget.go", "Go", 76, 0, 0, 0, 0, 0, 15, 91
"/opt/projects/swiftkube/vendor/k8s.io/client-go/informers/policy/v1beta1/interface.go", "Go", 41, 0, 0, 0, 0, 0, 12, 53
"/opt/projects/swiftkube/vendor/k8s.io/client-go/informers/policy/v1beta1/poddisruptionbudget.go", "Go", 76, 0, 0, 0, 0, 0, 15, 91
"/opt/projects/swiftkube/vendor/k8s.io/client-go/informers/policy/v1beta1/podsecuritypolicy.go", "Go", 75, 0, 0, 0, 0, 0, 15, 90
"/opt/projects/swiftkube/vendor/k8s.io/client-go/informers/rbac/interface.go", "Go", 50, 0, 0, 0, 0, 0, 13, 63
"/opt/projects/swiftkube/vendor/k8s.io/client-go/informers/rbac/v1/clusterrole.go", "Go", 75, 0, 0, 0, 0, 0, 15, 90
"/opt/projects/swiftkube/vendor/k8s.io/client-go/informers/rbac/v1/clusterrolebinding.go", "Go", 75, 0, 0, 0, 0, 0, 15, 90
"/opt/projects/swiftkube/vendor/k8s.io/client-go/informers/rbac/v1/interface.go", "Go", 53, 0, 0, 0, 0, 0, 14, 67
"/opt/projects/swiftkube/vendor/k8s.io/client-go/informers/rbac/v1/role.go", "Go", 76, 0, 0, 0, 0, 0, 15, 91
"/opt/projects/swiftkube/vendor/k8s.io/client-go/informers/rbac/v1/rolebinding.go", "Go", 76, 0, 0, 0, 0, 0, 15, 91
"/opt/projects/swiftkube/vendor/k8s.io/client-go/informers/rbac/v1alpha1/clusterrole.go", "Go", 75, 0, 0, 0, 0, 0, 15, 90
"/opt/projects/swiftkube/vendor/k8s.io/client-go/informers/rbac/v1alpha1/clusterrolebinding.go", "Go", 75, 0, 0, 0, 0, 0, 15, 90
"/opt/projects/swiftkube/vendor/k8s.io/client-go/informers/rbac/v1alpha1/interface.go", "Go", 53, 0, 0, 0, 0, 0, 14, 67
"/opt/projects/swiftkube/vendor/k8s.io/client-go/informers/rbac/v1alpha1/role.go", "Go", 76, 0, 0, 0, 0, 0, 15, 91
"/opt/projects/swiftkube/vendor/k8s.io/client-go/informers/rbac/v1alpha1/rolebinding.go", "Go", 76, 0, 0, 0, 0, 0, 15, 91
"/opt/projects/swiftkube/vendor/k8s.io/client-go/informers/rbac/v1beta1/clusterrole.go", "Go", 75, 0, 0, 0, 0, 0, 15, 90
"/opt/projects/swiftkube/vendor/k8s.io/client-go/informers/rbac/v1beta1/clusterrolebinding.go", "Go", 75, 0, 0, 0, 0, 0, 15, 90
"/opt/projects/swiftkube/vendor/k8s.io/client-go/informers/rbac/v1beta1/interface.go", "Go", 53, 0, 0, 0, 0, 0, 14, 67
"/opt/projects/swiftkube/vendor/k8s.io/client-go/informers/rbac/v1beta1/role.go", "Go", 76, 0, 0, 0, 0, 0, 15, 91
"/opt/projects/swiftkube/vendor/k8s.io/client-go/informers/rbac/v1beta1/rolebinding.go", "Go", 76, 0, 0, 0, 0, 0, 15, 91
"/opt/projects/swiftkube/vendor/k8s.io/client-go/informers/resource/interface.go", "Go", 36, 0, 0, 0, 0, 0, 11, 47
"/opt/projects/swiftkube/vendor/k8s.io/client-go/informers/resource/v1alpha2/interface.go", "Go", 53, 0, 0, 0, 0, 0, 14, 67
"/opt/projects/swiftkube/vendor/k8s.io/client-go/informers/resource/v1alpha2/podschedulingcontext.go", "Go", 76, 0, 0, 0, 0, 0, 15, 91
"/opt/projects/swiftkube/vendor/k8s.io/client-go/informers/resource/v1alpha2/resourceclaim.go", "Go", 76, 0, 0, 0, 0, 0, 15, 91
"/opt/projects/swiftkube/vendor/k8s.io/client-go/informers/resource/v1alpha2/resourceclaimtemplate.go", "Go", 76, 0, 0, 0, 0, 0, 15, 91
"/opt/projects/swiftkube/vendor/k8s.io/client-go/informers/resource/v1alpha2/resourceclass.go", "Go", 75, 0, 0, 0, 0, 0, 15, 90
"/opt/projects/swiftkube/vendor/k8s.io/client-go/informers/scheduling/interface.go", "Go", 50, 0, 0, 0, 0, 0, 13, 63
"/opt/projects/swiftkube/vendor/k8s.io/client-go/informers/scheduling/v1/interface.go", "Go", 35, 0, 0, 0, 0, 0, 11, 46
"/opt/projects/swiftkube/vendor/k8s.io/client-go/informers/scheduling/v1/priorityclass.go", "Go", 75, 0, 0, 0, 0, 0, 15, 90
"/opt/projects/swiftkube/vendor/k8s.io/client-go/informers/scheduling/v1alpha1/interface.go", "Go", 35, 0, 0, 0, 0, 0, 11, 46
"/opt/projects/swiftkube/vendor/k8s.io/client-go/informers/scheduling/v1alpha1/priorityclass.go", "Go", 75, 0, 0, 0, 0, 0, 15, 90
"/opt/projects/swiftkube/vendor/k8s.io/client-go/informers/scheduling/v1beta1/interface.go", "Go", 35, 0, 0, 0, 0, 0, 11, 46
"/opt/projects/swiftkube/vendor/k8s.io/client-go/informers/scheduling/v1beta1/priorityclass.go", "Go", 75, 0, 0, 0, 0, 0, 15, 90
"/opt/projects/swiftkube/vendor/k8s.io/client-go/informers/storage/interface.go", "Go", 50, 0, 0, 0, 0, 0, 13, 63
"/opt/projects/swiftkube/vendor/k8s.io/client-go/informers/storage/v1/csidriver.go", "Go", 75, 0, 0, 0, 0, 0, 15, 90
"/opt/projects/swiftkube/vendor/k8s.io/client-go/informers/storage/v1/csinode.go", "Go", 75, 0, 0, 0, 0, 0, 15, 90
"/opt/projects/swiftkube/vendor/k8s.io/client-go/informers/storage/v1/csistoragecapacity.go", "Go", 76, 0, 0, 0, 0, 0, 15, 91
"/opt/projects/swiftkube/vendor/k8s.io/client-go/informers/storage/v1/interface.go", "Go", 59, 0, 0, 0, 0, 0, 15, 74
"/opt/projects/swiftkube/vendor/k8s.io/client-go/informers/storage/v1/storageclass.go", "Go", 75, 0, 0, 0, 0, 0, 15, 90
"/opt/projects/swiftkube/vendor/k8s.io/client-go/informers/storage/v1/volumeattachment.go", "Go", 75, 0, 0, 0, 0, 0, 15, 90
"/opt/projects/swiftkube/vendor/k8s.io/client-go/informers/storage/v1alpha1/csistoragecapacity.go", "Go", 76, 0, 0, 0, 0, 0, 15, 91
"/opt/projects/swiftkube/vendor/k8s.io/client-go/informers/storage/v1alpha1/interface.go", "Go", 41, 0, 0, 0, 0, 0, 12, 53
"/opt/projects/swiftkube/vendor/k8s.io/client-go/informers/storage/v1alpha1/volumeattachment.go", "Go", 75, 0, 0, 0, 0, 0, 15, 90
"/opt/projects/swiftkube/vendor/k8s.io/client-go/informers/storage/v1beta1/csidriver.go", "Go", 75, 0, 0, 0, 0, 0, 15, 90
"/opt/projects/swiftkube/vendor/k8s.io/client-go/informers/storage/v1beta1/csinode.go", "Go", 75, 0, 0, 0, 0, 0, 15, 90
"/opt/projects/swiftkube/vendor/k8s.io/client-go/informers/storage/v1beta1/csistoragecapacity.go", "Go", 76, 0, 0, 0, 0, 0, 15, 91
"/opt/projects/swiftkube/vendor/k8s.io/client-go/informers/storage/v1beta1/interface.go", "Go", 59, 0, 0, 0, 0, 0, 15, 74
"/opt/projects/swiftkube/vendor/k8s.io/client-go/informers/storage/v1beta1/storageclass.go", "Go", 75, 0, 0, 0, 0, 0, 15, 90
"/opt/projects/swiftkube/vendor/k8s.io/client-go/informers/storage/v1beta1/volumeattachment.go", "Go", 75, 0, 0, 0, 0, 0, 15, 90
"/opt/projects/swiftkube/vendor/k8s.io/client-go/kubernetes/clientset.go", "Go", 699, 0, 0, 0, 0, 0, 72, 771
"/opt/projects/swiftkube/vendor/k8s.io/client-go/kubernetes/doc.go", "Go", 15, 0, 0, 0, 0, 0, 5, 20
"/opt/projects/swiftkube/vendor/k8s.io/client-go/kubernetes/fake/clientset_generated.go", "Go", 371, 0, 0, 0, 0, 0, 65, 436
"/opt/projects/swiftkube/vendor/k8s.io/client-go/kubernetes/fake/doc.go", "Go", 15, 0, 0, 0, 0, 0, 6, 21
"/opt/projects/swiftkube/vendor/k8s.io/client-go/kubernetes/fake/register.go", "Go", 146, 0, 0, 0, 0, 0, 11, 157
"/opt/projects/swiftkube/vendor/k8s.io/client-go/kubernetes/import.go", "Go", 14, 0, 0, 0, 0, 0, 6, 20
"/opt/projects/swiftkube/vendor/k8s.io/client-go/kubernetes/scheme/doc.go", "Go", 15, 0, 0, 0, 0, 0, 6, 21
"/opt/projects/swiftkube/vendor/k8s.io/client-go/kubernetes/scheme/register.go", "Go", 147, 0, 0, 0, 0, 0, 10, 157
"/opt/projects/swiftkube/vendor/k8s.io/client-go/kubernetes/typed/admissionregistration/v1/admissionregistration_client.go", "Go", 93, 0, 0, 0, 0, 0, 20, 113
"/opt/projects/swiftkube/vendor/k8s.io/client-go/kubernetes/typed/admissionregistration/v1/doc.go", "Go", 15, 0, 0, 0, 0, 0, 6, 21
"/opt/projects/swiftkube/vendor/k8s.io/client-go/kubernetes/typed/admissionregistration/v1/fake/doc.go", "Go", 15, 0, 0, 0, 0, 0, 6, 21
"/opt/projects/swiftkube/vendor/k8s.io/client-go/kubernetes/typed/admissionregistration/v1/fake/fake_admissionregistration_client.go", "Go", 34, 0, 0, 0, 0, 0, 11, 45
"/opt/projects/swiftkube/vendor/k8s.io/client-go/kubernetes/typed/admissionregistration/v1/fake/fake_mutatingwebhookconfiguration.go", "Go", 124, 0, 0, 0, 0, 0, 22, 146
"/opt/projects/swiftkube/vendor/k8s.io/client-go/kubernetes/typed/admissionregistration/v1/fake/fake_validatingwebhookconfiguration.go", "Go", 124, 0, 0, 0, 0, 0, 22, 146
"/opt/projects/swiftkube/vendor/k8s.io/client-go/kubernetes/typed/admissionregistration/v1/generated_expansion.go", "Go", 16, 0, 0, 0, 0, 0, 8, 24
"/opt/projects/swiftkube/vendor/k8s.io/client-go/kubernetes/typed/admissionregistration/v1/mutatingwebhookconfiguration.go", "Go", 177, 0, 0, 0, 0, 0, 21, 198
"/opt/projects/swiftkube/vendor/k8s.io/client-go/kubernetes/typed/admissionregistration/v1/validatingwebhookconfiguration.go", "Go", 177, 0, 0, 0, 0, 0, 21, 198
"/opt/projects/swiftkube/vendor/k8s.io/client-go/kubernetes/typed/admissionregistration/v1alpha1/admissionregistration_client.go", "Go", 93, 0, 0, 0, 0, 0, 20, 113
"/opt/projects/swiftkube/vendor/k8s.io/client-go/kubernetes/typed/admissionregistration/v1alpha1/doc.go", "Go", 15, 0, 0, 0, 0, 0, 6, 21
"/opt/projects/swiftkube/vendor/k8s.io/client-go/kubernetes/typed/admissionregistration/v1alpha1/fake/doc.go", "Go", 15, 0, 0, 0, 0, 0, 6, 21
"/opt/projects/swiftkube/vendor/k8s.io/client-go/kubernetes/typed/admissionregistration/v1alpha1/fake/fake_admissionregistration_client.go", "Go", 34, 0, 0, 0, 0, 0, 11, 45
"/opt/projects/swiftkube/vendor/k8s.io/client-go/kubernetes/typed/admissionregistration/v1alpha1/fake/fake_validatingadmissionpolicy.go", "Go", 155, 0, 0, 0, 0, 0, 24, 179
"/opt/projects/swiftkube/vendor/k8s.io/client-go/kubernetes/typed/admissionregistration/v1alpha1/fake/fake_validatingadmissionpolicybinding.go", "Go", 124, 0, 0, 0, 0, 0, 22, 146
"/opt/projects/swiftkube/vendor/k8s.io/client-go/kubernetes/typed/admissionregistration/v1alpha1/generated_expansion.go", "Go", 16, 0, 0, 0, 0, 0, 8, 24
"/opt/projects/swiftkube/vendor/k8s.io/client-go/kubernetes/typed/admissionregistration/v1alpha1/validatingadmissionpolicy.go", "Go", 219, 0, 0, 0, 0, 0, 25, 244
"/opt/projects/swiftkube/vendor/k8s.io/client-go/kubernetes/typed/admissionregistration/v1alpha1/validatingadmissionpolicybinding.go", "Go", 177, 0, 0, 0, 0, 0, 21, 198
"/opt/projects/swiftkube/vendor/k8s.io/client-go/kubernetes/typed/admissionregistration/v1beta1/admissionregistration_client.go", "Go", 101, 0, 0, 0, 0, 0, 22, 123
"/opt/projects/swiftkube/vendor/k8s.io/client-go/kubernetes/typed/admissionregistration/v1beta1/doc.go", "Go", 15, 0, 0, 0, 0, 0, 6, 21
"/opt/projects/swiftkube/vendor/k8s.io/client-go/kubernetes/typed/admissionregistration/v1beta1/fake/doc.go", "Go", 15, 0, 0, 0, 0, 0, 6, 21
"/opt/projects/swiftkube/vendor/k8s.io/client-go/kubernetes/typed/admissionregistration/v1beta1/fake/fake_admissionregistration_client.go", "Go", 40, 0, 0, 0, 0, 0, 13, 53
"/opt/projects/swiftkube/vendor/k8s.io/client-go/kubernetes/typed/admissionregistration/v1beta1/fake/fake_mutatingwebhookconfiguration.go", "Go", 124, 0, 0, 0, 0, 0, 22, 146
"/opt/projects/swiftkube/vendor/k8s.io/client-go/kubernetes/typed/admissionregistration/v1beta1/fake/fake_validatingadmissionpolicy.go", "Go", 155, 0, 0, 0, 0, 0, 24, 179
"/opt/projects/swiftkube/vendor/k8s.io/client-go/kubernetes/typed/admissionregistration/v1beta1/fake/fake_validatingadmissionpolicybinding.go", "Go", 124, 0, 0, 0, 0, 0, 22, 146
"/opt/projects/swiftkube/vendor/k8s.io/client-go/kubernetes/typed/admissionregistration/v1beta1/fake/fake_validatingwebhookconfiguration.go", "Go", 124, 0, 0, 0, 0, 0, 22, 146
"/opt/projects/swiftkube/vendor/k8s.io/client-go/kubernetes/typed/admissionregistration/v1beta1/generated_expansion.go", "Go", 18, 0, 0, 0, 0, 0, 10, 28
"/opt/projects/swiftkube/vendor/k8s.io/client-go/kubernetes/typed/admissionregistration/v1beta1/mutatingwebhookconfiguration.go", "Go", 177, 0, 0, 0, 0, 0, 21, 198
"/opt/projects/swiftkube/vendor/k8s.io/client-go/kubernetes/typed/admissionregistration/v1beta1/validatingadmissionpolicy.go", "Go", 219, 0, 0, 0, 0, 0, 25, 244
"/opt/projects/swiftkube/vendor/k8s.io/client-go/kubernetes/typed/admissionregistration/v1beta1/validatingadmissionpolicybinding.go", "Go", 177, 0, 0, 0, 0, 0, 21, 198
"/opt/projects/swiftkube/vendor/k8s.io/client-go/kubernetes/typed/admissionregistration/v1beta1/validatingwebhookconfiguration.go", "Go", 177, 0, 0, 0, 0, 0, 21, 198
"/opt/projects/swiftkube/vendor/k8s.io/client-go/kubernetes/typed/apiserverinternal/v1alpha1/apiserverinternal_client.go", "Go", 89, 0, 0, 0, 0, 0, 19, 108
"/opt/projects/swiftkube/vendor/k8s.io/client-go/kubernetes/typed/apiserverinternal/v1alpha1/doc.go", "Go", 15, 0, 0, 0, 0, 0, 6, 21
"/opt/projects/swiftkube/vendor/k8s.io/client-go/kubernetes/typed/apiserverinternal/v1alpha1/fake/doc.go", "Go", 15, 0, 0, 0, 0, 0, 6, 21
"/opt/projects/swiftkube/vendor/k8s.io/client-go/kubernetes/typed/apiserverinternal/v1alpha1/fake/fake_apiserverinternal_client.go", "Go", 31, 0, 0, 0, 0, 0, 10, 41
"/opt/projects/swiftkube/vendor/k8s.io/client-go/kubernetes/typed/apiserverinternal/v1alpha1/fake/fake_storageversion.go", "Go", 155, 0, 0, 0, 0, 0, 24, 179
"/opt/projects/swiftkube/vendor/k8s.io/client-go/kubernetes/typed/apiserverinternal/v1alpha1/generated_expansion.go", "Go", 15, 0, 0, 0, 0, 0, 7, 22
"/opt/projects/swiftkube/vendor/k8s.io/client-go/kubernetes/typed/apiserverinternal/v1alpha1/storageversion.go", "Go", 219, 0, 0, 0, 0, 0, 25, 244
"/opt/projects/swiftkube/vendor/k8s.io/client-go/kubernetes/typed/apps/v1/apps_client.go", "Go", 105, 0, 0, 0, 0, 0, 23, 128
"/opt/projects/swiftkube/vendor/k8s.io/client-go/kubernetes/typed/apps/v1/controllerrevision.go", "Go", 188, 0, 0, 0, 0, 0, 21, 209
"/opt/projects/swiftkube/vendor/k8s.io/client-go/kubernetes/typed/apps/v1/daemonset.go", "Go", 232, 0, 0, 0, 0, 0, 25, 257
"/opt/projects/swiftkube/vendor/k8s.io/client-go/kubernetes/typed/apps/v1/deployment.go", "Go", 287, 0, 0, 0, 0, 0, 30, 317
"/opt/projects/swiftkube/vendor/k8s.io/client-go/kubernetes/typed/apps/v1/doc.go", "Go", 15, 0, 0, 0, 0, 0, 6, 21
"/opt/projects/swiftkube/vendor/k8s.io/client-go/kubernetes/typed/apps/v1/fake/doc.go", "Go", 15, 0, 0, 0, 0, 0, 6, 21
"/opt/projects/swiftkube/vendor/k8s.io/client-go/kubernetes/typed/apps/v1/fake/fake_apps_client.go", "Go", 43, 0, 0, 0, 0, 0, 14, 57
"/opt/projects/swiftkube/vendor/k8s.io/client-go/kubernetes/typed/apps/v1/fake/fake_controllerrevision.go", "Go", 125, 0, 0, 0, 0, 0, 30, 155
"/opt/projects/swiftkube/vendor/k8s.io/client-go/kubernetes/typed/apps/v1/fake/fake_daemonset.go", "Go", 156, 0, 0, 0, 0, 0, 34, 190
"/opt/projects/swiftkube/vendor/k8s.io/client-go/kubernetes/typed/apps/v1/fake/fake_deployment.go", "Go", 193, 0, 0, 0, 0, 0, 40, 233
"/opt/projects/swiftkube/vendor/k8s.io/client-go/kubernetes/typed/apps/v1/fake/fake_replicaset.go", "Go", 193, 0, 0, 0, 0, 0, 40, 233
"/opt/projects/swiftkube/vendor/k8s.io/client-go/kubernetes/typed/apps/v1/fake/fake_statefulset.go", "Go", 193, 0, 0, 0, 0, 0, 40, 233
"/opt/projects/swiftkube/vendor/k8s.io/client-go/kubernetes/typed/apps/v1/generated_expansion.go", "Go", 19, 0, 0, 0, 0, 0, 11, 30
"/opt/projects/swiftkube/vendor/k8s.io/client-go/kubernetes/typed/apps/v1/replicaset.go", "Go", 287, 0, 0, 0, 0, 0, 30, 317
"/opt/projects/swiftkube/vendor/k8s.io/client-go/kubernetes/typed/apps/v1/statefulset.go", "Go", 287, 0, 0, 0, 0, 0, 30, 317
"/opt/projects/swiftkube/vendor/k8s.io/client-go/kubernetes/typed/apps/v1beta1/apps_client.go", "Go", 97, 0, 0, 0, 0, 0, 21, 118
"/opt/projects/swiftkube/vendor/k8s.io/client-go/kubernetes/typed/apps/v1beta1/controllerrevision.go", "Go", 188, 0, 0, 0, 0, 0, 21, 209
"/opt/projects/swiftkube/vendor/k8s.io/client-go/kubernetes/typed/apps/v1beta1/deployment.go", "Go", 232, 0, 0, 0, 0, 0, 25, 257
"/opt/projects/swiftkube/vendor/k8s.io/client-go/kubernetes/typed/apps/v1beta1/doc.go", "Go", 15, 0, 0, 0, 0, 0, 6, 21
"/opt/projects/swiftkube/vendor/k8s.io/client-go/kubernetes/typed/apps/v1beta1/fake/doc.go", "Go", 15, 0, 0, 0, 0, 0, 6, 21
"/opt/projects/swiftkube/vendor/k8s.io/client-go/kubernetes/typed/apps/v1beta1/fake/fake_apps_client.go", "Go", 37, 0, 0, 0, 0, 0, 12, 49
"/opt/projects/swiftkube/vendor/k8s.io/client-go/kubernetes/typed/apps/v1beta1/fake/fake_controllerrevision.go", "Go", 125, 0, 0, 0, 0, 0, 30, 155
"/opt/projects/swiftkube/vendor/k8s.io/client-go/kubernetes/typed/apps/v1beta1/fake/fake_deployment.go", "Go", 156, 0, 0, 0, 0, 0, 34, 190
"/opt/projects/swiftkube/vendor/k8s.io/client-go/kubernetes/typed/apps/v1beta1/fake/fake_statefulset.go", "Go", 156, 0, 0, 0, 0, 0, 34, 190
"/opt/projects/swiftkube/vendor/k8s.io/client-go/kubernetes/typed/apps/v1beta1/generated_expansion.go", "Go", 17, 0, 0, 0, 0, 0, 9, 26
"/opt/projects/swiftkube/vendor/k8s.io/client-go/kubernetes/typed/apps/v1beta1/statefulset.go", "Go", 232, 0, 0, 0, 0, 0, 25, 257
"/opt/projects/swiftkube/vendor/k8s.io/client-go/kubernetes/typed/apps/v1beta2/apps_client.go", "Go", 105, 0, 0, 0, 0, 0, 23, 128
"/opt/projects/swiftkube/vendor/k8s.io/client-go/kubernetes/typed/apps/v1beta2/controllerrevision.go", "Go", 188, 0, 0, 0, 0, 0, 21, 209
"/opt/projects/swiftkube/vendor/k8s.io/client-go/kubernetes/typed/apps/v1beta2/daemonset.go", "Go", 232, 0, 0, 0, 0, 0, 25, 257
"/opt/projects/swiftkube/vendor/k8s.io/client-go/kubernetes/typed/apps/v1beta2/deployment.go", "Go", 232, 0, 0, 0, 0, 0, 25, 257
"/opt/projects/swiftkube/vendor/k8s.io/client-go/kubernetes/typed/apps/v1beta2/doc.go", "Go", 15, 0, 0, 0, 0, 0, 6, 21
"/opt/projects/swiftkube/vendor/k8s.io/client-go/kubernetes/typed/apps/v1beta2/fake/doc.go", "Go", 15, 0, 0, 0, 0, 0, 6, 21
"/opt/projects/swiftkube/vendor/k8s.io/client-go/kubernetes/typed/apps/v1beta2/fake/fake_apps_client.go", "Go", 43, 0, 0, 0, 0, 0, 14, 57
"/opt/projects/swiftkube/vendor/k8s.io/client-go/kubernetes/typed/apps/v1beta2/fake/fake_controllerrevision.go", "Go", 125, 0, 0, 0, 0, 0, 30, 155
"/opt/projects/swiftkube/vendor/k8s.io/client-go/kubernetes/typed/apps/v1beta2/fake/fake_daemonset.go", "Go", 156, 0, 0, 0, 0, 0, 34, 190
"/opt/projects/swiftkube/vendor/k8s.io/client-go/kubernetes/typed/apps/v1beta2/fake/fake_deployment.go", "Go", 156, 0, 0, 0, 0, 0, 34, 190
"/opt/projects/swiftkube/vendor/k8s.io/client-go/kubernetes/typed/apps/v1beta2/fake/fake_replicaset.go", "Go", 156, 0, 0, 0, 0, 0, 34, 190
"/opt/projects/swiftkube/vendor/k8s.io/client-go/kubernetes/typed/apps/v1beta2/fake/fake_statefulset.go", "Go", 191, 0, 0, 0, 0, 0, 40, 231
"/opt/projects/swiftkube/vendor/k8s.io/client-go/kubernetes/typed/apps/v1beta2/generated_expansion.go", "Go", 19, 0, 0, 0, 0, 0, 11, 30
"/opt/projects/swiftkube/vendor/k8s.io/client-go/kubernetes/typed/apps/v1beta2/replicaset.go", "Go", 232, 0, 0, 0, 0, 0, 25, 257
"/opt/projects/swiftkube/vendor/k8s.io/client-go/kubernetes/typed/apps/v1beta2/statefulset.go", "Go", 285, 0, 0, 0, 0, 0, 30, 315
"/opt/projects/swiftkube/vendor/k8s.io/client-go/kubernetes/typed/authentication/v1/authentication_client.go", "Go", 93, 0, 0, 0, 0, 0, 20, 113
"/opt/projects/swiftkube/vendor/k8s.io/client-go/kubernetes/typed/authentication/v1/doc.go", "Go", 15, 0, 0, 0, 0, 0, 6, 21
"/opt/projects/swiftkube/vendor/k8s.io/client-go/kubernetes/typed/authentication/v1/fake/doc.go", "Go", 15, 0, 0, 0, 0, 0, 6, 21
"/opt/projects/swiftkube/vendor/k8s.io/client-go/kubernetes/typed/authentication/v1/fake/fake_authentication_client.go", "Go", 34, 0, 0, 0, 0, 0, 11, 45
"/opt/projects/swiftkube/vendor/k8s.io/client-go/kubernetes/typed/authentication/v1/fake/fake_selfsubjectreview.go", "Go", 35, 0, 0, 0, 0, 0, 12, 47
"/opt/projects/swiftkube/vendor/k8s.io/client-go/kubernetes/typed/authentication/v1/fake/fake_tokenreview.go", "Go", 35, 0, 0, 0, 0, 0, 12, 47
"/opt/projects/swiftkube/vendor/k8s.io/client-go/kubernetes/typed/authentication/v1/generated_expansion.go", "Go", 16, 0, 0, 0, 0, 0, 8, 24
"/opt/projects/swiftkube/vendor/k8s.io/client-go/kubernetes/typed/authentication/v1/selfsubjectreview.go", "Go", 52, 0, 0, 0, 0, 0, 13, 65
"/opt/projects/swiftkube/vendor/k8s.io/client-go/kubernetes/typed/authentication/v1/tokenreview.go", "Go", 52, 0, 0, 0, 0, 0, 13, 65
"/opt/projects/swiftkube/vendor/k8s.io/client-go/kubernetes/typed/authentication/v1alpha1/authentication_client.go", "Go", 89, 0, 0, 0, 0, 0, 19, 108
"/opt/projects/swiftkube/vendor/k8s.io/client-go/kubernetes/typed/authentication/v1alpha1/doc.go", "Go", 15, 0, 0, 0, 0, 0, 6, 21
"/opt/projects/swiftkube/vendor/k8s.io/client-go/kubernetes/typed/authentication/v1alpha1/fake/doc.go", "Go", 15, 0, 0, 0, 0, 0, 6, 21
"/opt/projects/swiftkube/vendor/k8s.io/client-go/kubernetes/typed/authentication/v1alpha1/fake/fake_authentication_client.go", "Go", 31, 0, 0, 0, 0, 0, 10, 41
"/opt/projects/swiftkube/vendor/k8s.io/client-go/kubernetes/typed/authentication/v1alpha1/fake/fake_selfsubjectreview.go", "Go", 35, 0, 0, 0, 0, 0, 12, 47
"/opt/projects/swiftkube/vendor/k8s.io/client-go/kubernetes/typed/authentication/v1alpha1/generated_expansion.go", "Go", 15, 0, 0, 0, 0, 0, 7, 22
"/opt/projects/swiftkube/vendor/k8s.io/client-go/kubernetes/typed/authentication/v1alpha1/selfsubjectreview.go", "Go", 52, 0, 0, 0, 0, 0, 13, 65
"/opt/projects/swiftkube/vendor/k8s.io/client-go/kubernetes/typed/authentication/v1beta1/authentication_client.go", "Go", 93, 0, 0, 0, 0, 0, 20, 113
"/opt/projects/swiftkube/vendor/k8s.io/client-go/kubernetes/typed/authentication/v1beta1/doc.go", "Go", 15, 0, 0, 0, 0, 0, 6, 21
"/opt/projects/swiftkube/vendor/k8s.io/client-go/kubernetes/typed/authentication/v1beta1/fake/doc.go", "Go", 15, 0, 0, 0, 0, 0, 6, 21
"/opt/projects/swiftkube/vendor/k8s.io/client-go/kubernetes/typed/authentication/v1beta1/fake/fake_authentication_client.go", "Go", 34, 0, 0, 0, 0, 0, 11, 45
"/opt/projects/swiftkube/vendor/k8s.io/client-go/kubernetes/typed/authentication/v1beta1/fake/fake_selfsubjectreview.go", "Go", 35, 0, 0, 0, 0, 0, 12, 47
"/opt/projects/swiftkube/vendor/k8s.io/client-go/kubernetes/typed/authentication/v1beta1/fake/fake_tokenreview.go", "Go", 35, 0, 0, 0, 0, 0, 12, 47
"/opt/projects/swiftkube/vendor/k8s.io/client-go/kubernetes/typed/authentication/v1beta1/generated_expansion.go", "Go", 16, 0, 0, 0, 0, 0, 8, 24
"/opt/projects/swiftkube/vendor/k8s.io/client-go/kubernetes/typed/authentication/v1beta1/selfsubjectreview.go", "Go", 52, 0, 0, 0, 0, 0, 13, 65
"/opt/projects/swiftkube/vendor/k8s.io/client-go/kubernetes/typed/authentication/v1beta1/tokenreview.go", "Go", 52, 0, 0, 0, 0, 0, 13, 65
"/opt/projects/swiftkube/vendor/k8s.io/client-go/kubernetes/typed/authorization/v1/authorization_client.go", "Go", 101, 0, 0, 0, 0, 0, 22, 123
"/opt/projects/swiftkube/vendor/k8s.io/client-go/kubernetes/typed/authorization/v1/doc.go", "Go", 15, 0, 0, 0, 0, 0, 6, 21
"/opt/projects/swiftkube/vendor/k8s.io/client-go/kubernetes/typed/authorization/v1/fake/doc.go", "Go", 15, 0, 0, 0, 0, 0, 6, 21
"/opt/projects/swiftkube/vendor/k8s.io/client-go/kubernetes/typed/authorization/v1/fake/fake_authorization_client.go", "Go", 40, 0, 0, 0, 0, 0, 13, 53
"/opt/projects/swiftkube/vendor/k8s.io/client-go/kubernetes/typed/authorization/v1/fake/fake_localsubjectaccessreview.go", "Go", 36, 0, 0, 0, 0, 0, 13, 49
"/opt/projects/swiftkube/vendor/k8s.io/client-go/kubernetes/typed/authorization/v1/fake/fake_selfsubjectaccessreview.go", "Go", 35, 0, 0, 0, 0, 0, 12, 47
"/opt/projects/swiftkube/vendor/k8s.io/client-go/kubernetes/typed/authorization/v1/fake/fake_selfsubjectrulesreview.go", "Go", 35, 0, 0, 0, 0, 0, 12, 47
"/opt/projects/swiftkube/vendor/k8s.io/client-go/kubernetes/typed/authorization/v1/fake/fake_subjectaccessreview.go", "Go", 35, 0, 0, 0, 0, 0, 12, 47
"/opt/projects/swiftkube/vendor/k8s.io/client-go/kubernetes/typed/authorization/v1/generated_expansion.go", "Go", 18, 0, 0, 0, 0, 0, 10, 28
"/opt/projects/swiftkube/vendor/k8s.io/client-go/kubernetes/typed/authorization/v1/localsubjectaccessreview.go", "Go", 55, 0, 0, 0, 0, 0, 13, 68
"/opt/projects/swiftkube/vendor/k8s.io/client-go/kubernetes/typed/authorization/v1/selfsubjectaccessreview.go", "Go", 52, 0, 0, 0, 0, 0, 13, 65
"/opt/projects/swiftkube/vendor/k8s.io/client-go/kubernetes/typed/authorization/v1/selfsubjectrulesreview.go", "Go", 52, 0, 0, 0, 0, 0, 13, 65
"/opt/projects/swiftkube/vendor/k8s.io/client-go/kubernetes/typed/authorization/v1/subjectaccessreview.go", "Go", 52, 0, 0, 0, 0, 0, 13, 65
"/opt/projects/swiftkube/vendor/k8s.io/client-go/kubernetes/typed/authorization/v1beta1/authorization_client.go", "Go", 101, 0, 0, 0, 0, 0, 22, 123
"/opt/projects/swiftkube/vendor/k8s.io/client-go/kubernetes/typed/authorization/v1beta1/doc.go", "Go", 15, 0, 0, 0, 0, 0, 6, 21
"/opt/projects/swiftkube/vendor/k8s.io/client-go/kubernetes/typed/authorization/v1beta1/fake/doc.go", "Go", 15, 0, 0, 0, 0, 0, 6, 21
"/opt/projects/swiftkube/vendor/k8s.io/client-go/kubernetes/typed/authorization/v1beta1/fake/fake_authorization_client.go", "Go", 40, 0, 0, 0, 0, 0, 13, 53
"/opt/projects/swiftkube/vendor/k8s.io/client-go/kubernetes/typed/authorization/v1beta1/fake/fake_localsubjectaccessreview.go", "Go", 36, 0, 0, 0, 0, 0, 13, 49
"/opt/projects/swiftkube/vendor/k8s.io/client-go/kubernetes/typed/authorization/v1beta1/fake/fake_selfsubjectaccessreview.go", "Go", 35, 0, 0, 0, 0, 0, 12, 47
"/opt/projects/swiftkube/vendor/k8s.io/client-go/kubernetes/typed/authorization/v1beta1/fake/fake_selfsubjectrulesreview.go", "Go", 35, 0, 0, 0, 0, 0, 12, 47
"/opt/projects/swiftkube/vendor/k8s.io/client-go/kubernetes/typed/authorization/v1beta1/fake/fake_subjectaccessreview.go", "Go", 35, 0, 0, 0, 0, 0, 12, 47
"/opt/projects/swiftkube/vendor/k8s.io/client-go/kubernetes/typed/authorization/v1beta1/generated_expansion.go", "Go", 18, 0, 0, 0, 0, 0, 10, 28
"/opt/projects/swiftkube/vendor/k8s.io/client-go/kubernetes/typed/authorization/v1beta1/localsubjectaccessreview.go", "Go", 55, 0, 0, 0, 0, 0, 13, 68
"/opt/projects/swiftkube/vendor/k8s.io/client-go/kubernetes/typed/authorization/v1beta1/selfsubjectaccessreview.go", "Go", 52, 0, 0, 0, 0, 0, 13, 65
"/opt/projects/swiftkube/vendor/k8s.io/client-go/kubernetes/typed/authorization/v1beta1/selfsubjectrulesreview.go", "Go", 52, 0, 0, 0, 0, 0, 13, 65
"/opt/projects/swiftkube/vendor/k8s.io/client-go/kubernetes/typed/authorization/v1beta1/subjectaccessreview.go", "Go", 52, 0, 0, 0, 0, 0, 13, 65
"/opt/projects/swiftkube/vendor/k8s.io/client-go/kubernetes/typed/autoscaling/v1/autoscaling_client.go", "Go", 89, 0, 0, 0, 0, 0, 19, 108
"/opt/projects/swiftkube/vendor/k8s.io/client-go/kubernetes/typed/autoscaling/v1/doc.go", "Go", 15, 0, 0, 0, 0, 0, 6, 21
"/opt/projects/swiftkube/vendor/k8s.io/client-go/kubernetes/typed/autoscaling/v1/fake/doc.go", "Go", 15, 0, 0, 0, 0, 0, 6, 21
"/opt/projects/swiftkube/vendor/k8s.io/client-go/kubernetes/typed/autoscaling/v1/fake/fake_autoscaling_client.go", "Go", 31, 0, 0, 0, 0, 0, 10, 41
"/opt/projects/swiftkube/vendor/k8s.io/client-go/kubernetes/typed/autoscaling/v1/fake/fake_horizontalpodautoscaler.go", "Go", 156, 0, 0, 0, 0, 0, 34, 190
"/opt/projects/swiftkube/vendor/k8s.io/client-go/kubernetes/typed/autoscaling/v1/generated_expansion.go", "Go", 15, 0, 0, 0, 0, 0, 7, 22
"/opt/projects/swiftkube/vendor/k8s.io/client-go/kubernetes/typed/autoscaling/v1/horizontalpodautoscaler.go", "Go", 232, 0, 0, 0, 0, 0, 25, 257
"/opt/projects/swiftkube/vendor/k8s.io/client-go/kubernetes/typed/autoscaling/v2/autoscaling_client.go", "Go", 89, 0, 0, 0, 0, 0, 19, 108
"/opt/projects/swiftkube/vendor/k8s.io/client-go/kubernetes/typed/autoscaling/v2/doc.go", "Go", 15, 0, 0, 0, 0, 0, 6, 21
"/opt/projects/swiftkube/vendor/k8s.io/client-go/kubernetes/typed/autoscaling/v2/fake/doc.go", "Go", 15, 0, 0, 0, 0, 0, 6, 21
"/opt/projects/swiftkube/vendor/k8s.io/client-go/kubernetes/typed/autoscaling/v2/fake/fake_autoscaling_client.go", "Go", 31, 0, 0, 0, 0, 0, 10, 41
"/opt/projects/swiftkube/vendor/k8s.io/client-go/kubernetes/typed/autoscaling/v2/fake/fake_horizontalpodautoscaler.go", "Go", 156, 0, 0, 0, 0, 0, 34, 190
"/opt/projects/swiftkube/vendor/k8s.io/client-go/kubernetes/typed/autoscaling/v2/generated_expansion.go", "Go", 15, 0, 0, 0, 0, 0, 7, 22
"/opt/projects/swiftkube/vendor/k8s.io/client-go/kubernetes/typed/autoscaling/v2/horizontalpodautoscaler.go", "Go", 232, 0, 0, 0, 0, 0, 25, 257
"/opt/projects/swiftkube/vendor/k8s.io/client-go/kubernetes/typed/autoscaling/v2beta1/autoscaling_client.go", "Go", 89, 0, 0, 0, 0, 0, 19, 108
"/opt/projects/swiftkube/vendor/k8s.io/client-go/kubernetes/typed/autoscaling/v2beta1/doc.go", "Go", 15, 0, 0, 0, 0, 0, 6, 21
"/opt/projects/swiftkube/vendor/k8s.io/client-go/kubernetes/typed/autoscaling/v2beta1/fake/doc.go", "Go", 15, 0, 0, 0, 0, 0, 6, 21
"/opt/projects/swiftkube/vendor/k8s.io/client-go/kubernetes/typed/autoscaling/v2beta1/fake/fake_autoscaling_client.go", "Go", 31, 0, 0, 0, 0, 0, 10, 41
"/opt/projects/swiftkube/vendor/k8s.io/client-go/kubernetes/typed/autoscaling/v2beta1/fake/fake_horizontalpodautoscaler.go", "Go", 156, 0, 0, 0, 0, 0, 34, 190
"/opt/projects/swiftkube/vendor/k8s.io/client-go/kubernetes/typed/autoscaling/v2beta1/generated_expansion.go", "Go", 15, 0, 0, 0, 0, 0, 7, 22
"/opt/projects/swiftkube/vendor/k8s.io/client-go/kubernetes/typed/autoscaling/v2beta1/horizontalpodautoscaler.go", "Go", 232, 0, 0, 0, 0, 0, 25, 257
"/opt/projects/swiftkube/vendor/k8s.io/client-go/kubernetes/typed/autoscaling/v2beta2/autoscaling_client.go", "Go", 89, 0, 0, 0, 0, 0, 19, 108
"/opt/projects/swiftkube/vendor/k8s.io/client-go/kubernetes/typed/autoscaling/v2beta2/doc.go", "Go", 15, 0, 0, 0, 0, 0, 6, 21
"/opt/projects/swiftkube/vendor/k8s.io/client-go/kubernetes/typed/autoscaling/v2beta2/fake/doc.go", "Go", 15, 0, 0, 0, 0, 0, 6, 21
"/opt/projects/swiftkube/vendor/k8s.io/client-go/kubernetes/typed/autoscaling/v2beta2/fake/fake_autoscaling_client.go", "Go", 31, 0, 0, 0, 0, 0, 10, 41
"/opt/projects/swiftkube/vendor/k8s.io/client-go/kubernetes/typed/autoscaling/v2beta2/fake/fake_horizontalpodautoscaler.go", "Go", 156, 0, 0, 0, 0, 0, 34, 190
"/opt/projects/swiftkube/vendor/k8s.io/client-go/kubernetes/typed/autoscaling/v2beta2/generated_expansion.go", "Go", 15, 0, 0, 0, 0, 0, 7, 22
"/opt/projects/swiftkube/vendor/k8s.io/client-go/kubernetes/typed/autoscaling/v2beta2/horizontalpodautoscaler.go", "Go", 232, 0, 0, 0, 0, 0, 25, 257
"/opt/projects/swiftkube/vendor/k8s.io/client-go/kubernetes/typed/batch/v1/batch_client.go", "Go", 93, 0, 0, 0, 0, 0, 20, 113
"/opt/projects/swiftkube/vendor/k8s.io/client-go/kubernetes/typed/batch/v1/cronjob.go", "Go", 232, 0, 0, 0, 0, 0, 25, 257
"/opt/projects/swiftkube/vendor/k8s.io/client-go/kubernetes/typed/batch/v1/doc.go", "Go", 15, 0, 0, 0, 0, 0, 6, 21
"/opt/projects/swiftkube/vendor/k8s.io/client-go/kubernetes/typed/batch/v1/fake/doc.go", "Go", 15, 0, 0, 0, 0, 0, 6, 21
"/opt/projects/swiftkube/vendor/k8s.io/client-go/kubernetes/typed/batch/v1/fake/fake_batch_client.go", "Go", 34, 0, 0, 0, 0, 0, 11, 45
"/opt/projects/swiftkube/vendor/k8s.io/client-go/kubernetes/typed/batch/v1/fake/fake_cronjob.go", "Go", 156, 0, 0, 0, 0, 0, 34, 190
"/opt/projects/swiftkube/vendor/k8s.io/client-go/kubernetes/typed/batch/v1/fake/fake_job.go", "Go", 156, 0, 0, 0, 0, 0, 34, 190
"/opt/projects/swiftkube/vendor/k8s.io/client-go/kubernetes/typed/batch/v1/generated_expansion.go", "Go", 16, 0, 0, 0, 0, 0, 8, 24
"/opt/projects/swiftkube/vendor/k8s.io/client-go/kubernetes/typed/batch/v1/job.go", "Go", 232, 0, 0, 0, 0, 0, 25, 257
"/opt/projects/swiftkube/vendor/k8s.io/client-go/kubernetes/typed/batch/v1beta1/batch_client.go", "Go", 89, 0, 0, 0, 0, 0, 19, 108
"/opt/projects/swiftkube/vendor/k8s.io/client-go/kubernetes/typed/batch/v1beta1/cronjob.go", "Go", 232, 0, 0, 0, 0, 0, 25, 257
"/opt/projects/swiftkube/vendor/k8s.io/client-go/kubernetes/typed/batch/v1beta1/doc.go", "Go", 15, 0, 0, 0, 0, 0, 6, 21
"/opt/projects/swiftkube/vendor/k8s.io/client-go/kubernetes/typed/batch/v1beta1/fake/doc.go", "Go", 15, 0, 0, 0, 0, 0, 6, 21
"/opt/projects/swiftkube/vendor/k8s.io/client-go/kubernetes/typed/batch/v1beta1/fake/fake_batch_client.go", "Go", 31, 0, 0, 0, 0, 0, 10, 41
"/opt/projects/swiftkube/vendor/k8s.io/client-go/kubernetes/typed/batch/v1beta1/fake/fake_cronjob.go", "Go", 156, 0, 0, 0, 0, 0, 34, 190
"/opt/projects/swiftkube/vendor/k8s.io/client-go/kubernetes/typed/batch/v1beta1/generated_expansion.go", "Go", 15, 0, 0, 0, 0, 0, 7, 22
"/opt/projects/swiftkube/vendor/k8s.io/client-go/kubernetes/typed/certificates/v1/certificates_client.go", "Go", 89, 0, 0, 0, 0, 0, 19, 108
"/opt/projects/swiftkube/vendor/k8s.io/client-go/kubernetes/typed/certificates/v1/certificatesigningrequest.go", "Go", 233, 0, 0, 0, 0, 0, 27, 260
"/opt/projects/swiftkube/vendor/k8s.io/client-go/kubernetes/typed/certificates/v1/doc.go", "Go", 15, 0, 0, 0, 0, 0, 6, 21
"/opt/projects/swiftkube/vendor/k8s.io/client-go/kubernetes/typed/certificates/v1/fake/doc.go", "Go", 15, 0, 0, 0, 0, 0, 6, 21
"/opt/projects/swiftkube/vendor/k8s.io/client-go/kubernetes/typed/certificates/v1/fake/fake_certificates_client.go", "Go", 31, 0, 0, 0, 0, 0, 10, 41
"/opt/projects/swiftkube/vendor/k8s.io/client-go/kubernetes/typed/certificates/v1/fake/fake_certificatesigningrequest.go", "Go", 164, 0, 0, 0, 0, 0, 25, 189
"/opt/projects/swiftkube/vendor/k8s.io/client-go/kubernetes/typed/certificates/v1/generated_expansion.go", "Go", 15, 0, 0, 0, 0, 0, 7, 22
"/opt/projects/swiftkube/vendor/k8s.io/client-go/kubernetes/typed/certificates/v1alpha1/certificates_client.go", "Go", 89, 0, 0, 0, 0, 0, 19, 108
"/opt/projects/swiftkube/vendor/k8s.io/client-go/kubernetes/typed/certificates/v1alpha1/clustertrustbundle.go", "Go", 177, 0, 0, 0, 0, 0, 21, 198
"/opt/projects/swiftkube/vendor/k8s.io/client-go/kubernetes/typed/certificates/v1alpha1/doc.go", "Go", 15, 0, 0, 0, 0, 0, 6, 21
"/opt/projects/swiftkube/vendor/k8s.io/client-go/kubernetes/typed/certificates/v1alpha1/fake/doc.go", "Go", 15, 0, 0, 0, 0, 0, 6, 21
"/opt/projects/swiftkube/vendor/k8s.io/client-go/kubernetes/typed/certificates/v1alpha1/fake/fake_certificates_client.go", "Go", 31, 0, 0, 0, 0, 0, 10, 41
"/opt/projects/swiftkube/vendor/k8s.io/client-go/kubernetes/typed/certificates/v1alpha1/fake/fake_clustertrustbundle.go", "Go", 124, 0, 0, 0, 0, 0, 22, 146
"/opt/projects/swiftkube/vendor/k8s.io/client-go/kubernetes/typed/certificates/v1alpha1/generated_expansion.go", "Go", 15, 0, 0, 0, 0, 0, 7, 22
"/opt/projects/swiftkube/vendor/k8s.io/client-go/kubernetes/typed/certificates/v1beta1/certificates_client.go", "Go", 89, 0, 0, 0, 0, 0, 19, 108
"/opt/projects/swiftkube/vendor/k8s.io/client-go/kubernetes/typed/certificates/v1beta1/certificatesigningrequest.go", "Go", 219, 0, 0, 0, 0, 0, 25, 244
"/opt/projects/swiftkube/vendor/k8s.io/client-go/kubernetes/typed/certificates/v1beta1/certificatesigningrequest_expansion.go", "Go", 34, 0, 0, 0, 0, 0, 9, 43
"/opt/projects/swiftkube/vendor/k8s.io/client-go/kubernetes/typed/certificates/v1beta1/doc.go", "Go", 15, 0, 0, 0, 0, 0, 6, 21
"/opt/projects/swiftkube/vendor/k8s.io/client-go/kubernetes/typed/certificates/v1beta1/fake/doc.go", "Go", 15, 0, 0, 0, 0, 0, 6, 21
"/opt/projects/swiftkube/vendor/k8s.io/client-go/kubernetes/typed/certificates/v1beta1/fake/fake_certificates_client.go", "Go", 31, 0, 0, 0, 0, 0, 10, 41
"/opt/projects/swiftkube/vendor/k8s.io/client-go/kubernetes/typed/certificates/v1beta1/fake/fake_certificatesigningrequest.go", "Go", 155, 0, 0, 0, 0, 0, 24, 179
"/opt/projects/swiftkube/vendor/k8s.io/client-go/kubernetes/typed/certificates/v1beta1/fake/fake_certificatesigningrequest_expansion.go", "Go", 27, 0, 0, 0, 0, 0, 8, 35
"/opt/projects/swiftkube/vendor/k8s.io/client-go/kubernetes/typed/certificates/v1beta1/generated_expansion.go", "Go", 14, 0, 0, 0, 0, 0, 6, 20
"/opt/projects/swiftkube/vendor/k8s.io/client-go/kubernetes/typed/coordination/v1/coordination_client.go", "Go", 89, 0, 0, 0, 0, 0, 19, 108
"/opt/projects/swiftkube/vendor/k8s.io/client-go/kubernetes/typed/coordination/v1/doc.go", "Go", 15, 0, 0, 0, 0, 0, 6, 21
"/opt/projects/swiftkube/vendor/k8s.io/client-go/kubernetes/typed/coordination/v1/fake/doc.go", "Go", 15, 0, 0, 0, 0, 0, 6, 21
"/opt/projects/swiftkube/vendor/k8s.io/client-go/kubernetes/typed/coordination/v1/fake/fake_coordination_client.go", "Go", 31, 0, 0, 0, 0, 0, 10, 41
"/opt/projects/swiftkube/vendor/k8s.io/client-go/kubernetes/typed/coordination/v1/fake/fake_lease.go", "Go", 125, 0, 0, 0, 0, 0, 30, 155
"/opt/projects/swiftkube/vendor/k8s.io/client-go/kubernetes/typed/coordination/v1/generated_expansion.go", "Go", 15, 0, 0, 0, 0, 0, 7, 22
"/opt/projects/swiftkube/vendor/k8s.io/client-go/kubernetes/typed/coordination/v1/lease.go", "Go", 188, 0, 0, 0, 0, 0, 21, 209
"/opt/projects/swiftkube/vendor/k8s.io/client-go/kubernetes/typed/coordination/v1beta1/coordination_client.go", "Go", 89, 0, 0, 0, 0, 0, 19, 108
"/opt/projects/swiftkube/vendor/k8s.io/client-go/kubernetes/typed/coordination/v1beta1/doc.go", "Go", 15, 0, 0, 0, 0, 0, 6, 21
"/opt/projects/swiftkube/vendor/k8s.io/client-go/kubernetes/typed/coordination/v1beta1/fake/doc.go", "Go", 15, 0, 0, 0, 0, 0, 6, 21
"/opt/projects/swiftkube/vendor/k8s.io/client-go/kubernetes/typed/coordination/v1beta1/fake/fake_coordination_client.go", "Go", 31, 0, 0, 0, 0, 0, 10, 41
"/opt/projects/swiftkube/vendor/k8s.io/client-go/kubernetes/typed/coordination/v1beta1/fake/fake_lease.go", "Go", 125, 0, 0, 0, 0, 0, 30, 155
"/opt/projects/swiftkube/vendor/k8s.io/client-go/kubernetes/typed/coordination/v1beta1/generated_expansion.go", "Go", 15, 0, 0, 0, 0, 0, 7, 22
"/opt/projects/swiftkube/vendor/k8s.io/client-go/kubernetes/typed/coordination/v1beta1/lease.go", "Go", 188, 0, 0, 0, 0, 0, 21, 209
"/opt/projects/swiftkube/vendor/k8s.io/client-go/kubernetes/typed/core/v1/componentstatus.go", "Go", 177, 0, 0, 0, 0, 0, 21, 198
"/opt/projects/swiftkube/vendor/k8s.io/client-go/kubernetes/typed/core/v1/configmap.go", "Go", 188, 0, 0, 0, 0, 0, 21, 209
"/opt/projects/swiftkube/vendor/k8s.io/client-go/kubernetes/typed/core/v1/core_client.go", "Go", 149, 0, 0, 0, 0, 0, 34, 183
"/opt/projects/swiftkube/vendor/k8s.io/client-go/kubernetes/typed/core/v1/doc.go", "Go", 15, 0, 0, 0, 0, 0, 6, 21
"/opt/projects/swiftkube/vendor/k8s.io/client-go/kubernetes/typed/core/v1/endpoints.go", "Go", 188, 0, 0, 0, 0, 0, 21, 209
"/opt/projects/swiftkube/vendor/k8s.io/client-go/kubernetes/typed/core/v1/event.go", "Go", 188, 0, 0, 0, 0, 0, 21, 209
"/opt/projects/swiftkube/vendor/k8s.io/client-go/kubernetes/typed/core/v1/event_expansion.go", "Go", 152, 0, 0, 0, 0, 0, 18, 170
"/opt/projects/swiftkube/vendor/k8s.io/client-go/kubernetes/typed/core/v1/fake/doc.go", "Go", 15, 0, 0, 0, 0, 0, 6, 21
"/opt/projects/swiftkube/vendor/k8s.io/client-go/kubernetes/typed/core/v1/fake/fake_componentstatus.go", "Go", 124, 0, 0, 0, 0, 0, 22, 146
"/opt/projects/swiftkube/vendor/k8s.io/client-go/kubernetes/typed/core/v1/fake/fake_configmap.go", "Go", 125, 0, 0, 0, 0, 0, 30, 155
"/opt/projects/swiftkube/vendor/k8s.io/client-go/kubernetes/typed/core/v1/fake/fake_core_client.go", "Go", 76, 0, 0, 0, 0, 0, 25, 101
"/opt/projects/swiftkube/vendor/k8s.io/client-go/kubernetes/typed/core/v1/fake/fake_endpoints.go", "Go", 125, 0, 0, 0, 0, 0, 30, 155
"/opt/projects/swiftkube/vendor/k8s.io/client-go/kubernetes/typed/core/v1/fake/fake_event.go", "Go", 125, 0, 0, 0, 0, 0, 30, 155
"/opt/projects/swiftkube/vendor/k8s.io/client-go/kubernetes/typed/core/v1/fake/fake_event_expansion.go", "Go", 86, 0, 0, 0, 0, 0, 16, 102
"/opt/projects/swiftkube/vendor/k8s.io/client-go/kubernetes/typed/core/v1/fake/fake_limitrange.go", "Go", 125, 0, 0, 0, 0, 0, 30, 155
"/opt/projects/swiftkube/vendor/k8s.io/client-go/kubernetes/typed/core/v1/fake/fake_namespace.go", "Go", 149, 0, 0, 0, 0, 0, 22, 171
"/opt/projects/swiftkube/vendor/k8s.io/client-go/kubernetes/typed/core/v1/fake/fake_namespace_expansion.go", "Go", 31, 0, 0, 0, 0, 0, 10, 41
"/opt/projects/swiftkube/vendor/k8s.io/client-go/kubernetes/typed/core/v1/fake/fake_node.go", "Go", 155, 0, 0, 0, 0, 0, 24, 179
"/opt/projects/swiftkube/vendor/k8s.io/client-go/kubernetes/typed/core/v1/fake/fake_node_expansion.go", "Go", 30, 0, 0, 0, 0, 0, 9, 39
"/opt/projects/swiftkube/vendor/k8s.io/client-go/kubernetes/typed/core/v1/fake/fake_persistentvolume.go", "Go", 155, 0, 0, 0, 0, 0, 24, 179
"/opt/projects/swiftkube/vendor/k8s.io/client-go/kubernetes/typed/core/v1/fake/fake_persistentvolumeclaim.go", "Go", 156, 0, 0, 0, 0, 0, 34, 190
"/opt/projects/swiftkube/vendor/k8s.io/client-go/kubernetes/typed/core/v1/fake/fake_pod.go", "Go", 165, 0, 0, 0, 0, 0, 36, 201
"/opt/projects/swiftkube/vendor/k8s.io/client-go/kubernetes/typed/core/v1/fake/fake_pod_expansion.go", "Go", 94, 0, 0, 0, 0, 0, 19, 113
"/opt/projects/swiftkube/vendor/k8s.io/client-go/kubernetes/typed/core/v1/fake/fake_podtemplate.go", "Go", 125, 0, 0, 0, 0, 0, 30, 155
"/opt/projects/swiftkube/vendor/k8s.io/client-go/kubernetes/typed/core/v1/fake/fake_replicationcontroller.go", "Go", 175, 0, 0, 0, 0, 0, 38, 213
"/opt/projects/swiftkube/vendor/k8s.io/client-go/kubernetes/typed/core/v1/fake/fake_resourcequota.go", "Go", 156, 0, 0, 0, 0, 0, 34, 190
"/opt/projects/swiftkube/vendor/k8s.io/client-go/kubernetes/typed/core/v1/fake/fake_secret.go", "Go", 125, 0, 0, 0, 0, 0, 30, 155
"/opt/projects/swiftkube/vendor/k8s.io/client-go/kubernetes/typed/core/v1/fake/fake_service.go", "Go", 150, 0, 0, 0, 0, 0, 32, 182
"/opt/projects/swiftkube/vendor/k8s.io/client-go/kubernetes/typed/core/v1/fake/fake_service_expansion.go", "Go", 20, 0, 0, 0, 0, 0, 7, 27
"/opt/projects/swiftkube/vendor/k8s.io/client-go/kubernetes/typed/core/v1/fake/fake_serviceaccount.go", "Go", 135, 0, 0, 0, 0, 0, 32, 167
"/opt/projects/swiftkube/vendor/k8s.io/client-go/kubernetes/typed/core/v1/generated_expansion.go", "Go", 25, 0, 0, 0, 0, 0, 17, 42
"/opt/projects/swiftkube/vendor/k8s.io/client-go/kubernetes/typed/core/v1/limitrange.go", "Go", 188, 0, 0, 0, 0, 0, 21, 209
"/opt/projects/swiftkube/vendor/k8s.io/client-go/kubernetes/typed/core/v1/namespace.go", "Go", 204, 0, 0, 0, 0, 0, 24, 228
"/opt/projects/swiftkube/vendor/k8s.io/client-go/kubernetes/typed/core/v1/namespace_expansion.go", "Go", 29, 0, 0, 0, 0, 0, 9, 38
"/opt/projects/swiftkube/vendor/k8s.io/client-go/kubernetes/typed/core/v1/node.go", "Go", 219, 0, 0, 0, 0, 0, 25, 244
"/opt/projects/swiftkube/vendor/k8s.io/client-go/kubernetes/typed/core/v1/node_expansion.go", "Go", 37, 0, 0, 0, 0, 0, 9, 46
"/opt/projects/swiftkube/vendor/k8s.io/client-go/kubernetes/typed/core/v1/persistentvolume.go", "Go", 219, 0, 0, 0, 0, 0, 25, 244
"/opt/projects/swiftkube/vendor/k8s.io/client-go/kubernetes/typed/core/v1/persistentvolumeclaim.go", "Go", 232, 0, 0, 0, 0, 0, 25, 257
"/opt/projects/swiftkube/vendor/k8s.io/client-go/kubernetes/typed/core/v1/pod.go", "Go", 247, 0, 0, 0, 0, 0, 27, 274
"/opt/projects/swiftkube/vendor/k8s.io/client-go/kubernetes/typed/core/v1/pod_expansion.go", "Go", 72, 0, 0, 0, 0, 0, 14, 86
"/opt/projects/swiftkube/vendor/k8s.io/client-go/kubernetes/typed/core/v1/podtemplate.go", "Go", 188, 0, 0, 0, 0, 0, 21, 209
"/opt/projects/swiftkube/vendor/k8s.io/client-go/kubernetes/typed/core/v1/replicationcontroller.go", "Go", 262, 0, 0, 0, 0, 0, 28, 290
"/opt/projects/swiftkube/vendor/k8s.io/client-go/kubernetes/typed/core/v1/resourcequota.go", "Go", 232, 0, 0, 0, 0, 0, 25, 257
"/opt/projects/swiftkube/vendor/k8s.io/client-go/kubernetes/typed/core/v1/secret.go", "Go", 188, 0, 0, 0, 0, 0, 21, 209
"/opt/projects/swiftkube/vendor/k8s.io/client-go/kubernetes/typed/core/v1/service.go", "Go", 216, 0, 0, 0, 0, 0, 24, 240
"/opt/projects/swiftkube/vendor/k8s.io/client-go/kubernetes/typed/core/v1/service_expansion.go", "Go", 34, 0, 0, 0, 0, 0, 8, 42
"/opt/projects/swiftkube/vendor/k8s.io/client-go/kubernetes/typed/core/v1/serviceaccount.go", "Go", 204, 0, 0, 0, 0, 0, 23, 227
"/opt/projects/swiftkube/vendor/k8s.io/client-go/kubernetes/typed/discovery/v1/discovery_client.go", "Go", 89, 0, 0, 0, 0, 0, 19, 108
"/opt/projects/swiftkube/vendor/k8s.io/client-go/kubernetes/typed/discovery/v1/doc.go", "Go", 15, 0, 0, 0, 0, 0, 6, 21
"/opt/projects/swiftkube/vendor/k8s.io/client-go/kubernetes/typed/discovery/v1/endpointslice.go", "Go", 188, 0, 0, 0, 0, 0, 21, 209
"/opt/projects/swiftkube/vendor/k8s.io/client-go/kubernetes/typed/discovery/v1/fake/doc.go", "Go", 15, 0, 0, 0, 0, 0, 6, 21
"/opt/projects/swiftkube/vendor/k8s.io/client-go/kubernetes/typed/discovery/v1/fake/fake_discovery_client.go", "Go", 31, 0, 0, 0, 0, 0, 10, 41
"/opt/projects/swiftkube/vendor/k8s.io/client-go/kubernetes/typed/discovery/v1/fake/fake_endpointslice.go", "Go", 125, 0, 0, 0, 0, 0, 30, 155
"/opt/projects/swiftkube/vendor/k8s.io/client-go/kubernetes/typed/discovery/v1/generated_expansion.go", "Go", 15, 0, 0, 0, 0, 0, 7, 22
"/opt/projects/swiftkube/vendor/k8s.io/client-go/kubernetes/typed/discovery/v1beta1/discovery_client.go", "Go", 89, 0, 0, 0, 0, 0, 19, 108
"/opt/projects/swiftkube/vendor/k8s.io/client-go/kubernetes/typed/discovery/v1beta1/doc.go", "Go", 15, 0, 0, 0, 0, 0, 6, 21
"/opt/projects/swiftkube/vendor/k8s.io/client-go/kubernetes/typed/discovery/v1beta1/endpointslice.go", "Go", 188, 0, 0, 0, 0, 0, 21, 209
"/opt/projects/swiftkube/vendor/k8s.io/client-go/kubernetes/typed/discovery/v1beta1/fake/doc.go", "Go", 15, 0, 0, 0, 0, 0, 6, 21
"/opt/projects/swiftkube/vendor/k8s.io/client-go/kubernetes/typed/discovery/v1beta1/fake/fake_discovery_client.go", "Go", 31, 0, 0, 0, 0, 0, 10, 41
"/opt/projects/swiftkube/vendor/k8s.io/client-go/kubernetes/typed/discovery/v1beta1/fake/fake_endpointslice.go", "Go", 125, 0, 0, 0, 0, 0, 30, 155
"/opt/projects/swiftkube/vendor/k8s.io/client-go/kubernetes/typed/discovery/v1beta1/generated_expansion.go", "Go", 15, 0, 0, 0, 0, 0, 7, 22
"/opt/projects/swiftkube/vendor/k8s.io/client-go/kubernetes/typed/events/v1/doc.go", "Go", 15, 0, 0, 0, 0, 0, 6, 21
"/opt/projects/swiftkube/vendor/k8s.io/client-go/kubernetes/typed/events/v1/event.go", "Go", 188, 0, 0, 0, 0, 0, 21, 209
"/opt/projects/swiftkube/vendor/k8s.io/client-go/kubernetes/typed/events/v1/events_client.go", "Go", 89, 0, 0, 0, 0, 0, 19, 108
"/opt/projects/swiftkube/vendor/k8s.io/client-go/kubernetes/typed/events/v1/fake/doc.go", "Go", 15, 0, 0, 0, 0, 0, 6, 21
"/opt/projects/swiftkube/vendor/k8s.io/client-go/kubernetes/typed/events/v1/fake/fake_event.go", "Go", 125, 0, 0, 0, 0, 0, 30, 155
"/opt/projects/swiftkube/vendor/k8s.io/client-go/kubernetes/typed/events/v1/fake/fake_events_client.go", "Go", 31, 0, 0, 0, 0, 0, 10, 41
"/opt/projects/swiftkube/vendor/k8s.io/client-go/kubernetes/typed/events/v1/generated_expansion.go", "Go", 15, 0, 0, 0, 0, 0, 7, 22
"/opt/projects/swiftkube/vendor/k8s.io/client-go/kubernetes/typed/events/v1beta1/doc.go", "Go", 15, 0, 0, 0, 0, 0, 6, 21
"/opt/projects/swiftkube/vendor/k8s.io/client-go/kubernetes/typed/events/v1beta1/event.go", "Go", 188, 0, 0, 0, 0, 0, 21, 209
"/opt/projects/swiftkube/vendor/k8s.io/client-go/kubernetes/typed/events/v1beta1/event_expansion.go", "Go", 89, 0, 0, 0, 0, 0, 11, 100
"/opt/projects/swiftkube/vendor/k8s.io/client-go/kubernetes/typed/events/v1beta1/events_client.go", "Go", 89, 0, 0, 0, 0, 0, 19, 108
"/opt/projects/swiftkube/vendor/k8s.io/client-go/kubernetes/typed/events/v1beta1/fake/doc.go", "Go", 15, 0, 0, 0, 0, 0, 6, 21
"/opt/projects/swiftkube/vendor/k8s.io/client-go/kubernetes/typed/events/v1beta1/fake/fake_event.go", "Go", 125, 0, 0, 0, 0, 0, 30, 155
"/opt/projects/swiftkube/vendor/k8s.io/client-go/kubernetes/typed/events/v1beta1/fake/fake_event_expansion.go", "Go", 55, 0, 0, 0, 0, 0, 12, 67
"/opt/projects/swiftkube/vendor/k8s.io/client-go/kubernetes/typed/events/v1beta1/fake/fake_events_client.go", "Go", 31, 0, 0, 0, 0, 0, 10, 41
"/opt/projects/swiftkube/vendor/k8s.io/client-go/kubernetes/typed/events/v1beta1/generated_expansion.go", "Go", 14, 0, 0, 0, 0, 0, 6, 20
"/opt/projects/swiftkube/vendor/k8s.io/client-go/kubernetes/typed/extensions/v1beta1/daemonset.go", "Go", 232, 0, 0, 0, 0, 0, 25, 257
"/opt/projects/swiftkube/vendor/k8s.io/client-go/kubernetes/typed/extensions/v1beta1/deployment.go", "Go", 285, 0, 0, 0, 0, 0, 30, 315
"/opt/projects/swiftkube/vendor/k8s.io/client-go/kubernetes/typed/extensions/v1beta1/deployment_expansion.go", "Go", 27, 0, 0, 0, 0, 0, 9, 36
"/opt/projects/swiftkube/vendor/k8s.io/client-go/kubernetes/typed/extensions/v1beta1/doc.go", "Go", 15, 0, 0, 0, 0, 0, 6, 21
"/opt/projects/swiftkube/vendor/k8s.io/client-go/kubernetes/typed/extensions/v1beta1/extensions_client.go", "Go", 105, 0, 0, 0, 0, 0, 23, 128
"/opt/projects/swiftkube/vendor/k8s.io/client-go/kubernetes/typed/extensions/v1beta1/fake/doc.go", "Go", 15, 0, 0, 0, 0, 0, 6, 21
"/opt/projects/swiftkube/vendor/k8s.io/client-go/kubernetes/typed/extensions/v1beta1/fake/fake_daemonset.go", "Go", 156, 0, 0, 0, 0, 0, 34, 190
"/opt/projects/swiftkube/vendor/k8s.io/client-go/kubernetes/typed/extensions/v1beta1/fake/fake_deployment.go", "Go", 191, 0, 0, 0, 0, 0, 40, 231
"/opt/projects/swiftkube/vendor/k8s.io/client-go/kubernetes/typed/extensions/v1beta1/fake/fake_deployment_expansion.go", "Go", 28, 0, 0, 0, 0, 0, 9, 37
"/opt/projects/swiftkube/vendor/k8s.io/client-go/kubernetes/typed/extensions/v1beta1/fake/fake_extensions_client.go", "Go", 43, 0, 0, 0, 0, 0, 14, 57
"/opt/projects/swiftkube/vendor/k8s.io/client-go/kubernetes/typed/extensions/v1beta1/fake/fake_ingress.go", "Go", 156, 0, 0, 0, 0, 0, 34, 190
"/opt/projects/swiftkube/vendor/k8s.io/client-go/kubernetes/typed/extensions/v1beta1/fake/fake_networkpolicy.go", "Go", 125, 0, 0, 0, 0, 0, 30, 155
"/opt/projects/swiftkube/vendor/k8s.io/client-go/kubernetes/typed/extensions/v1beta1/fake/fake_replicaset.go", "Go", 191, 0, 0, 0, 0, 0, 40, 231
"/opt/projects/swiftkube/vendor/k8s.io/client-go/kubernetes/typed/extensions/v1beta1/generated_expansion.go", "Go", 18, 0, 0, 0, 0, 0, 10, 28
"/opt/projects/swiftkube/vendor/k8s.io/client-go/kubernetes/typed/extensions/v1beta1/ingress.go", "Go", 232, 0, 0, 0, 0, 0, 25, 257
"/opt/projects/swiftkube/vendor/k8s.io/client-go/kubernetes/typed/extensions/v1beta1/networkpolicy.go", "Go", 188, 0, 0, 0, 0, 0, 21, 209
"/opt/projects/swiftkube/vendor/k8s.io/client-go/kubernetes/typed/extensions/v1beta1/replicaset.go", "Go", 285, 0, 0, 0, 0, 0, 30, 315
"/opt/projects/swiftkube/vendor/k8s.io/client-go/kubernetes/typed/flowcontrol/v1alpha1/doc.go", "Go", 15, 0, 0, 0, 0, 0, 6, 21
"/opt/projects/swiftkube/vendor/k8s.io/client-go/kubernetes/typed/flowcontrol/v1alpha1/fake/doc.go", "Go", 15, 0, 0, 0, 0, 0, 6, 21
"/opt/projects/swiftkube/vendor/k8s.io/client-go/kubernetes/typed/flowcontrol/v1alpha1/fake/fake_flowcontrol_client.go", "Go", 34, 0, 0, 0, 0, 0, 11, 45
"/opt/projects/swiftkube/vendor/k8s.io/client-go/kubernetes/typed/flowcontrol/v1alpha1/fake/fake_flowschema.go", "Go", 155, 0, 0, 0, 0, 0, 24, 179
"/opt/projects/swiftkube/vendor/k8s.io/client-go/kubernetes/typed/flowcontrol/v1alpha1/fake/fake_prioritylevelconfiguration.go", "Go", 155, 0, 0, 0, 0, 0, 24, 179
"/opt/projects/swiftkube/vendor/k8s.io/client-go/kubernetes/typed/flowcontrol/v1alpha1/flowcontrol_client.go", "Go", 93, 0, 0, 0, 0, 0, 20, 113
"/opt/projects/swiftkube/vendor/k8s.io/client-go/kubernetes/typed/flowcontrol/v1alpha1/flowschema.go", "Go", 219, 0, 0, 0, 0, 0, 25, 244
"/opt/projects/swiftkube/vendor/k8s.io/client-go/kubernetes/typed/flowcontrol/v1alpha1/generated_expansion.go", "Go", 16, 0, 0, 0, 0, 0, 8, 24
"/opt/projects/swiftkube/vendor/k8s.io/client-go/kubernetes/typed/flowcontrol/v1alpha1/prioritylevelconfiguration.go", "Go", 219, 0, 0, 0, 0, 0, 25, 244
"/opt/projects/swiftkube/vendor/k8s.io/client-go/kubernetes/typed/flowcontrol/v1beta1/doc.go", "Go", 15, 0, 0, 0, 0, 0, 6, 21
"/opt/projects/swiftkube/vendor/k8s.io/client-go/kubernetes/typed/flowcontrol/v1beta1/fake/doc.go", "Go", 15, 0, 0, 0, 0, 0, 6, 21
"/opt/projects/swiftkube/vendor/k8s.io/client-go/kubernetes/typed/flowcontrol/v1beta1/fake/fake_flowcontrol_client.go", "Go", 34, 0, 0, 0, 0, 0, 11, 45
"/opt/projects/swiftkube/vendor/k8s.io/client-go/kubernetes/typed/flowcontrol/v1beta1/fake/fake_flowschema.go", "Go", 155, 0, 0, 0, 0, 0, 24, 179
"/opt/projects/swiftkube/vendor/k8s.io/client-go/kubernetes/typed/flowcontrol/v1beta1/fake/fake_prioritylevelconfiguration.go", "Go", 155, 0, 0, 0, 0, 0, 24, 179
"/opt/projects/swiftkube/vendor/k8s.io/client-go/kubernetes/typed/flowcontrol/v1beta1/flowcontrol_client.go", "Go", 93, 0, 0, 0, 0, 0, 20, 113
"/opt/projects/swiftkube/vendor/k8s.io/client-go/kubernetes/typed/flowcontrol/v1beta1/flowschema.go", "Go", 219, 0, 0, 0, 0, 0, 25, 244
"/opt/projects/swiftkube/vendor/k8s.io/client-go/kubernetes/typed/flowcontrol/v1beta1/generated_expansion.go", "Go", 16, 0, 0, 0, 0, 0, 8, 24
"/opt/projects/swiftkube/vendor/k8s.io/client-go/kubernetes/typed/flowcontrol/v1beta1/prioritylevelconfiguration.go", "Go", 219, 0, 0, 0, 0, 0, 25, 244
"/opt/projects/swiftkube/vendor/k8s.io/client-go/kubernetes/typed/flowcontrol/v1beta2/doc.go", "Go", 15, 0, 0, 0, 0, 0, 6, 21
"/opt/projects/swiftkube/vendor/k8s.io/client-go/kubernetes/typed/flowcontrol/v1beta2/fake/doc.go", "Go", 15, 0, 0, 0, 0, 0, 6, 21
"/opt/projects/swiftkube/vendor/k8s.io/client-go/kubernetes/typed/flowcontrol/v1beta2/fake/fake_flowcontrol_client.go", "Go", 34, 0, 0, 0, 0, 0, 11, 45
"/opt/projects/swiftkube/vendor/k8s.io/client-go/kubernetes/typed/flowcontrol/v1beta2/fake/fake_flowschema.go", "Go", 155, 0, 0, 0, 0, 0, 24, 179
"/opt/projects/swiftkube/vendor/k8s.io/client-go/kubernetes/typed/flowcontrol/v1beta2/fake/fake_prioritylevelconfiguration.go", "Go", 155, 0, 0, 0, 0, 0, 24, 179
"/opt/projects/swiftkube/vendor/k8s.io/client-go/kubernetes/typed/flowcontrol/v1beta2/flowcontrol_client.go", "Go", 93, 0, 0, 0, 0, 0, 20, 113
"/opt/projects/swiftkube/vendor/k8s.io/client-go/kubernetes/typed/flowcontrol/v1beta2/flowschema.go", "Go", 219, 0, 0, 0, 0, 0, 25, 244
"/opt/projects/swiftkube/vendor/k8s.io/client-go/kubernetes/typed/flowcontrol/v1beta2/generated_expansion.go", "Go", 16, 0, 0, 0, 0, 0, 8, 24
"/opt/projects/swiftkube/vendor/k8s.io/client-go/kubernetes/typed/flowcontrol/v1beta2/prioritylevelconfiguration.go", "Go", 219, 0, 0, 0, 0, 0, 25, 244
"/opt/projects/swiftkube/vendor/k8s.io/client-go/kubernetes/typed/flowcontrol/v1beta3/doc.go", "Go", 15, 0, 0, 0, 0, 0, 6, 21
"/opt/projects/swiftkube/vendor/k8s.io/client-go/kubernetes/typed/flowcontrol/v1beta3/fake/doc.go", "Go", 15, 0, 0, 0, 0, 0, 6, 21
"/opt/projects/swiftkube/vendor/k8s.io/client-go/kubernetes/typed/flowcontrol/v1beta3/fake/fake_flowcontrol_client.go", "Go", 34, 0, 0, 0, 0, 0, 11, 45
"/opt/projects/swiftkube/vendor/k8s.io/client-go/kubernetes/typed/flowcontrol/v1beta3/fake/fake_flowschema.go", "Go", 155, 0, 0, 0, 0, 0, 24, 179
"/opt/projects/swiftkube/vendor/k8s.io/client-go/kubernetes/typed/flowcontrol/v1beta3/fake/fake_prioritylevelconfiguration.go", "Go", 155, 0, 0, 0, 0, 0, 24, 179
"/opt/projects/swiftkube/vendor/k8s.io/client-go/kubernetes/typed/flowcontrol/v1beta3/flowcontrol_client.go", "Go", 93, 0, 0, 0, 0, 0, 20, 113
"/opt/projects/swiftkube/vendor/k8s.io/client-go/kubernetes/typed/flowcontrol/v1beta3/flowschema.go", "Go", 219, 0, 0, 0, 0, 0, 25, 244
"/opt/projects/swiftkube/vendor/k8s.io/client-go/kubernetes/typed/flowcontrol/v1beta3/generated_expansion.go", "Go", 16, 0, 0, 0, 0, 0, 8, 24
"/opt/projects/swiftkube/vendor/k8s.io/client-go/kubernetes/typed/flowcontrol/v1beta3/prioritylevelconfiguration.go", "Go", 219, 0, 0, 0, 0, 0, 25, 244
"/opt/projects/swiftkube/vendor/k8s.io/client-go/kubernetes/typed/networking/v1/doc.go", "Go", 15, 0, 0, 0, 0, 0, 6, 21
"/opt/projects/swiftkube/vendor/k8s.io/client-go/kubernetes/typed/networking/v1/fake/doc.go", "Go", 15, 0, 0, 0, 0, 0, 6, 21
"/opt/projects/swiftkube/vendor/k8s.io/client-go/kubernetes/typed/networking/v1/fake/fake_ingress.go", "Go", 156, 0, 0, 0, 0, 0, 34, 190
"/opt/projects/swiftkube/vendor/k8s.io/client-go/kubernetes/typed/networking/v1/fake/fake_ingressclass.go", "Go", 124, 0, 0, 0, 0, 0, 22, 146
"/opt/projects/swiftkube/vendor/k8s.io/client-go/kubernetes/typed/networking/v1/fake/fake_networking_client.go", "Go", 37, 0, 0, 0, 0, 0, 12, 49
"/opt/projects/swiftkube/vendor/k8s.io/client-go/kubernetes/typed/networking/v1/fake/fake_networkpolicy.go", "Go", 125, 0, 0, 0, 0, 0, 30, 155
"/opt/projects/swiftkube/vendor/k8s.io/client-go/kubernetes/typed/networking/v1/generated_expansion.go", "Go", 17, 0, 0, 0, 0, 0, 9, 26
"/opt/projects/swiftkube/vendor/k8s.io/client-go/kubernetes/typed/networking/v1/ingress.go", "Go", 232, 0, 0, 0, 0, 0, 25, 257
"/opt/projects/swiftkube/vendor/k8s.io/client-go/kubernetes/typed/networking/v1/ingressclass.go", "Go", 177, 0, 0, 0, 0, 0, 21, 198
"/opt/projects/swiftkube/vendor/k8s.io/client-go/kubernetes/typed/networking/v1/networking_client.go", "Go", 97, 0, 0, 0, 0, 0, 21, 118
"/opt/projects/swiftkube/vendor/k8s.io/client-go/kubernetes/typed/networking/v1/networkpolicy.go", "Go", 188, 0, 0, 0, 0, 0, 21, 209
"/opt/projects/swiftkube/vendor/k8s.io/client-go/kubernetes/typed/networking/v1alpha1/clustercidr.go", "Go", 177, 0, 0, 0, 0, 0, 21, 198
"/opt/projects/swiftkube/vendor/k8s.io/client-go/kubernetes/typed/networking/v1alpha1/doc.go", "Go", 15, 0, 0, 0, 0, 0, 6, 21
"/opt/projects/swiftkube/vendor/k8s.io/client-go/kubernetes/typed/networking/v1alpha1/fake/doc.go", "Go", 15, 0, 0, 0, 0, 0, 6, 21
"/opt/projects/swiftkube/vendor/k8s.io/client-go/kubernetes/typed/networking/v1alpha1/fake/fake_clustercidr.go", "Go", 124, 0, 0, 0, 0, 0, 22, 146
"/opt/projects/swiftkube/vendor/k8s.io/client-go/kubernetes/typed/networking/v1alpha1/fake/fake_ipaddress.go", "Go", 124, 0, 0, 0, 0, 0, 22, 146
"/opt/projects/swiftkube/vendor/k8s.io/client-go/kubernetes/typed/networking/v1alpha1/fake/fake_networking_client.go", "Go", 34, 0, 0, 0, 0, 0, 11, 45
"/opt/projects/swiftkube/vendor/k8s.io/client-go/kubernetes/typed/networking/v1alpha1/generated_expansion.go", "Go", 16, 0, 0, 0, 0, 0, 8, 24
"/opt/projects/swiftkube/vendor/k8s.io/client-go/kubernetes/typed/networking/v1alpha1/ipaddress.go", "Go", 177, 0, 0, 0, 0, 0, 21, 198
"/opt/projects/swiftkube/vendor/k8s.io/client-go/kubernetes/typed/networking/v1alpha1/networking_client.go", "Go", 93, 0, 0, 0, 0, 0, 20, 113
"/opt/projects/swiftkube/vendor/k8s.io/client-go/kubernetes/typed/networking/v1beta1/doc.go", "Go", 15, 0, 0, 0, 0, 0, 6, 21
"/opt/projects/swiftkube/vendor/k8s.io/client-go/kubernetes/typed/networking/v1beta1/fake/doc.go", "Go", 15, 0, 0, 0, 0, 0, 6, 21
"/opt/projects/swiftkube/vendor/k8s.io/client-go/kubernetes/typed/networking/v1beta1/fake/fake_ingress.go", "Go", 156, 0, 0, 0, 0, 0, 34, 190
"/opt/projects/swiftkube/vendor/k8s.io/client-go/kubernetes/typed/networking/v1beta1/fake/fake_ingressclass.go", "Go", 124, 0, 0, 0, 0, 0, 22, 146
"/opt/projects/swiftkube/vendor/k8s.io/client-go/kubernetes/typed/networking/v1beta1/fake/fake_networking_client.go", "Go", 34, 0, 0, 0, 0, 0, 11, 45
"/opt/projects/swiftkube/vendor/k8s.io/client-go/kubernetes/typed/networking/v1beta1/generated_expansion.go", "Go", 16, 0, 0, 0, 0, 0, 8, 24
"/opt/projects/swiftkube/vendor/k8s.io/client-go/kubernetes/typed/networking/v1beta1/ingress.go", "Go", 232, 0, 0, 0, 0, 0, 25, 257
"/opt/projects/swiftkube/vendor/k8s.io/client-go/kubernetes/typed/networking/v1beta1/ingressclass.go", "Go", 177, 0, 0, 0, 0, 0, 21, 198
"/opt/projects/swiftkube/vendor/k8s.io/client-go/kubernetes/typed/networking/v1beta1/networking_client.go", "Go", 93, 0, 0, 0, 0, 0, 20, 113
"/opt/projects/swiftkube/vendor/k8s.io/client-go/kubernetes/typed/node/v1/doc.go", "Go", 15, 0, 0, 0, 0, 0, 6, 21
"/opt/projects/swiftkube/vendor/k8s.io/client-go/kubernetes/typed/node/v1/fake/doc.go", "Go", 15, 0, 0, 0, 0, 0, 6, 21
"/opt/projects/swiftkube/vendor/k8s.io/client-go/kubernetes/typed/node/v1/fake/fake_node_client.go", "Go", 31, 0, 0, 0, 0, 0, 10, 41
"/opt/projects/swiftkube/vendor/k8s.io/client-go/kubernetes/typed/node/v1/fake/fake_runtimeclass.go", "Go", 124, 0, 0, 0, 0, 0, 22, 146
"/opt/projects/swiftkube/vendor/k8s.io/client-go/kubernetes/typed/node/v1/generated_expansion.go", "Go", 15, 0, 0, 0, 0, 0, 7, 22
"/opt/projects/swiftkube/vendor/k8s.io/client-go/kubernetes/typed/node/v1/node_client.go", "Go", 89, 0, 0, 0, 0, 0, 19, 108
"/opt/projects/swiftkube/vendor/k8s.io/client-go/kubernetes/typed/node/v1/runtimeclass.go", "Go", 177, 0, 0, 0, 0, 0, 21, 198
"/opt/projects/swiftkube/vendor/k8s.io/client-go/kubernetes/typed/node/v1alpha1/doc.go", "Go", 15, 0, 0, 0, 0, 0, 6, 21
"/opt/projects/swiftkube/vendor/k8s.io/client-go/kubernetes/typed/node/v1alpha1/fake/doc.go", "Go", 15, 0, 0, 0, 0, 0, 6, 21
"/opt/projects/swiftkube/vendor/k8s.io/client-go/kubernetes/typed/node/v1alpha1/fake/fake_node_client.go", "Go", 31, 0, 0, 0, 0, 0, 10, 41
"/opt/projects/swiftkube/vendor/k8s.io/client-go/kubernetes/typed/node/v1alpha1/fake/fake_runtimeclass.go", "Go", 124, 0, 0, 0, 0, 0, 22, 146
"/opt/projects/swiftkube/vendor/k8s.io/client-go/kubernetes/typed/node/v1alpha1/generated_expansion.go", "Go", 15, 0, 0, 0, 0, 0, 7, 22
"/opt/projects/swiftkube/vendor/k8s.io/client-go/kubernetes/typed/node/v1alpha1/node_client.go", "Go", 89, 0, 0, 0, 0, 0, 19, 108
"/opt/projects/swiftkube/vendor/k8s.io/client-go/kubernetes/typed/node/v1alpha1/runtimeclass.go", "Go", 177, 0, 0, 0, 0, 0, 21, 198
"/opt/projects/swiftkube/vendor/k8s.io/client-go/kubernetes/typed/node/v1beta1/doc.go", "Go", 15, 0, 0, 0, 0, 0, 6, 21
"/opt/projects/swiftkube/vendor/k8s.io/client-go/kubernetes/typed/node/v1beta1/fake/doc.go", "Go", 15, 0, 0, 0, 0, 0, 6, 21
"/opt/projects/swiftkube/vendor/k8s.io/client-go/kubernetes/typed/node/v1beta1/fake/fake_node_client.go", "Go", 31, 0, 0, 0, 0, 0, 10, 41
"/opt/projects/swiftkube/vendor/k8s.io/client-go/kubernetes/typed/node/v1beta1/fake/fake_runtimeclass.go", "Go", 124, 0, 0, 0, 0, 0, 22, 146
"/opt/projects/swiftkube/vendor/k8s.io/client-go/kubernetes/typed/node/v1beta1/generated_expansion.go", "Go", 15, 0, 0, 0, 0, 0, 7, 22
"/opt/projects/swiftkube/vendor/k8s.io/client-go/kubernetes/typed/node/v1beta1/node_client.go", "Go", 89, 0, 0, 0, 0, 0, 19, 108
"/opt/projects/swiftkube/vendor/k8s.io/client-go/kubernetes/typed/node/v1beta1/runtimeclass.go", "Go", 177, 0, 0, 0, 0, 0, 21, 198
"/opt/projects/swiftkube/vendor/k8s.io/client-go/kubernetes/typed/policy/v1/doc.go", "Go", 15, 0, 0, 0, 0, 0, 6, 21
"/opt/projects/swiftkube/vendor/k8s.io/client-go/kubernetes/typed/policy/v1/eviction.go", "Go", 38, 0, 0, 0, 0, 0, 11, 49
"/opt/projects/swiftkube/vendor/k8s.io/client-go/kubernetes/typed/policy/v1/eviction_expansion.go", "Go", 32, 0, 0, 0, 0, 0, 9, 41
"/opt/projects/swiftkube/vendor/k8s.io/client-go/kubernetes/typed/policy/v1/fake/doc.go", "Go", 15, 0, 0, 0, 0, 0, 6, 21
"/opt/projects/swiftkube/vendor/k8s.io/client-go/kubernetes/typed/policy/v1/fake/fake_eviction.go", "Go", 19, 0, 0, 0, 0, 0, 7, 26
"/opt/projects/swiftkube/vendor/k8s.io/client-go/kubernetes/typed/policy/v1/fake/fake_eviction_expansion.go", "Go", 29, 0, 0, 0, 0, 0, 9, 38
"/opt/projects/swiftkube/vendor/k8s.io/client-go/kubernetes/typed/policy/v1/fake/fake_poddisruptionbudget.go", "Go", 156, 0, 0, 0, 0, 0, 34, 190
"/opt/projects/swiftkube/vendor/k8s.io/client-go/kubernetes/typed/policy/v1/fake/fake_policy_client.go", "Go", 34, 0, 0, 0, 0, 0, 11, 45
"/opt/projects/swiftkube/vendor/k8s.io/client-go/kubernetes/typed/policy/v1/generated_expansion.go", "Go", 15, 0, 0, 0, 0, 0, 7, 22
"/opt/projects/swiftkube/vendor/k8s.io/client-go/kubernetes/typed/policy/v1/poddisruptionbudget.go", "Go", 232, 0, 0, 0, 0, 0, 25, 257
"/opt/projects/swiftkube/vendor/k8s.io/client-go/kubernetes/typed/policy/v1/policy_client.go", "Go", 93, 0, 0, 0, 0, 0, 20, 113
"/opt/projects/swiftkube/vendor/k8s.io/client-go/kubernetes/typed/policy/v1beta1/doc.go", "Go", 15, 0, 0, 0, 0, 0, 6, 21
"/opt/projects/swiftkube/vendor/k8s.io/client-go/kubernetes/typed/policy/v1beta1/eviction.go", "Go", 38, 0, 0, 0, 0, 0, 11, 49
"/opt/projects/swiftkube/vendor/k8s.io/client-go/kubernetes/typed/policy/v1beta1/eviction_expansion.go", "Go", 32, 0, 0, 0, 0, 0, 9, 41
"/opt/projects/swiftkube/vendor/k8s.io/client-go/kubernetes/typed/policy/v1beta1/fake/doc.go", "Go", 15, 0, 0, 0, 0, 0, 6, 21
"/opt/projects/swiftkube/vendor/k8s.io/client-go/kubernetes/typed/policy/v1beta1/fake/fake_eviction.go", "Go", 19, 0, 0, 0, 0, 0, 7, 26
"/opt/projects/swiftkube/vendor/k8s.io/client-go/kubernetes/typed/policy/v1beta1/fake/fake_eviction_expansion.go", "Go", 29, 0, 0, 0, 0, 0, 9, 38
"/opt/projects/swiftkube/vendor/k8s.io/client-go/kubernetes/typed/policy/v1beta1/fake/fake_poddisruptionbudget.go", "Go", 156, 0, 0, 0, 0, 0, 34, 190
"/opt/projects/swiftkube/vendor/k8s.io/client-go/kubernetes/typed/policy/v1beta1/fake/fake_podsecuritypolicy.go", "Go", 124, 0, 0, 0, 0, 0, 22, 146
"/opt/projects/swiftkube/vendor/k8s.io/client-go/kubernetes/typed/policy/v1beta1/fake/fake_policy_client.go", "Go", 37, 0, 0, 0, 0, 0, 12, 49
"/opt/projects/swiftkube/vendor/k8s.io/client-go/kubernetes/typed/policy/v1beta1/generated_expansion.go", "Go", 16, 0, 0, 0, 0, 0, 8, 24
"/opt/projects/swiftkube/vendor/k8s.io/client-go/kubernetes/typed/policy/v1beta1/poddisruptionbudget.go", "Go", 232, 0, 0, 0, 0, 0, 25, 257
"/opt/projects/swiftkube/vendor/k8s.io/client-go/kubernetes/typed/policy/v1beta1/podsecuritypolicy.go", "Go", 177, 0, 0, 0, 0, 0, 21, 198
"/opt/projects/swiftkube/vendor/k8s.io/client-go/kubernetes/typed/policy/v1beta1/policy_client.go", "Go", 97, 0, 0, 0, 0, 0, 21, 118
"/opt/projects/swiftkube/vendor/k8s.io/client-go/kubernetes/typed/rbac/v1/clusterrole.go", "Go", 177, 0, 0, 0, 0, 0, 21, 198
"/opt/projects/swiftkube/vendor/k8s.io/client-go/kubernetes/typed/rbac/v1/clusterrolebinding.go", "Go", 177, 0, 0, 0, 0, 0, 21, 198
"/opt/projects/swiftkube/vendor/k8s.io/client-go/kubernetes/typed/rbac/v1/doc.go", "Go", 15, 0, 0, 0, 0, 0, 6, 21
"/opt/projects/swiftkube/vendor/k8s.io/client-go/kubernetes/typed/rbac/v1/fake/doc.go", "Go", 15, 0, 0, 0, 0, 0, 6, 21
"/opt/projects/swiftkube/vendor/k8s.io/client-go/kubernetes/typed/rbac/v1/fake/fake_clusterrole.go", "Go", 124, 0, 0, 0, 0, 0, 22, 146
"/opt/projects/swiftkube/vendor/k8s.io/client-go/kubernetes/typed/rbac/v1/fake/fake_clusterrolebinding.go", "Go", 124, 0, 0, 0, 0, 0, 22, 146
"/opt/projects/swiftkube/vendor/k8s.io/client-go/kubernetes/typed/rbac/v1/fake/fake_rbac_client.go", "Go", 40, 0, 0, 0, 0, 0, 13, 53
"/opt/projects/swiftkube/vendor/k8s.io/client-go/kubernetes/typed/rbac/v1/fake/fake_role.go", "Go", 125, 0, 0, 0, 0, 0, 30, 155
"/opt/projects/swiftkube/vendor/k8s.io/client-go/kubernetes/typed/rbac/v1/fake/fake_rolebinding.go", "Go", 125, 0, 0, 0, 0, 0, 30, 155
"/opt/projects/swiftkube/vendor/k8s.io/client-go/kubernetes/typed/rbac/v1/generated_expansion.go", "Go", 18, 0, 0, 0, 0, 0, 10, 28
"/opt/projects/swiftkube/vendor/k8s.io/client-go/kubernetes/typed/rbac/v1/rbac_client.go", "Go", 101, 0, 0, 0, 0, 0, 22, 123
"/opt/projects/swiftkube/vendor/k8s.io/client-go/kubernetes/typed/rbac/v1/role.go", "Go", 188, 0, 0, 0, 0, 0, 21, 209
"/opt/projects/swiftkube/vendor/k8s.io/client-go/kubernetes/typed/rbac/v1/rolebinding.go", "Go", 188, 0, 0, 0, 0, 0, 21, 209
"/opt/projects/swiftkube/vendor/k8s.io/client-go/kubernetes/typed/rbac/v1alpha1/clusterrole.go", "Go", 177, 0, 0, 0, 0, 0, 21, 198
"/opt/projects/swiftkube/vendor/k8s.io/client-go/kubernetes/typed/rbac/v1alpha1/clusterrolebinding.go", "Go", 177, 0, 0, 0, 0, 0, 21, 198
"/opt/projects/swiftkube/vendor/k8s.io/client-go/kubernetes/typed/rbac/v1alpha1/doc.go", "Go", 15, 0, 0, 0, 0, 0, 6, 21
"/opt/projects/swiftkube/vendor/k8s.io/client-go/kubernetes/typed/rbac/v1alpha1/fake/doc.go", "Go", 15, 0, 0, 0, 0, 0, 6, 21
"/opt/projects/swiftkube/vendor/k8s.io/client-go/kubernetes/typed/rbac/v1alpha1/fake/fake_clusterrole.go", "Go", 124, 0, 0, 0, 0, 0, 22, 146
"/opt/projects/swiftkube/vendor/k8s.io/client-go/kubernetes/typed/rbac/v1alpha1/fake/fake_clusterrolebinding.go", "Go", 124, 0, 0, 0, 0, 0, 22, 146
"/opt/projects/swiftkube/vendor/k8s.io/client-go/kubernetes/typed/rbac/v1alpha1/fake/fake_rbac_client.go", "Go", 40, 0, 0, 0, 0, 0, 13, 53
"/opt/projects/swiftkube/vendor/k8s.io/client-go/kubernetes/typed/rbac/v1alpha1/fake/fake_role.go", "Go", 125, 0, 0, 0, 0, 0, 30, 155
"/opt/projects/swiftkube/vendor/k8s.io/client-go/kubernetes/typed/rbac/v1alpha1/fake/fake_rolebinding.go", "Go", 125, 0, 0, 0, 0, 0, 30, 155
"/opt/projects/swiftkube/vendor/k8s.io/client-go/kubernetes/typed/rbac/v1alpha1/generated_expansion.go", "Go", 18, 0, 0, 0, 0, 0, 10, 28
"/opt/projects/swiftkube/vendor/k8s.io/client-go/kubernetes/typed/rbac/v1alpha1/rbac_client.go", "Go", 101, 0, 0, 0, 0, 0, 22, 123
"/opt/projects/swiftkube/vendor/k8s.io/client-go/kubernetes/typed/rbac/v1alpha1/role.go", "Go", 188, 0, 0, 0, 0, 0, 21, 209
"/opt/projects/swiftkube/vendor/k8s.io/client-go/kubernetes/typed/rbac/v1alpha1/rolebinding.go", "Go", 188, 0, 0, 0, 0, 0, 21, 209
"/opt/projects/swiftkube/vendor/k8s.io/client-go/kubernetes/typed/rbac/v1beta1/clusterrole.go", "Go", 177, 0, 0, 0, 0, 0, 21, 198
"/opt/projects/swiftkube/vendor/k8s.io/client-go/kubernetes/typed/rbac/v1beta1/clusterrolebinding.go", "Go", 177, 0, 0, 0, 0, 0, 21, 198
"/opt/projects/swiftkube/vendor/k8s.io/client-go/kubernetes/typed/rbac/v1beta1/doc.go", "Go", 15, 0, 0, 0, 0, 0, 6, 21
"/opt/projects/swiftkube/vendor/k8s.io/client-go/kubernetes/typed/rbac/v1beta1/fake/doc.go", "Go", 15, 0, 0, 0, 0, 0, 6, 21
"/opt/projects/swiftkube/vendor/k8s.io/client-go/kubernetes/typed/rbac/v1beta1/fake/fake_clusterrole.go", "Go", 124, 0, 0, 0, 0, 0, 22, 146
"/opt/projects/swiftkube/vendor/k8s.io/client-go/kubernetes/typed/rbac/v1beta1/fake/fake_clusterrolebinding.go", "Go", 124, 0, 0, 0, 0, 0, 22, 146
"/opt/projects/swiftkube/vendor/k8s.io/client-go/kubernetes/typed/rbac/v1beta1/fake/fake_rbac_client.go", "Go", 40, 0, 0, 0, 0, 0, 13, 53
"/opt/projects/swiftkube/vendor/k8s.io/client-go/kubernetes/typed/rbac/v1beta1/fake/fake_role.go", "Go", 125, 0, 0, 0, 0, 0, 30, 155
"/opt/projects/swiftkube/vendor/k8s.io/client-go/kubernetes/typed/rbac/v1beta1/fake/fake_rolebinding.go", "Go", 125, 0, 0, 0, 0, 0, 30, 155
"/opt/projects/swiftkube/vendor/k8s.io/client-go/kubernetes/typed/rbac/v1beta1/generated_expansion.go", "Go", 18, 0, 0, 0, 0, 0, 10, 28
"/opt/projects/swiftkube/vendor/k8s.io/client-go/kubernetes/typed/rbac/v1beta1/rbac_client.go", "Go", 101, 0, 0, 0, 0, 0, 22, 123
"/opt/projects/swiftkube/vendor/k8s.io/client-go/kubernetes/typed/rbac/v1beta1/role.go", "Go", 188, 0, 0, 0, 0, 0, 21, 209
"/opt/projects/swiftkube/vendor/k8s.io/client-go/kubernetes/typed/rbac/v1beta1/rolebinding.go", "Go", 188, 0, 0, 0, 0, 0, 21, 209
"/opt/projects/swiftkube/vendor/k8s.io/client-go/kubernetes/typed/resource/v1alpha2/doc.go", "Go", 15, 0, 0, 0, 0, 0, 6, 21
"/opt/projects/swiftkube/vendor/k8s.io/client-go/kubernetes/typed/resource/v1alpha2/fake/doc.go", "Go", 15, 0, 0, 0, 0, 0, 6, 21
"/opt/projects/swiftkube/vendor/k8s.io/client-go/kubernetes/typed/resource/v1alpha2/fake/fake_podschedulingcontext.go", "Go", 156, 0, 0, 0, 0, 0, 34, 190
"/opt/projects/swiftkube/vendor/k8s.io/client-go/kubernetes/typed/resource/v1alpha2/fake/fake_resource_client.go", "Go", 40, 0, 0, 0, 0, 0, 13, 53
"/opt/projects/swiftkube/vendor/k8s.io/client-go/kubernetes/typed/resource/v1alpha2/fake/fake_resourceclaim.go", "Go", 156, 0, 0, 0, 0, 0, 34, 190
"/opt/projects/swiftkube/vendor/k8s.io/client-go/kubernetes/typed/resource/v1alpha2/fake/fake_resourceclaimtemplate.go", "Go", 125, 0, 0, 0, 0, 0, 30, 155
"/opt/projects/swiftkube/vendor/k8s.io/client-go/kubernetes/typed/resource/v1alpha2/fake/fake_resourceclass.go", "Go", 124, 0, 0, 0, 0, 0, 22, 146
"/opt/projects/swiftkube/vendor/k8s.io/client-go/kubernetes/typed/resource/v1alpha2/generated_expansion.go", "Go", 18, 0, 0, 0, 0, 0, 10, 28
"/opt/projects/swiftkube/vendor/k8s.io/client-go/kubernetes/typed/resource/v1alpha2/podschedulingcontext.go", "Go", 232, 0, 0, 0, 0, 0, 25, 257
"/opt/projects/swiftkube/vendor/k8s.io/client-go/kubernetes/typed/resource/v1alpha2/resource_client.go", "Go", 101, 0, 0, 0, 0, 0, 22, 123
"/opt/projects/swiftkube/vendor/k8s.io/client-go/kubernetes/typed/resource/v1alpha2/resourceclaim.go", "Go", 232, 0, 0, 0, 0, 0, 25, 257
"/opt/projects/swiftkube/vendor/k8s.io/client-go/kubernetes/typed/resource/v1alpha2/resourceclaimtemplate.go", "Go", 188, 0, 0, 0, 0, 0, 21, 209
"/opt/projects/swiftkube/vendor/k8s.io/client-go/kubernetes/typed/resource/v1alpha2/resourceclass.go", "Go", 177, 0, 0, 0, 0, 0, 21, 198
"/opt/projects/swiftkube/vendor/k8s.io/client-go/kubernetes/typed/scheduling/v1/doc.go", "Go", 15, 0, 0, 0, 0, 0, 6, 21
"/opt/projects/swiftkube/vendor/k8s.io/client-go/kubernetes/typed/scheduling/v1/fake/doc.go", "Go", 15, 0, 0, 0, 0, 0, 6, 21
"/opt/projects/swiftkube/vendor/k8s.io/client-go/kubernetes/typed/scheduling/v1/fake/fake_priorityclass.go", "Go", 124, 0, 0, 0, 0, 0, 22, 146
"/opt/projects/swiftkube/vendor/k8s.io/client-go/kubernetes/typed/scheduling/v1/fake/fake_scheduling_client.go", "Go", 31, 0, 0, 0, 0, 0, 10, 41
"/opt/projects/swiftkube/vendor/k8s.io/client-go/kubernetes/typed/scheduling/v1/generated_expansion.go", "Go", 15, 0, 0, 0, 0, 0, 7, 22
"/opt/projects/swiftkube/vendor/k8s.io/client-go/kubernetes/typed/scheduling/v1/priorityclass.go", "Go", 177, 0, 0, 0, 0, 0, 21, 198
"/opt/projects/swiftkube/vendor/k8s.io/client-go/kubernetes/typed/scheduling/v1/scheduling_client.go", "Go", 89, 0, 0, 0, 0, 0, 19, 108
"/opt/projects/swiftkube/vendor/k8s.io/client-go/kubernetes/typed/scheduling/v1alpha1/doc.go", "Go", 15, 0, 0, 0, 0, 0, 6, 21
"/opt/projects/swiftkube/vendor/k8s.io/client-go/kubernetes/typed/scheduling/v1alpha1/fake/doc.go", "Go", 15, 0, 0, 0, 0, 0, 6, 21
"/opt/projects/swiftkube/vendor/k8s.io/client-go/kubernetes/typed/scheduling/v1alpha1/fake/fake_priorityclass.go", "Go", 124, 0, 0, 0, 0, 0, 22, 146
"/opt/projects/swiftkube/vendor/k8s.io/client-go/kubernetes/typed/scheduling/v1alpha1/fake/fake_scheduling_client.go", "Go", 31, 0, 0, 0, 0, 0, 10, 41
"/opt/projects/swiftkube/vendor/k8s.io/client-go/kubernetes/typed/scheduling/v1alpha1/generated_expansion.go", "Go", 15, 0, 0, 0, 0, 0, 7, 22
"/opt/projects/swiftkube/vendor/k8s.io/client-go/kubernetes/typed/scheduling/v1alpha1/priorityclass.go", "Go", 177, 0, 0, 0, 0, 0, 21, 198
"/opt/projects/swiftkube/vendor/k8s.io/client-go/kubernetes/typed/scheduling/v1alpha1/scheduling_client.go", "Go", 89, 0, 0, 0, 0, 0, 19, 108
"/opt/projects/swiftkube/vendor/k8s.io/client-go/kubernetes/typed/scheduling/v1beta1/doc.go", "Go", 15, 0, 0, 0, 0, 0, 6, 21
"/opt/projects/swiftkube/vendor/k8s.io/client-go/kubernetes/typed/scheduling/v1beta1/fake/doc.go", "Go", 15, 0, 0, 0, 0, 0, 6, 21
"/opt/projects/swiftkube/vendor/k8s.io/client-go/kubernetes/typed/scheduling/v1beta1/fake/fake_priorityclass.go", "Go", 124, 0, 0, 0, 0, 0, 22, 146
"/opt/projects/swiftkube/vendor/k8s.io/client-go/kubernetes/typed/scheduling/v1beta1/fake/fake_scheduling_client.go", "Go", 31, 0, 0, 0, 0, 0, 10, 41
"/opt/projects/swiftkube/vendor/k8s.io/client-go/kubernetes/typed/scheduling/v1beta1/generated_expansion.go", "Go", 15, 0, 0, 0, 0, 0, 7, 22
"/opt/projects/swiftkube/vendor/k8s.io/client-go/kubernetes/typed/scheduling/v1beta1/priorityclass.go", "Go", 177, 0, 0, 0, 0, 0, 21, 198
"/opt/projects/swiftkube/vendor/k8s.io/client-go/kubernetes/typed/scheduling/v1beta1/scheduling_client.go", "Go", 89, 0, 0, 0, 0, 0, 19, 108
"/opt/projects/swiftkube/vendor/k8s.io/client-go/kubernetes/typed/storage/v1/csidriver.go", "Go", 177, 0, 0, 0, 0, 0, 21, 198
"/opt/projects/swiftkube/vendor/k8s.io/client-go/kubernetes/typed/storage/v1/csinode.go", "Go", 177, 0, 0, 0, 0, 0, 21, 198
"/opt/projects/swiftkube/vendor/k8s.io/client-go/kubernetes/typed/storage/v1/csistoragecapacity.go", "Go", 188, 0, 0, 0, 0, 0, 21, 209
"/opt/projects/swiftkube/vendor/k8s.io/client-go/kubernetes/typed/storage/v1/doc.go", "Go", 15, 0, 0, 0, 0, 0, 6, 21
"/opt/projects/swiftkube/vendor/k8s.io/client-go/kubernetes/typed/storage/v1/fake/doc.go", "Go", 15, 0, 0, 0, 0, 0, 6, 21
"/opt/projects/swiftkube/vendor/k8s.io/client-go/kubernetes/typed/storage/v1/fake/fake_csidriver.go", "Go", 124, 0, 0, 0, 0, 0, 22, 146
"/opt/projects/swiftkube/vendor/k8s.io/client-go/kubernetes/typed/storage/v1/fake/fake_csinode.go", "Go", 124, 0, 0, 0, 0, 0, 22, 146
"/opt/projects/swiftkube/vendor/k8s.io/client-go/kubernetes/typed/storage/v1/fake/fake_csistoragecapacity.go", "Go", 125, 0, 0, 0, 0, 0, 30, 155
"/opt/projects/swiftkube/vendor/k8s.io/client-go/kubernetes/typed/storage/v1/fake/fake_storage_client.go", "Go", 43, 0, 0, 0, 0, 0, 14, 57
"/opt/projects/swiftkube/vendor/k8s.io/client-go/kubernetes/typed/storage/v1/fake/fake_storageclass.go", "Go", 124, 0, 0, 0, 0, 0, 22, 146
"/opt/projects/swiftkube/vendor/k8s.io/client-go/kubernetes/typed/storage/v1/fake/fake_volumeattachment.go", "Go", 155, 0, 0, 0, 0, 0, 24, 179
"/opt/projects/swiftkube/vendor/k8s.io/client-go/kubernetes/typed/storage/v1/generated_expansion.go", "Go", 19, 0, 0, 0, 0, 0, 11, 30
"/opt/projects/swiftkube/vendor/k8s.io/client-go/kubernetes/typed/storage/v1/storage_client.go", "Go", 105, 0, 0, 0, 0, 0, 23, 128
"/opt/projects/swiftkube/vendor/k8s.io/client-go/kubernetes/typed/storage/v1/storageclass.go", "Go", 177, 0, 0, 0, 0, 0, 21, 198
"/opt/projects/swiftkube/vendor/k8s.io/client-go/kubernetes/typed/storage/v1/volumeattachment.go", "Go", 219, 0, 0, 0, 0, 0, 25, 244
"/opt/projects/swiftkube/vendor/k8s.io/client-go/kubernetes/typed/storage/v1alpha1/csistoragecapacity.go", "Go", 188, 0, 0, 0, 0, 0, 21, 209
"/opt/projects/swiftkube/vendor/k8s.io/client-go/kubernetes/typed/storage/v1alpha1/doc.go", "Go", 15, 0, 0, 0, 0, 0, 6, 21
"/opt/projects/swiftkube/vendor/k8s.io/client-go/kubernetes/typed/storage/v1alpha1/fake/doc.go", "Go", 15, 0, 0, 0, 0, 0, 6, 21
"/opt/projects/swiftkube/vendor/k8s.io/client-go/kubernetes/typed/storage/v1alpha1/fake/fake_csistoragecapacity.go", "Go", 125, 0, 0, 0, 0, 0, 30, 155
"/opt/projects/swiftkube/vendor/k8s.io/client-go/kubernetes/typed/storage/v1alpha1/fake/fake_storage_client.go", "Go", 34, 0, 0, 0, 0, 0, 11, 45
"/opt/projects/swiftkube/vendor/k8s.io/client-go/kubernetes/typed/storage/v1alpha1/fake/fake_volumeattachment.go", "Go", 155, 0, 0, 0, 0, 0, 24, 179
"/opt/projects/swiftkube/vendor/k8s.io/client-go/kubernetes/typed/storage/v1alpha1/generated_expansion.go", "Go", 16, 0, 0, 0, 0, 0, 8, 24
"/opt/projects/swiftkube/vendor/k8s.io/client-go/kubernetes/typed/storage/v1alpha1/storage_client.go", "Go", 93, 0, 0, 0, 0, 0, 20, 113
"/opt/projects/swiftkube/vendor/k8s.io/client-go/kubernetes/typed/storage/v1alpha1/volumeattachment.go", "Go", 219, 0, 0, 0, 0, 0, 25, 244
"/opt/projects/swiftkube/vendor/k8s.io/client-go/kubernetes/typed/storage/v1beta1/csidriver.go", "Go", 177, 0, 0, 0, 0, 0, 21, 198
"/opt/projects/swiftkube/vendor/k8s.io/client-go/kubernetes/typed/storage/v1beta1/csinode.go", "Go", 177, 0, 0, 0, 0, 0, 21, 198
"/opt/projects/swiftkube/vendor/k8s.io/client-go/kubernetes/typed/storage/v1beta1/csistoragecapacity.go", "Go", 188, 0, 0, 0, 0, 0, 21, 209
"/opt/projects/swiftkube/vendor/k8s.io/client-go/kubernetes/typed/storage/v1beta1/doc.go", "Go", 15, 0, 0, 0, 0, 0, 6, 21
"/opt/projects/swiftkube/vendor/k8s.io/client-go/kubernetes/typed/storage/v1beta1/fake/doc.go", "Go", 15, 0, 0, 0, 0, 0, 6, 21
"/opt/projects/swiftkube/vendor/k8s.io/client-go/kubernetes/typed/storage/v1beta1/fake/fake_csidriver.go", "Go", 124, 0, 0, 0, 0, 0, 22, 146
"/opt/projects/swiftkube/vendor/k8s.io/client-go/kubernetes/typed/storage/v1beta1/fake/fake_csinode.go", "Go", 124, 0, 0, 0, 0, 0, 22, 146
"/opt/projects/swiftkube/vendor/k8s.io/client-go/kubernetes/typed/storage/v1beta1/fake/fake_csistoragecapacity.go", "Go", 125, 0, 0, 0, 0, 0, 30, 155
"/opt/projects/swiftkube/vendor/k8s.io/client-go/kubernetes/typed/storage/v1beta1/fake/fake_storage_client.go", "Go", 43, 0, 0, 0, 0, 0, 14, 57
"/opt/projects/swiftkube/vendor/k8s.io/client-go/kubernetes/typed/storage/v1beta1/fake/fake_storageclass.go", "Go", 124, 0, 0, 0, 0, 0, 22, 146
"/opt/projects/swiftkube/vendor/k8s.io/client-go/kubernetes/typed/storage/v1beta1/fake/fake_volumeattachment.go", "Go", 155, 0, 0, 0, 0, 0, 24, 179
"/opt/projects/swiftkube/vendor/k8s.io/client-go/kubernetes/typed/storage/v1beta1/generated_expansion.go", "Go", 19, 0, 0, 0, 0, 0, 11, 30
"/opt/projects/swiftkube/vendor/k8s.io/client-go/kubernetes/typed/storage/v1beta1/storage_client.go", "Go", 105, 0, 0, 0, 0, 0, 23, 128
"/opt/projects/swiftkube/vendor/k8s.io/client-go/kubernetes/typed/storage/v1beta1/storageclass.go", "Go", 177, 0, 0, 0, 0, 0, 21, 198
"/opt/projects/swiftkube/vendor/k8s.io/client-go/kubernetes/typed/storage/v1beta1/volumeattachment.go", "Go", 219, 0, 0, 0, 0, 0, 25, 244
"/opt/projects/swiftkube/vendor/k8s.io/client-go/listers/admissionregistration/v1/expansion_generated.go", "Go", 20, 0, 0, 0, 0, 0, 8, 28
"/opt/projects/swiftkube/vendor/k8s.io/client-go/listers/admissionregistration/v1/mutatingwebhookconfiguration.go", "Go", 57, 0, 0, 0, 0, 0, 12, 69
"/opt/projects/swiftkube/vendor/k8s.io/client-go/listers/admissionregistration/v1/validatingwebhookconfiguration.go", "Go", 57, 0, 0, 0, 0, 0, 12, 69
"/opt/projects/swiftkube/vendor/k8s.io/client-go/listers/admissionregistration/v1alpha1/expansion_generated.go", "Go", 20, 0, 0, 0, 0, 0, 8, 28
"/opt/projects/swiftkube/vendor/k8s.io/client-go/listers/admissionregistration/v1alpha1/validatingadmissionpolicy.go", "Go", 57, 0, 0, 0, 0, 0, 12, 69
"/opt/projects/swiftkube/vendor/k8s.io/client-go/listers/admissionregistration/v1alpha1/validatingadmissionpolicybinding.go", "Go", 57, 0, 0, 0, 0, 0, 12, 69
"/opt/projects/swiftkube/vendor/k8s.io/client-go/listers/admissionregistration/v1beta1/expansion_generated.go", "Go", 26, 0, 0, 0, 0, 0, 10, 36
"/opt/projects/swiftkube/vendor/k8s.io/client-go/listers/admissionregistration/v1beta1/mutatingwebhookconfiguration.go", "Go", 57, 0, 0, 0, 0, 0, 12, 69
"/opt/projects/swiftkube/vendor/k8s.io/client-go/listers/admissionregistration/v1beta1/validatingadmissionpolicy.go", "Go", 57, 0, 0, 0, 0, 0, 12, 69
"/opt/projects/swiftkube/vendor/k8s.io/client-go/listers/admissionregistration/v1beta1/validatingadmissionpolicybinding.go", "Go", 57, 0, 0, 0, 0, 0, 12, 69
"/opt/projects/swiftkube/vendor/k8s.io/client-go/listers/admissionregistration/v1beta1/validatingwebhookconfiguration.go", "Go", 57, 0, 0, 0, 0, 0, 12, 69
"/opt/projects/swiftkube/vendor/k8s.io/client-go/listers/apiserverinternal/v1alpha1/expansion_generated.go", "Go", 17, 0, 0, 0, 0, 0, 7, 24
"/opt/projects/swiftkube/vendor/k8s.io/client-go/listers/apiserverinternal/v1alpha1/storageversion.go", "Go", 57, 0, 0, 0, 0, 0, 12, 69
"/opt/projects/swiftkube/vendor/k8s.io/client-go/listers/apps/v1/controllerrevision.go", "Go", 84, 0, 0, 0, 0, 0, 16, 100
"/opt/projects/swiftkube/vendor/k8s.io/client-go/listers/apps/v1/daemonset.go", "Go", 84, 0, 0, 0, 0, 0, 16, 100
"/opt/projects/swiftkube/vendor/k8s.io/client-go/listers/apps/v1/daemonset_expansion.go", "Go", 94, 0, 0, 0, 0, 0, 21, 115
"/opt/projects/swiftkube/vendor/k8s.io/client-go/listers/apps/v1/deployment.go", "Go", 84, 0, 0, 0, 0, 0, 16, 100
"/opt/projects/swiftkube/vendor/k8s.io/client-go/listers/apps/v1/expansion_generated.go", "Go", 26, 0, 0, 0, 0, 0, 10, 36
"/opt/projects/swiftkube/vendor/k8s.io/client-go/listers/apps/v1/replicaset.go", "Go", 84, 0, 0, 0, 0, 0, 16, 100
"/opt/projects/swiftkube/vendor/k8s.io/client-go/listers/apps/v1/replicaset_expansion.go", "Go", 60, 0, 0, 0, 0, 0, 15, 75
"/opt/projects/swiftkube/vendor/k8s.io/client-go/listers/apps/v1/statefulset.go", "Go", 84, 0, 0, 0, 0, 0, 16, 100
"/opt/projects/swiftkube/vendor/k8s.io/client-go/listers/apps/v1/statefulset_expansion.go", "Go", 63, 0, 0, 0, 0, 0, 16, 79
"/opt/projects/swiftkube/vendor/k8s.io/client-go/listers/apps/v1beta1/controllerrevision.go", "Go", 84, 0, 0, 0, 0, 0, 16, 100
"/opt/projects/swiftkube/vendor/k8s.io/client-go/listers/apps/v1beta1/deployment.go", "Go", 84, 0, 0, 0, 0, 0, 16, 100
"/opt/projects/swiftkube/vendor/k8s.io/client-go/listers/apps/v1beta1/expansion_generated.go", "Go", 26, 0, 0, 0, 0, 0, 10, 36
"/opt/projects/swiftkube/vendor/k8s.io/client-go/listers/apps/v1beta1/statefulset.go", "Go", 84, 0, 0, 0, 0, 0, 16, 100
"/opt/projects/swiftkube/vendor/k8s.io/client-go/listers/apps/v1beta1/statefulset_expansion.go", "Go", 63, 0, 0, 0, 0, 0, 16, 79
"/opt/projects/swiftkube/vendor/k8s.io/client-go/listers/apps/v1beta2/controllerrevision.go", "Go", 84, 0, 0, 0, 0, 0, 16, 100
"/opt/projects/swiftkube/vendor/k8s.io/client-go/listers/apps/v1beta2/daemonset.go", "Go", 84, 0, 0, 0, 0, 0, 16, 100
"/opt/projects/swiftkube/vendor/k8s.io/client-go/listers/apps/v1beta2/daemonset_expansion.go", "Go", 94, 0, 0, 0, 0, 0, 21, 115
"/opt/projects/swiftkube/vendor/k8s.io/client-go/listers/apps/v1beta2/deployment.go", "Go", 84, 0, 0, 0, 0, 0, 16, 100
"/opt/projects/swiftkube/vendor/k8s.io/client-go/listers/apps/v1beta2/expansion_generated.go", "Go", 26, 0, 0, 0, 0, 0, 10, 36
"/opt/projects/swiftkube/vendor/k8s.io/client-go/listers/apps/v1beta2/replicaset.go", "Go", 84, 0, 0, 0, 0, 0, 16, 100
"/opt/projects/swiftkube/vendor/k8s.io/client-go/listers/apps/v1beta2/replicaset_expansion.go", "Go", 60, 0, 0, 0, 0, 0, 15, 75
"/opt/projects/swiftkube/vendor/k8s.io/client-go/listers/apps/v1beta2/statefulset.go", "Go", 84, 0, 0, 0, 0, 0, 16, 100
"/opt/projects/swiftkube/vendor/k8s.io/client-go/listers/apps/v1beta2/statefulset_expansion.go", "Go", 63, 0, 0, 0, 0, 0, 16, 79
"/opt/projects/swiftkube/vendor/k8s.io/client-go/listers/autoscaling/v1/expansion_generated.go", "Go", 20, 0, 0, 0, 0, 0, 8, 28
"/opt/projects/swiftkube/vendor/k8s.io/client-go/listers/autoscaling/v1/horizontalpodautoscaler.go", "Go", 84, 0, 0, 0, 0, 0, 16, 100
"/opt/projects/swiftkube/vendor/k8s.io/client-go/listers/autoscaling/v2/expansion_generated.go", "Go", 20, 0, 0, 0, 0, 0, 8, 28
"/opt/projects/swiftkube/vendor/k8s.io/client-go/listers/autoscaling/v2/horizontalpodautoscaler.go", "Go", 84, 0, 0, 0, 0, 0, 16, 100
"/opt/projects/swiftkube/vendor/k8s.io/client-go/listers/autoscaling/v2beta1/expansion_generated.go", "Go", 20, 0, 0, 0, 0, 0, 8, 28
"/opt/projects/swiftkube/vendor/k8s.io/client-go/listers/autoscaling/v2beta1/horizontalpodautoscaler.go", "Go", 84, 0, 0, 0, 0, 0, 16, 100
"/opt/projects/swiftkube/vendor/k8s.io/client-go/listers/autoscaling/v2beta2/expansion_generated.go", "Go", 20, 0, 0, 0, 0, 0, 8, 28
"/opt/projects/swiftkube/vendor/k8s.io/client-go/listers/autoscaling/v2beta2/horizontalpodautoscaler.go", "Go", 84, 0, 0, 0, 0, 0, 16, 100
"/opt/projects/swiftkube/vendor/k8s.io/client-go/listers/batch/v1/cronjob.go", "Go", 84, 0, 0, 0, 0, 0, 16, 100
"/opt/projects/swiftkube/vendor/k8s.io/client-go/listers/batch/v1/expansion_generated.go", "Go", 20, 0, 0, 0, 0, 0, 8, 28
"/opt/projects/swiftkube/vendor/k8s.io/client-go/listers/batch/v1/job.go", "Go", 84, 0, 0, 0, 0, 0, 16, 100
"/opt/projects/swiftkube/vendor/k8s.io/client-go/listers/batch/v1/job_expansion.go", "Go", 62, 0, 0, 0, 0, 0, 11, 73
"/opt/projects/swiftkube/vendor/k8s.io/client-go/listers/batch/v1beta1/cronjob.go", "Go", 84, 0, 0, 0, 0, 0, 16, 100
"/opt/projects/swiftkube/vendor/k8s.io/client-go/listers/batch/v1beta1/expansion_generated.go", "Go", 20, 0, 0, 0, 0, 0, 8, 28
"/opt/projects/swiftkube/vendor/k8s.io/client-go/listers/certificates/v1/certificatesigningrequest.go", "Go", 57, 0, 0, 0, 0, 0, 12, 69
"/opt/projects/swiftkube/vendor/k8s.io/client-go/listers/certificates/v1/expansion_generated.go", "Go", 17, 0, 0, 0, 0, 0, 7, 24
"/opt/projects/swiftkube/vendor/k8s.io/client-go/listers/certificates/v1alpha1/clustertrustbundle.go", "Go", 57, 0, 0, 0, 0, 0, 12, 69
"/opt/projects/swiftkube/vendor/k8s.io/client-go/listers/certificates/v1alpha1/expansion_generated.go", "Go", 17, 0, 0, 0, 0, 0, 7, 24
"/opt/projects/swiftkube/vendor/k8s.io/client-go/listers/certificates/v1beta1/certificatesigningrequest.go", "Go", 57, 0, 0, 0, 0, 0, 12, 69
"/opt/projects/swiftkube/vendor/k8s.io/client-go/listers/certificates/v1beta1/expansion_generated.go", "Go", 17, 0, 0, 0, 0, 0, 7, 24
"/opt/projects/swiftkube/vendor/k8s.io/client-go/listers/coordination/v1/expansion_generated.go", "Go", 20, 0, 0, 0, 0, 0, 8, 28
"/opt/projects/swiftkube/vendor/k8s.io/client-go/listers/coordination/v1/lease.go", "Go", 84, 0, 0, 0, 0, 0, 16, 100
"/opt/projects/swiftkube/vendor/k8s.io/client-go/listers/coordination/v1beta1/expansion_generated.go", "Go", 20, 0, 0, 0, 0, 0, 8, 28
"/opt/projects/swiftkube/vendor/k8s.io/client-go/listers/coordination/v1beta1/lease.go", "Go", 84, 0, 0, 0, 0, 0, 16, 100
"/opt/projects/swiftkube/vendor/k8s.io/client-go/listers/core/v1/componentstatus.go", "Go", 57, 0, 0, 0, 0, 0, 12, 69
"/opt/projects/swiftkube/vendor/k8s.io/client-go/listers/core/v1/configmap.go", "Go", 84, 0, 0, 0, 0, 0, 16, 100
"/opt/projects/swiftkube/vendor/k8s.io/client-go/listers/core/v1/endpoints.go", "Go", 84, 0, 0, 0, 0, 0, 16, 100
"/opt/projects/swiftkube/vendor/k8s.io/client-go/listers/core/v1/event.go", "Go", 84, 0, 0, 0, 0, 0, 16, 100
"/opt/projects/swiftkube/vendor/k8s.io/client-go/listers/core/v1/expansion_generated.go", "Go", 92, 0, 0, 0, 0, 0, 32, 124
"/opt/projects/swiftkube/vendor/k8s.io/client-go/listers/core/v1/limitrange.go", "Go", 84, 0, 0, 0, 0, 0, 16, 100
"/opt/projects/swiftkube/vendor/k8s.io/client-go/listers/core/v1/namespace.go", "Go", 57, 0, 0, 0, 0, 0, 12, 69
"/opt/projects/swiftkube/vendor/k8s.io/client-go/listers/core/v1/node.go", "Go", 57, 0, 0, 0, 0, 0, 12, 69
"/opt/projects/swiftkube/vendor/k8s.io/client-go/listers/core/v1/persistentvolume.go", "Go", 57, 0, 0, 0, 0, 0, 12, 69
"/opt/projects/swiftkube/vendor/k8s.io/client-go/listers/core/v1/persistentvolumeclaim.go", "Go", 84, 0, 0, 0, 0, 0, 16, 100
"/opt/projects/swiftkube/vendor/k8s.io/client-go/listers/core/v1/pod.go", "Go", 84, 0, 0, 0, 0, 0, 16, 100
"/opt/projects/swiftkube/vendor/k8s.io/client-go/listers/core/v1/podtemplate.go", "Go", 84, 0, 0, 0, 0, 0, 16, 100
"/opt/projects/swiftkube/vendor/k8s.io/client-go/listers/core/v1/replicationcontroller.go", "Go", 84, 0, 0, 0, 0, 0, 16, 100
"/opt/projects/swiftkube/vendor/k8s.io/client-go/listers/core/v1/replicationcontroller_expansion.go", "Go", 52, 0, 0, 0, 0, 0, 15, 67
"/opt/projects/swiftkube/vendor/k8s.io/client-go/listers/core/v1/resourcequota.go", "Go", 84, 0, 0, 0, 0, 0, 16, 100
"/opt/projects/swiftkube/vendor/k8s.io/client-go/listers/core/v1/secret.go", "Go", 84, 0, 0, 0, 0, 0, 16, 100
"/opt/projects/swiftkube/vendor/k8s.io/client-go/listers/core/v1/service.go", "Go", 84, 0, 0, 0, 0, 0, 16, 100
"/opt/projects/swiftkube/vendor/k8s.io/client-go/listers/core/v1/serviceaccount.go", "Go", 84, 0, 0, 0, 0, 0, 16, 100
"/opt/projects/swiftkube/vendor/k8s.io/client-go/listers/discovery/v1/endpointslice.go", "Go", 84, 0, 0, 0, 0, 0, 16, 100
"/opt/projects/swiftkube/vendor/k8s.io/client-go/listers/discovery/v1/expansion_generated.go", "Go", 20, 0, 0, 0, 0, 0, 8, 28
"/opt/projects/swiftkube/vendor/k8s.io/client-go/listers/discovery/v1beta1/endpointslice.go", "Go", 84, 0, 0, 0, 0, 0, 16, 100
"/opt/projects/swiftkube/vendor/k8s.io/client-go/listers/discovery/v1beta1/expansion_generated.go", "Go", 20, 0, 0, 0, 0, 0, 8, 28
"/opt/projects/swiftkube/vendor/k8s.io/client-go/listers/events/v1/event.go", "Go", 84, 0, 0, 0, 0, 0, 16, 100
"/opt/projects/swiftkube/vendor/k8s.io/client-go/listers/events/v1/expansion_generated.go", "Go", 20, 0, 0, 0, 0, 0, 8, 28
"/opt/projects/swiftkube/vendor/k8s.io/client-go/listers/events/v1beta1/event.go", "Go", 84, 0, 0, 0, 0, 0, 16, 100
"/opt/projects/swiftkube/vendor/k8s.io/client-go/listers/events/v1beta1/expansion_generated.go", "Go", 20, 0, 0, 0, 0, 0, 8, 28
"/opt/projects/swiftkube/vendor/k8s.io/client-go/listers/extensions/v1beta1/daemonset.go", "Go", 84, 0, 0, 0, 0, 0, 16, 100
"/opt/projects/swiftkube/vendor/k8s.io/client-go/listers/extensions/v1beta1/daemonset_expansion.go", "Go", 95, 0, 0, 0, 0, 0, 21, 116
"/opt/projects/swiftkube/vendor/k8s.io/client-go/listers/extensions/v1beta1/deployment.go", "Go", 84, 0, 0, 0, 0, 0, 16, 100
"/opt/projects/swiftkube/vendor/k8s.io/client-go/listers/extensions/v1beta1/expansion_generated.go", "Go", 32, 0, 0, 0, 0, 0, 12, 44
"/opt/projects/swiftkube/vendor/k8s.io/client-go/listers/extensions/v1beta1/ingress.go", "Go", 84, 0, 0, 0, 0, 0, 16, 100
"/opt/projects/swiftkube/vendor/k8s.io/client-go/listers/extensions/v1beta1/networkpolicy.go", "Go", 84, 0, 0, 0, 0, 0, 16, 100
"/opt/projects/swiftkube/vendor/k8s.io/client-go/listers/extensions/v1beta1/replicaset.go", "Go", 84, 0, 0, 0, 0, 0, 16, 100
"/opt/projects/swiftkube/vendor/k8s.io/client-go/listers/extensions/v1beta1/replicaset_expansion.go", "Go", 60, 0, 0, 0, 0, 0, 15, 75
"/opt/projects/swiftkube/vendor/k8s.io/client-go/listers/flowcontrol/v1alpha1/expansion_generated.go", "Go", 20, 0, 0, 0, 0, 0, 8, 28
"/opt/projects/swiftkube/vendor/k8s.io/client-go/listers/flowcontrol/v1alpha1/flowschema.go", "Go", 57, 0, 0, 0, 0, 0, 12, 69
"/opt/projects/swiftkube/vendor/k8s.io/client-go/listers/flowcontrol/v1alpha1/prioritylevelconfiguration.go", "Go", 57, 0, 0, 0, 0, 0, 12, 69
"/opt/projects/swiftkube/vendor/k8s.io/client-go/listers/flowcontrol/v1beta1/expansion_generated.go", "Go", 20, 0, 0, 0, 0, 0, 8, 28
"/opt/projects/swiftkube/vendor/k8s.io/client-go/listers/flowcontrol/v1beta1/flowschema.go", "Go", 57, 0, 0, 0, 0, 0, 12, 69
"/opt/projects/swiftkube/vendor/k8s.io/client-go/listers/flowcontrol/v1beta1/prioritylevelconfiguration.go", "Go", 57, 0, 0, 0, 0, 0, 12, 69
"/opt/projects/swiftkube/vendor/k8s.io/client-go/listers/flowcontrol/v1beta2/expansion_generated.go", "Go", 20, 0, 0, 0, 0, 0, 8, 28
"/opt/projects/swiftkube/vendor/k8s.io/client-go/listers/flowcontrol/v1beta2/flowschema.go", "Go", 57, 0, 0, 0, 0, 0, 12, 69
"/opt/projects/swiftkube/vendor/k8s.io/client-go/listers/flowcontrol/v1beta2/prioritylevelconfiguration.go", "Go", 57, 0, 0, 0, 0, 0, 12, 69
"/opt/projects/swiftkube/vendor/k8s.io/client-go/listers/flowcontrol/v1beta3/expansion_generated.go", "Go", 20, 0, 0, 0, 0, 0, 8, 28
"/opt/projects/swiftkube/vendor/k8s.io/client-go/listers/flowcontrol/v1beta3/flowschema.go", "Go", 57, 0, 0, 0, 0, 0, 12, 69
"/opt/projects/swiftkube/vendor/k8s.io/client-go/listers/flowcontrol/v1beta3/prioritylevelconfiguration.go", "Go", 57, 0, 0, 0, 0, 0, 12, 69
"/opt/projects/swiftkube/vendor/k8s.io/client-go/listers/networking/v1/expansion_generated.go", "Go", 29, 0, 0, 0, 0, 0, 11, 40
"/opt/projects/swiftkube/vendor/k8s.io/client-go/listers/networking/v1/ingress.go", "Go", 84, 0, 0, 0, 0, 0, 16, 100
"/opt/projects/swiftkube/vendor/k8s.io/client-go/listers/networking/v1/ingressclass.go", "Go", 57, 0, 0, 0, 0, 0, 12, 69
"/opt/projects/swiftkube/vendor/k8s.io/client-go/listers/networking/v1/networkpolicy.go", "Go", 84, 0, 0, 0, 0, 0, 16, 100
"/opt/projects/swiftkube/vendor/k8s.io/client-go/listers/networking/v1alpha1/clustercidr.go", "Go", 57, 0, 0, 0, 0, 0, 12, 69
"/opt/projects/swiftkube/vendor/k8s.io/client-go/listers/networking/v1alpha1/expansion_generated.go", "Go", 20, 0, 0, 0, 0, 0, 8, 28
"/opt/projects/swiftkube/vendor/k8s.io/client-go/listers/networking/v1alpha1/ipaddress.go", "Go", 57, 0, 0, 0, 0, 0, 12, 69
"/opt/projects/swiftkube/vendor/k8s.io/client-go/listers/networking/v1beta1/expansion_generated.go", "Go", 23, 0, 0, 0, 0, 0, 9, 32
"/opt/projects/swiftkube/vendor/k8s.io/client-go/listers/networking/v1beta1/ingress.go", "Go", 84, 0, 0, 0, 0, 0, 16, 100
"/opt/projects/swiftkube/vendor/k8s.io/client-go/listers/networking/v1beta1/ingressclass.go", "Go", 57, 0, 0, 0, 0, 0, 12, 69
"/opt/projects/swiftkube/vendor/k8s.io/client-go/listers/node/v1/expansion_generated.go", "Go", 17, 0, 0, 0, 0, 0, 7, 24
"/opt/projects/swiftkube/vendor/k8s.io/client-go/listers/node/v1/runtimeclass.go", "Go", 57, 0, 0, 0, 0, 0, 12, 69
"/opt/projects/swiftkube/vendor/k8s.io/client-go/listers/node/v1alpha1/expansion_generated.go", "Go", 17, 0, 0, 0, 0, 0, 7, 24
"/opt/projects/swiftkube/vendor/k8s.io/client-go/listers/node/v1alpha1/runtimeclass.go", "Go", 57, 0, 0, 0, 0, 0, 12, 69
"/opt/projects/swiftkube/vendor/k8s.io/client-go/listers/node/v1beta1/expansion_generated.go", "Go", 17, 0, 0, 0, 0, 0, 7, 24
"/opt/projects/swiftkube/vendor/k8s.io/client-go/listers/node/v1beta1/runtimeclass.go", "Go", 57, 0, 0, 0, 0, 0, 12, 69
"/opt/projects/swiftkube/vendor/k8s.io/client-go/listers/policy/v1/eviction.go", "Go", 84, 0, 0, 0, 0, 0, 16, 100
"/opt/projects/swiftkube/vendor/k8s.io/client-go/listers/policy/v1/expansion_generated.go", "Go", 20, 0, 0, 0, 0, 0, 8, 28
"/opt/projects/swiftkube/vendor/k8s.io/client-go/listers/policy/v1/poddisruptionbudget.go", "Go", 84, 0, 0, 0, 0, 0, 16, 100
"/opt/projects/swiftkube/vendor/k8s.io/client-go/listers/policy/v1/poddisruptionbudget_expansion.go", "Go", 54, 0, 0, 0, 0, 0, 15, 69
"/opt/projects/swiftkube/vendor/k8s.io/client-go/listers/policy/v1beta1/eviction.go", "Go", 84, 0, 0, 0, 0, 0, 16, 100
"/opt/projects/swiftkube/vendor/k8s.io/client-go/listers/policy/v1beta1/expansion_generated.go", "Go", 23, 0, 0, 0, 0, 0, 9, 32
"/opt/projects/swiftkube/vendor/k8s.io/client-go/listers/policy/v1beta1/poddisruptionbudget.go", "Go", 84, 0, 0, 0, 0, 0, 16, 100
"/opt/projects/swiftkube/vendor/k8s.io/client-go/listers/policy/v1beta1/poddisruptionbudget_expansion.go", "Go", 54, 0, 0, 0, 0, 0, 15, 69
"/opt/projects/swiftkube/vendor/k8s.io/client-go/listers/policy/v1beta1/podsecuritypolicy.go", "Go", 57, 0, 0, 0, 0, 0, 12, 69
"/opt/projects/swiftkube/vendor/k8s.io/client-go/listers/rbac/v1/clusterrole.go", "Go", 57, 0, 0, 0, 0, 0, 12, 69
"/opt/projects/swiftkube/vendor/k8s.io/client-go/listers/rbac/v1/clusterrolebinding.go", "Go", 57, 0, 0, 0, 0, 0, 12, 69
"/opt/projects/swiftkube/vendor/k8s.io/client-go/listers/rbac/v1/expansion_generated.go", "Go", 32, 0, 0, 0, 0, 0, 12, 44
"/opt/projects/swiftkube/vendor/k8s.io/client-go/listers/rbac/v1/role.go", "Go", 84, 0, 0, 0, 0, 0, 16, 100
"/opt/projects/swiftkube/vendor/k8s.io/client-go/listers/rbac/v1/rolebinding.go", "Go", 84, 0, 0, 0, 0, 0, 16, 100
"/opt/projects/swiftkube/vendor/k8s.io/client-go/listers/rbac/v1alpha1/clusterrole.go", "Go", 57, 0, 0, 0, 0, 0, 12, 69
"/opt/projects/swiftkube/vendor/k8s.io/client-go/listers/rbac/v1alpha1/clusterrolebinding.go", "Go", 57, 0, 0, 0, 0, 0, 12, 69
"/opt/projects/swiftkube/vendor/k8s.io/client-go/listers/rbac/v1alpha1/expansion_generated.go", "Go", 32, 0, 0, 0, 0, 0, 12, 44
"/opt/projects/swiftkube/vendor/k8s.io/client-go/listers/rbac/v1alpha1/role.go", "Go", 84, 0, 0, 0, 0, 0, 16, 100
"/opt/projects/swiftkube/vendor/k8s.io/client-go/listers/rbac/v1alpha1/rolebinding.go", "Go", 84, 0, 0, 0, 0, 0, 16, 100
"/opt/projects/swiftkube/vendor/k8s.io/client-go/listers/rbac/v1beta1/clusterrole.go", "Go", 57, 0, 0, 0, 0, 0, 12, 69
"/opt/projects/swiftkube/vendor/k8s.io/client-go/listers/rbac/v1beta1/clusterrolebinding.go", "Go", 57, 0, 0, 0, 0, 0, 12, 69
"/opt/projects/swiftkube/vendor/k8s.io/client-go/listers/rbac/v1beta1/expansion_generated.go", "Go", 32, 0, 0, 0, 0, 0, 12, 44
"/opt/projects/swiftkube/vendor/k8s.io/client-go/listers/rbac/v1beta1/role.go", "Go", 84, 0, 0, 0, 0, 0, 16, 100
"/opt/projects/swiftkube/vendor/k8s.io/client-go/listers/rbac/v1beta1/rolebinding.go", "Go", 84, 0, 0, 0, 0, 0, 16, 100
"/opt/projects/swiftkube/vendor/k8s.io/client-go/listers/resource/v1alpha2/expansion_generated.go", "Go", 35, 0, 0, 0, 0, 0, 13, 48
"/opt/projects/swiftkube/vendor/k8s.io/client-go/listers/resource/v1alpha2/podschedulingcontext.go", "Go", 84, 0, 0, 0, 0, 0, 16, 100
"/opt/projects/swiftkube/vendor/k8s.io/client-go/listers/resource/v1alpha2/resourceclaim.go", "Go", 84, 0, 0, 0, 0, 0, 16, 100
"/opt/projects/swiftkube/vendor/k8s.io/client-go/listers/resource/v1alpha2/resourceclaimtemplate.go", "Go", 84, 0, 0, 0, 0, 0, 16, 100
"/opt/projects/swiftkube/vendor/k8s.io/client-go/listers/resource/v1alpha2/resourceclass.go", "Go", 57, 0, 0, 0, 0, 0, 12, 69
"/opt/projects/swiftkube/vendor/k8s.io/client-go/listers/scheduling/v1/expansion_generated.go", "Go", 17, 0, 0, 0, 0, 0, 7, 24
"/opt/projects/swiftkube/vendor/k8s.io/client-go/listers/scheduling/v1/priorityclass.go", "Go", 57, 0, 0, 0, 0, 0, 12, 69
"/opt/projects/swiftkube/vendor/k8s.io/client-go/listers/scheduling/v1alpha1/expansion_generated.go", "Go", 17, 0, 0, 0, 0, 0, 7, 24
"/opt/projects/swiftkube/vendor/k8s.io/client-go/listers/scheduling/v1alpha1/priorityclass.go", "Go", 57, 0, 0, 0, 0, 0, 12, 69
"/opt/projects/swiftkube/vendor/k8s.io/client-go/listers/scheduling/v1beta1/expansion_generated.go", "Go", 17, 0, 0, 0, 0, 0, 7, 24
"/opt/projects/swiftkube/vendor/k8s.io/client-go/listers/scheduling/v1beta1/priorityclass.go", "Go", 57, 0, 0, 0, 0, 0, 12, 69
"/opt/projects/swiftkube/vendor/k8s.io/client-go/listers/storage/v1/csidriver.go", "Go", 57, 0, 0, 0, 0, 0, 12, 69
"/opt/projects/swiftkube/vendor/k8s.io/client-go/listers/storage/v1/csinode.go", "Go", 57, 0, 0, 0, 0, 0, 12, 69
"/opt/projects/swiftkube/vendor/k8s.io/client-go/listers/storage/v1/csistoragecapacity.go", "Go", 84, 0, 0, 0, 0, 0, 16, 100
"/opt/projects/swiftkube/vendor/k8s.io/client-go/listers/storage/v1/expansion_generated.go", "Go", 32, 0, 0, 0, 0, 0, 12, 44
"/opt/projects/swiftkube/vendor/k8s.io/client-go/listers/storage/v1/storageclass.go", "Go", 57, 0, 0, 0, 0, 0, 12, 69
"/opt/projects/swiftkube/vendor/k8s.io/client-go/listers/storage/v1/volumeattachment.go", "Go", 57, 0, 0, 0, 0, 0, 12, 69
"/opt/projects/swiftkube/vendor/k8s.io/client-go/listers/storage/v1alpha1/csistoragecapacity.go", "Go", 84, 0, 0, 0, 0, 0, 16, 100
"/opt/projects/swiftkube/vendor/k8s.io/client-go/listers/storage/v1alpha1/expansion_generated.go", "Go", 23, 0, 0, 0, 0, 0, 9, 32
"/opt/projects/swiftkube/vendor/k8s.io/client-go/listers/storage/v1alpha1/volumeattachment.go", "Go", 57, 0, 0, 0, 0, 0, 12, 69
"/opt/projects/swiftkube/vendor/k8s.io/client-go/listers/storage/v1beta1/csidriver.go", "Go", 57, 0, 0, 0, 0, 0, 12, 69
"/opt/projects/swiftkube/vendor/k8s.io/client-go/listers/storage/v1beta1/csinode.go", "Go", 57, 0, 0, 0, 0, 0, 12, 69
"/opt/projects/swiftkube/vendor/k8s.io/client-go/listers/storage/v1beta1/csistoragecapacity.go", "Go", 84, 0, 0, 0, 0, 0, 16, 100
"/opt/projects/swiftkube/vendor/k8s.io/client-go/listers/storage/v1beta1/expansion_generated.go", "Go", 32, 0, 0, 0, 0, 0, 12, 44
"/opt/projects/swiftkube/vendor/k8s.io/client-go/listers/storage/v1beta1/storageclass.go", "Go", 57, 0, 0, 0, 0, 0, 12, 69
"/opt/projects/swiftkube/vendor/k8s.io/client-go/listers/storage/v1beta1/volumeattachment.go", "Go", 57, 0, 0, 0, 0, 0, 12, 69
"/opt/projects/swiftkube/vendor/k8s.io/client-go/openapi/cached/client.go", "Go", 43, 0, 0, 0, 0, 0, 12, 55
"/opt/projects/swiftkube/vendor/k8s.io/client-go/openapi/cached/groupversion.go", "Go", 44, 0, 0, 0, 0, 0, 15, 59
"/opt/projects/swiftkube/vendor/k8s.io/client-go/openapi/client.go", "Go", 56, 0, 0, 0, 0, 0, 14, 70
"/opt/projects/swiftkube/vendor/k8s.io/client-go/openapi/groupversion.go", "Go", 55, 0, 0, 0, 0, 0, 16, 71
"/opt/projects/swiftkube/vendor/k8s.io/client-go/openapi/typeconverter.go", "Go", 41, 0, 0, 0, 0, 0, 8, 49
"/opt/projects/swiftkube/vendor/k8s.io/client-go/openapi3/root.go", "Go", 164, 0, 0, 0, 0, 0, 19, 183
"/opt/projects/swiftkube/vendor/k8s.io/client-go/pkg/apis/clientauthentication/doc.go", "Go", 15, 0, 0, 0, 0, 0, 6, 21
"/opt/projects/swiftkube/vendor/k8s.io/client-go/pkg/apis/clientauthentication/install/install.go", "Go", 28, 0, 0, 0, 0, 0, 7, 35
"/opt/projects/swiftkube/vendor/k8s.io/client-go/pkg/apis/clientauthentication/register.go", "Go", 39, 0, 0, 0, 0, 0, 12, 51
"/opt/projects/swiftkube/vendor/k8s.io/client-go/pkg/apis/clientauthentication/types.go", "Go", 116, 0, 0, 0, 0, 0, 14, 130
"/opt/projects/swiftkube/vendor/k8s.io/client-go/pkg/apis/clientauthentication/v1/doc.go", "Go", 18, 0, 0, 0, 0, 0, 7, 25
"/opt/projects/swiftkube/vendor/k8s.io/client-go/pkg/apis/clientauthentication/v1/register.go", "Go", 44, 0, 0, 0, 0, 0, 12, 56
"/opt/projects/swiftkube/vendor/k8s.io/client-go/pkg/apis/clientauthentication/v1/types.go", "Go", 114, 0, 0, 0, 0, 0, 14, 128
"/opt/projects/swiftkube/vendor/k8s.io/client-go/pkg/apis/clientauthentication/v1/zz_generated.conversion.go", "Go", 181, 0, 0, 0, 0, 0, 27, 208
"/opt/projects/swiftkube/vendor/k8s.io/client-go/pkg/apis/clientauthentication/v1/zz_generated.deepcopy.go", "Go", 104, 0, 0, 0, 0, 0, 17, 121
"/opt/projects/swiftkube/vendor/k8s.io/client-go/pkg/apis/clientauthentication/v1/zz_generated.defaults.go", "Go", 25, 0, 0, 0, 0, 0, 9, 34
"/opt/projects/swiftkube/vendor/k8s.io/client-go/pkg/apis/clientauthentication/v1beta1/doc.go", "Go", 18, 0, 0, 0, 0, 0, 7, 25
"/opt/projects/swiftkube/vendor/k8s.io/client-go/pkg/apis/clientauthentication/v1beta1/register.go", "Go", 44, 0, 0, 0, 0, 0, 12, 56
"/opt/projects/swiftkube/vendor/k8s.io/client-go/pkg/apis/clientauthentication/v1beta1/types.go", "Go", 114, 0, 0, 0, 0, 0, 14, 128
"/opt/projects/swiftkube/vendor/k8s.io/client-go/pkg/apis/clientauthentication/v1beta1/zz_generated.conversion.go", "Go", 181, 0, 0, 0, 0, 0, 27, 208
"/opt/projects/swiftkube/vendor/k8s.io/client-go/pkg/apis/clientauthentication/v1beta1/zz_generated.deepcopy.go", "Go", 104, 0, 0, 0, 0, 0, 17, 121
"/opt/projects/swiftkube/vendor/k8s.io/client-go/pkg/apis/clientauthentication/v1beta1/zz_generated.defaults.go", "Go", 25, 0, 0, 0, 0, 0, 9, 34
"/opt/projects/swiftkube/vendor/k8s.io/client-go/pkg/apis/clientauthentication/zz_generated.deepcopy.go", "Go", 106, 0, 0, 0, 0, 0, 17, 123
"/opt/projects/swiftkube/vendor/k8s.io/client-go/pkg/version/base.go", "Go", 56, 0, 0, 0, 0, 0, 9, 65
"/opt/projects/swiftkube/vendor/k8s.io/client-go/pkg/version/doc.go", "Go", 16, 0, 0, 0, 0, 0, 6, 22
"/opt/projects/swiftkube/vendor/k8s.io/client-go/pkg/version/version.go", "Go", 35, 0, 0, 0, 0, 0, 8, 43
"/opt/projects/swiftkube/vendor/k8s.io/client-go/plugin/pkg/client/auth/exec/exec.go", "Go", 464, 0, 0, 0, 0, 0, 84, 548
"/opt/projects/swiftkube/vendor/k8s.io/client-go/plugin/pkg/client/auth/exec/metrics.go", "Go", 94, 0, 0, 0, 0, 0, 18, 112
"/opt/projects/swiftkube/vendor/k8s.io/client-go/rest/client.go", "Go", 173, 0, 0, 0, 0, 0, 30, 203
"/opt/projects/swiftkube/vendor/k8s.io/client-go/rest/config.go", "Go", 587, 0, 0, 0, 0, 0, 85, 672
"/opt/projects/swiftkube/vendor/k8s.io/client-go/rest/exec.go", "Go", 74, 0, 0, 0, 0, 0, 13, 87
"/opt/projects/swiftkube/vendor/k8s.io/client-go/rest/fake/fake.go", "Go", 97, 0, 0, 0, 0, 0, 22, 119
"/opt/projects/swiftkube/vendor/k8s.io/client-go/rest/plugin.go", "Go", 69, 0, 0, 0, 0, 0, 16, 85
"/opt/projects/swiftkube/vendor/k8s.io/client-go/rest/request.go", "Go", 1319, 0, 0, 0, 0, 0, 154, 1473
"/opt/projects/swiftkube/vendor/k8s.io/client-go/rest/transport.go", "Go", 139, 0, 0, 0, 0, 0, 17, 156
"/opt/projects/swiftkube/vendor/k8s.io/client-go/rest/url_utils.go", "Go", 82, 0, 0, 0, 0, 0, 16, 98
"/opt/projects/swiftkube/vendor/k8s.io/client-go/rest/urlbackoff.go", "Go", 88, 0, 0, 0, 0, 0, 20, 108
"/opt/projects/swiftkube/vendor/k8s.io/client-go/rest/warnings.go", "Go", 122, 0, 0, 0, 0, 0, 26, 148
"/opt/projects/swiftkube/vendor/k8s.io/client-go/rest/watch/decoder.go", "Go", 61, 0, 0, 0, 0, 0, 12, 73
"/opt/projects/swiftkube/vendor/k8s.io/client-go/rest/watch/encoder.go", "Go", 47, 0, 0, 0, 0, 0, 10, 57
"/opt/projects/swiftkube/vendor/k8s.io/client-go/rest/with_retry.go", "Go", 317, 0, 0, 0, 0, 0, 53, 370
"/opt/projects/swiftkube/vendor/k8s.io/client-go/rest/zz_generated.deepcopy.go", "Go", 50, 0, 0, 0, 0, 0, 9, 59
"/opt/projects/swiftkube/vendor/k8s.io/client-go/restmapper/category_expansion.go", "Go", 101, 0, 0, 0, 0, 0, 19, 120
"/opt/projects/swiftkube/vendor/k8s.io/client-go/restmapper/discovery.go", "Go", 295, 0, 0, 0, 0, 0, 44, 339
"/opt/projects/swiftkube/vendor/k8s.io/client-go/restmapper/shortcut.go", "Go", 161, 0, 0, 0, 0, 0, 27, 188
"/opt/projects/swiftkube/vendor/k8s.io/client-go/scale/client.go", "Go", 199, 0, 0, 0, 0, 0, 40, 239
"/opt/projects/swiftkube/vendor/k8s.io/client-go/scale/doc.go", "Go", 17, 0, 0, 0, 0, 0, 5, 22
"/opt/projects/swiftkube/vendor/k8s.io/client-go/scale/interfaces.go", "Go", 37, 0, 0, 0, 0, 0, 11, 48
"/opt/projects/swiftkube/vendor/k8s.io/client-go/scale/scheme/appsint/doc.go", "Go", 18, 0, 0, 0, 0, 0, 5, 23
"/opt/projects/swiftkube/vendor/k8s.io/client-go/scale/scheme/appsint/register.go", "Go", 44, 0, 0, 0, 0, 0, 12, 56
"/opt/projects/swiftkube/vendor/k8s.io/client-go/scale/scheme/appsv1beta1/conversion.go", "Go", 61, 0, 0, 0, 0, 0, 13, 74
"/opt/projects/swiftkube/vendor/k8s.io/client-go/scale/scheme/appsv1beta1/doc.go", "Go", 15, 0, 0, 0, 0, 0, 6, 21
"/opt/projects/swiftkube/vendor/k8s.io/client-go/scale/scheme/appsv1beta1/register.go", "Go", 35, 0, 0, 0, 0, 0, 11, 46
"/opt/projects/swiftkube/vendor/k8s.io/client-go/scale/scheme/appsv1beta1/zz_generated.conversion.go", "Go", 115, 0, 0, 0, 0, 0, 20, 135
"/opt/projects/swiftkube/vendor/k8s.io/client-go/scale/scheme/appsv1beta2/conversion.go", "Go", 61, 0, 0, 0, 0, 0, 13, 74
"/opt/projects/swiftkube/vendor/k8s.io/client-go/scale/scheme/appsv1beta2/doc.go", "Go", 15, 0, 0, 0, 0, 0, 6, 21
"/opt/projects/swiftkube/vendor/k8s.io/client-go/scale/scheme/appsv1beta2/register.go", "Go", 35, 0, 0, 0, 0, 0, 11, 46
"/opt/projects/swiftkube/vendor/k8s.io/client-go/scale/scheme/appsv1beta2/zz_generated.conversion.go", "Go", 115, 0, 0, 0, 0, 0, 20, 135
"/opt/projects/swiftkube/vendor/k8s.io/client-go/scale/scheme/autoscalingv1/conversion.go", "Go", 44, 0, 0, 0, 0, 0, 11, 55
"/opt/projects/swiftkube/vendor/k8s.io/client-go/scale/scheme/autoscalingv1/doc.go", "Go", 15, 0, 0, 0, 0, 0, 6, 21
"/opt/projects/swiftkube/vendor/k8s.io/client-go/scale/scheme/autoscalingv1/register.go", "Go", 35, 0, 0, 0, 0, 0, 11, 46
"/opt/projects/swiftkube/vendor/k8s.io/client-go/scale/scheme/autoscalingv1/zz_generated.conversion.go", "Go", 114, 0, 0, 0, 0, 0, 20, 134
"/opt/projects/swiftkube/vendor/k8s.io/client-go/scale/scheme/doc.go", "Go", 17, 0, 0, 0, 0, 0, 6, 23
"/opt/projects/swiftkube/vendor/k8s.io/client-go/scale/scheme/extensionsint/doc.go", "Go", 18, 0, 0, 0, 0, 0, 5, 23
"/opt/projects/swiftkube/vendor/k8s.io/client-go/scale/scheme/extensionsint/register.go", "Go", 44, 0, 0, 0, 0, 0, 12, 56
"/opt/projects/swiftkube/vendor/k8s.io/client-go/scale/scheme/extensionsv1beta1/conversion.go", "Go", 61, 0, 0, 0, 0, 0, 13, 74
"/opt/projects/swiftkube/vendor/k8s.io/client-go/scale/scheme/extensionsv1beta1/doc.go", "Go", 15, 0, 0, 0, 0, 0, 6, 21
"/opt/projects/swiftkube/vendor/k8s.io/client-go/scale/scheme/extensionsv1beta1/register.go", "Go", 35, 0, 0, 0, 0, 0, 11, 46
"/opt/projects/swiftkube/vendor/k8s.io/client-go/scale/scheme/extensionsv1beta1/zz_generated.conversion.go", "Go", 115, 0, 0, 0, 0, 0, 20, 135
"/opt/projects/swiftkube/vendor/k8s.io/client-go/scale/scheme/register.go", "Go", 43, 0, 0, 0, 0, 0, 12, 55
"/opt/projects/swiftkube/vendor/k8s.io/client-go/scale/scheme/types.go", "Go", 47, 0, 0, 0, 0, 0, 14, 61
"/opt/projects/swiftkube/vendor/k8s.io/client-go/scale/scheme/zz_generated.deepcopy.go", "Go", 78, 0, 0, 0, 0, 0, 15, 93
"/opt/projects/swiftkube/vendor/k8s.io/client-go/scale/util.go", "Go", 166, 0, 0, 0, 0, 0, 32, 198
"/opt/projects/swiftkube/vendor/k8s.io/client-go/testing/actions.go", "Go", 582, 0, 0, 0, 0, 0, 117, 699
"/opt/projects/swiftkube/vendor/k8s.io/client-go/testing/fake.go", "Go", 181, 0, 0, 0, 0, 0, 40, 221
"/opt/projects/swiftkube/vendor/k8s.io/client-go/testing/fixture.go", "Go", 488, 0, 0, 0, 0, 0, 94, 582
"/opt/projects/swiftkube/vendor/k8s.io/client-go/testing/interface.go", "Go", 49, 0, 0, 0, 0, 0, 18, 67
"/opt/projects/swiftkube/vendor/k8s.io/client-go/third_party/forked/golang/template/exec.go", "Go", 47, 0, 0, 0, 0, 0, 6, 53
"/opt/projects/swiftkube/vendor/k8s.io/client-go/third_party/forked/golang/template/funcs.go", "Go", 166, 0, 0, 0, 0, 0, 12, 178
"/opt/projects/swiftkube/vendor/k8s.io/client-go/tools/auth/clientauth.go", "Go", 107, 0, 0, 0, 0, 0, 19, 126
"/opt/projects/swiftkube/vendor/k8s.io/client-go/tools/cache/controller.go", "Go", 456, 0, 0, 0, 0, 0, 60, 516
"/opt/projects/swiftkube/vendor/k8s.io/client-go/tools/cache/delta_fifo.go", "Go", 723, 0, 0, 0, 0, 0, 81, 804
"/opt/projects/swiftkube/vendor/k8s.io/client-go/tools/cache/doc.go", "Go", 20, 0, 0, 0, 0, 0, 5, 25
"/opt/projects/swiftkube/vendor/k8s.io/client-go/tools/cache/expiration_cache.go", "Go", 187, 0, 0, 0, 0, 0, 28, 215
"/opt/projects/swiftkube/vendor/k8s.io/client-go/tools/cache/expiration_cache_fakes.go", "Go", 47, 0, 0, 0, 0, 0, 11, 58
"/opt/projects/swiftkube/vendor/k8s.io/client-go/tools/cache/fake_custom_store.go", "Go", 88, 0, 0, 0, 0, 0, 15, 103
"/opt/projects/swiftkube/vendor/k8s.io/client-go/tools/cache/fifo.go", "Go", 338, 0, 0, 0, 0, 0, 45, 383
"/opt/projects/swiftkube/vendor/k8s.io/client-go/tools/cache/heap.go", "Go", 286, 0, 0, 0, 0, 0, 37, 323
"/opt/projects/swiftkube/vendor/k8s.io/client-go/tools/cache/index.go", "Go", 86, 0, 0, 0, 0, 0, 16, 102
"/opt/projects/swiftkube/vendor/k8s.io/client-go/tools/cache/listers.go", "Go", 146, 0, 0, 0, 0, 0, 24, 170
"/opt/projects/swiftkube/vendor/k8s.io/client-go/tools/cache/listwatch.go", "Go", 95, 0, 0, 0, 0, 0, 18, 113
"/opt/projects/swiftkube/vendor/k8s.io/client-go/tools/cache/mutation_cache.go", "Go", 236, 0, 0, 0, 0, 0, 27, 263
"/opt/projects/swiftkube/vendor/k8s.io/client-go/tools/cache/mutation_detector.go", "Go", 136, 0, 0, 0, 0, 0, 31, 167
"/opt/projects/swiftkube/vendor/k8s.io/client-go/tools/cache/object-names.go", "Go", 53, 0, 0, 0, 0, 0, 13, 66
"/opt/projects/swiftkube/vendor/k8s.io/client-go/tools/cache/reflector.go", "Go", 828, 0, 0, 0, 0, 0, 75, 903
"/opt/projects/swiftkube/vendor/k8s.io/client-go/tools/cache/reflector_metrics.go", "Go", 71, 0, 0, 0, 0, 0, 19, 90
"/opt/projects/swiftkube/vendor/k8s.io/client-go/tools/cache/retry_with_deadline.go", "Go", 64, 0, 0, 0, 0, 0, 15, 79
"/opt/projects/swiftkube/vendor/k8s.io/client-go/tools/cache/shared_informer.go", "Go", 874, 0, 0, 0, 0, 0, 141, 1015
"/opt/projects/swiftkube/vendor/k8s.io/client-go/tools/cache/store.go", "Go", 250, 0, 0, 0, 0, 0, 46, 296
"/opt/projects/swiftkube/vendor/k8s.io/client-go/tools/cache/synctrack/lazy.go", "Go", 70, 0, 0, 0, 0, 0, 14, 84
"/opt/projects/swiftkube/vendor/k8s.io/client-go/tools/cache/synctrack/synctrack.go", "Go", 104, 0, 0, 0, 0, 0, 17, 121
"/opt/projects/swiftkube/vendor/k8s.io/client-go/tools/cache/thread_safe_store.go", "Go", 310, 0, 0, 0, 0, 0, 54, 364
"/opt/projects/swiftkube/vendor/k8s.io/client-go/tools/cache/undelta_store.go", "Go", 78, 0, 0, 0, 0, 0, 12, 90
"/opt/projects/swiftkube/vendor/k8s.io/client-go/tools/clientcmd/api/doc.go", "Go", 14, 0, 0, 0, 0, 0, 6, 20
"/opt/projects/swiftkube/vendor/k8s.io/client-go/tools/clientcmd/api/helpers.go", "Go", 227, 0, 0, 0, 0, 0, 40, 267
"/opt/projects/swiftkube/vendor/k8s.io/client-go/tools/clientcmd/api/latest/latest.go", "Go", 50, 0, 0, 0, 0, 0, 12, 62
"/opt/projects/swiftkube/vendor/k8s.io/client-go/tools/clientcmd/api/register.go", "Go", 37, 0, 0, 0, 0, 0, 10, 47
"/opt/projects/swiftkube/vendor/k8s.io/client-go/tools/clientcmd/api/types.go", "Go", 340, 0, 0, 0, 0, 0, 36, 376
"/opt/projects/swiftkube/vendor/k8s.io/client-go/tools/clientcmd/api/v1/conversion.go", "Go", 156, 0, 0, 0, 0, 0, 19, 175
"/opt/projects/swiftkube/vendor/k8s.io/client-go/tools/clientcmd/api/v1/defaults.go", "Go", 30, 0, 0, 0, 0, 0, 8, 38
"/opt/projects/swiftkube/vendor/k8s.io/client-go/tools/clientcmd/api/v1/doc.go", "Go", 16, 0, 0, 0, 0, 0, 6, 22
"/opt/projects/swiftkube/vendor/k8s.io/client-go/tools/clientcmd/api/v1/register.go", "Go", 46, 0, 0, 0, 0, 0, 11, 57
"/opt/projects/swiftkube/vendor/k8s.io/client-go/tools/clientcmd/api/v1/types.go", "Go", 247, 0, 0, 0, 0, 0, 25, 272
"/opt/projects/swiftkube/vendor/k8s.io/client-go/tools/clientcmd/api/v1/zz_generated.conversion.go", "Go", 416, 0, 0, 0, 0, 0, 43, 459
"/opt/projects/swiftkube/vendor/k8s.io/client-go/tools/clientcmd/api/v1/zz_generated.deepcopy.go", "Go", 317, 0, 0, 0, 0, 0, 33, 350
"/opt/projects/swiftkube/vendor/k8s.io/client-go/tools/clientcmd/api/v1/zz_generated.defaults.go", "Go", 34, 0, 0, 0, 0, 0, 10, 44
"/opt/projects/swiftkube/vendor/k8s.io/client-go/tools/clientcmd/api/zz_generated.deepcopy.go", "Go", 304, 0, 0, 0, 0, 0, 25, 329
"/opt/projects/swiftkube/vendor/k8s.io/client-go/tools/clientcmd/auth_loaders.go", "Go", 94, 0, 0, 0, 0, 0, 17, 111
"/opt/projects/swiftkube/vendor/k8s.io/client-go/tools/clientcmd/client_config.go", "Go", 556, 0, 0, 0, 0, 0, 83, 639
"/opt/projects/swiftkube/vendor/k8s.io/client-go/tools/clientcmd/config.go", "Go", 419, 0, 0, 0, 0, 0, 82, 501
"/opt/projects/swiftkube/vendor/k8s.io/client-go/tools/clientcmd/doc.go", "Go", 29, 0, 0, 0, 0, 0, 9, 38
"/opt/projects/swiftkube/vendor/k8s.io/client-go/tools/clientcmd/flag.go", "Go", 40, 0, 0, 0, 0, 0, 10, 50
"/opt/projects/swiftkube/vendor/k8s.io/client-go/tools/clientcmd/helpers.go", "Go", 42, 0, 0, 0, 0, 0, 9, 51
"/opt/projects/swiftkube/vendor/k8s.io/client-go/tools/clientcmd/loader.go", "Go", 571, 0, 0, 0, 0, 0, 99, 670
"/opt/projects/swiftkube/vendor/k8s.io/client-go/tools/clientcmd/merged_client_builder.go", "Go", 143, 0, 0, 0, 0, 0, 30, 173
"/opt/projects/swiftkube/vendor/k8s.io/client-go/tools/clientcmd/overrides.go", "Go", 233, 0, 0, 0, 0, 0, 31, 264
"/opt/projects/swiftkube/vendor/k8s.io/client-go/tools/clientcmd/validation.go", "Go", 315, 0, 0, 0, 0, 0, 57, 372
"/opt/projects/swiftkube/vendor/k8s.io/client-go/tools/events/doc.go", "Go", 15, 0, 0, 0, 0, 0, 5, 20
"/opt/projects/swiftkube/vendor/k8s.io/client-go/tools/events/event_broadcaster.go", "Go", 395, 0, 0, 0, 0, 0, 36, 431
"/opt/projects/swiftkube/vendor/k8s.io/client-go/tools/events/event_recorder.go", "Go", 82, 0, 0, 0, 0, 0, 11, 93
"/opt/projects/swiftkube/vendor/k8s.io/client-go/tools/events/fake.go", "Go", 36, 0, 0, 0, 0, 0, 10, 46
"/opt/projects/swiftkube/vendor/k8s.io/client-go/tools/events/helper.go", "Go", 50, 0, 0, 0, 0, 0, 15, 65
"/opt/projects/swiftkube/vendor/k8s.io/client-go/tools/events/interfaces.go", "Go", 79, 0, 0, 0, 0, 0, 17, 96
"/opt/projects/swiftkube/vendor/k8s.io/client-go/tools/metrics/metrics.go", "Go", 172, 0, 0, 0, 0, 0, 40, 212
"/opt/projects/swiftkube/vendor/k8s.io/client-go/tools/pager/pager.go", "Go", 257, 0, 0, 0, 0, 0, 33, 290
"/opt/projects/swiftkube/vendor/k8s.io/client-go/tools/portforward/doc.go", "Go", 15, 0, 0, 0, 0, 0, 5, 20
"/opt/projects/swiftkube/vendor/k8s.io/client-go/tools/portforward/portforward.go", "Go", 384, 0, 0, 0, 0, 0, 56, 440
"/opt/projects/swiftkube/vendor/k8s.io/client-go/tools/record/doc.go", "Go", 15, 0, 0, 0, 0, 0, 5, 20
"/opt/projects/swiftkube/vendor/k8s.io/client-go/tools/record/event.go", "Go", 362, 0, 0, 0, 0, 0, 49, 411
"/opt/projects/swiftkube/vendor/k8s.io/client-go/tools/record/events_cache.go", "Go", 453, 0, 0, 0, 0, 0, 73, 526
"/opt/projects/swiftkube/vendor/k8s.io/client-go/tools/record/fake.go", "Go", 62, 0, 0, 0, 0, 0, 16, 78
"/opt/projects/swiftkube/vendor/k8s.io/client-go/tools/record/util/util.go", "Go", 31, 0, 0, 0, 0, 0, 10, 41
"/opt/projects/swiftkube/vendor/k8s.io/client-go/tools/reference/ref.go", "Go", 94, 0, 0, 0, 0, 0, 16, 110
"/opt/projects/swiftkube/vendor/k8s.io/client-go/tools/remotecommand/doc.go", "Go", 16, 0, 0, 0, 0, 0, 5, 21
"/opt/projects/swiftkube/vendor/k8s.io/client-go/tools/remotecommand/errorstream.go", "Go", 43, 0, 0, 0, 0, 0, 12, 55
"/opt/projects/swiftkube/vendor/k8s.io/client-go/tools/remotecommand/reader.go", "Go", 34, 0, 0, 0, 0, 0, 8, 42
"/opt/projects/swiftkube/vendor/k8s.io/client-go/tools/remotecommand/remotecommand.go", "Go", 156, 0, 0, 0, 0, 0, 27, 183
"/opt/projects/swiftkube/vendor/k8s.io/client-go/tools/remotecommand/resize.go", "Go", 26, 0, 0, 0, 0, 0, 8, 34
"/opt/projects/swiftkube/vendor/k8s.io/client-go/tools/remotecommand/v1.go", "Go", 135, 0, 0, 0, 0, 0, 25, 160
"/opt/projects/swiftkube/vendor/k8s.io/client-go/tools/remotecommand/v2.go", "Go", 163, 0, 0, 0, 0, 0, 37, 200
"/opt/projects/swiftkube/vendor/k8s.io/client-go/tools/remotecommand/v3.go", "Go", 87, 0, 0, 0, 0, 0, 25, 112
"/opt/projects/swiftkube/vendor/k8s.io/client-go/tools/remotecommand/v4.go", "Go", 95, 0, 0, 0, 0, 0, 25, 120
"/opt/projects/swiftkube/vendor/k8s.io/client-go/tools/watch/informerwatcher.go", "Go", 126, 0, 0, 0, 0, 0, 25, 151
"/opt/projects/swiftkube/vendor/k8s.io/client-go/tools/watch/retrywatcher.go", "Go", 252, 0, 0, 0, 0, 0, 44, 296
"/opt/projects/swiftkube/vendor/k8s.io/client-go/tools/watch/until.go", "Go", 146, 0, 0, 0, 0, 0, 23, 169
"/opt/projects/swiftkube/vendor/k8s.io/client-go/transport/cache.go", "Go", 151, 0, 0, 0, 0, 0, 28, 179
"/opt/projects/swiftkube/vendor/k8s.io/client-go/transport/cache_go118.go", "Go", 17, 0, 0, 0, 0, 0, 8, 25
"/opt/projects/swiftkube/vendor/k8s.io/client-go/transport/cert_rotation.go", "Go", 137, 0, 0, 0, 0, 0, 40, 177
"/opt/projects/swiftkube/vendor/k8s.io/client-go/transport/config.go", "Go", 130, 0, 0, 0, 0, 0, 31, 161
"/opt/projects/swiftkube/vendor/k8s.io/client-go/transport/round_trippers.go", "Go", 614, 0, 0, 0, 0, 0, 84, 698
"/opt/projects/swiftkube/vendor/k8s.io/client-go/transport/spdy/spdy.go", "Go", 90, 0, 0, 0, 0, 0, 14, 104
"/opt/projects/swiftkube/vendor/k8s.io/client-go/transport/token_source.go", "Go", 171, 0, 0, 0, 0, 0, 31, 202
"/opt/projects/swiftkube/vendor/k8s.io/client-go/transport/transport.go", "Go", 298, 0, 0, 0, 0, 0, 47, 345
"/opt/projects/swiftkube/vendor/k8s.io/client-go/util/cert/cert.go", "Go", 202, 0, 0, 0, 0, 0, 29, 231
"/opt/projects/swiftkube/vendor/k8s.io/client-go/util/cert/csr.go", "Go", 63, 0, 0, 0, 0, 0, 13, 76
"/opt/projects/swiftkube/vendor/k8s.io/client-go/util/cert/io.go", "Go", 94, 0, 0, 0, 0, 0, 19, 113
"/opt/projects/swiftkube/vendor/k8s.io/client-go/util/cert/pem.go", "Go", 62, 0, 0, 0, 0, 0, 12, 74
"/opt/projects/swiftkube/vendor/k8s.io/client-go/util/cert/server_inspection.go", "Go", 88, 0, 0, 0, 0, 0, 15, 103
"/opt/projects/swiftkube/vendor/k8s.io/client-go/util/certificate/certificate_manager.go", "Go", 691, 0, 0, 0, 0, 0, 85, 776
"/opt/projects/swiftkube/vendor/k8s.io/client-go/util/certificate/certificate_store.go", "Go", 282, 0, 0, 0, 0, 0, 37, 319
"/opt/projects/swiftkube/vendor/k8s.io/client-go/util/certificate/csr/csr.go", "Go", 329, 0, 0, 0, 0, 0, 36, 365
"/opt/projects/swiftkube/vendor/k8s.io/client-go/util/connrotation/connrotation.go", "Go", 112, 0, 0, 0, 0, 0, 22, 134
"/opt/projects/swiftkube/vendor/k8s.io/client-go/util/csaupgrade/upgrade.go", "Go", 277, 0, 0, 0, 0, 0, 45, 322
"/opt/projects/swiftkube/vendor/k8s.io/client-go/util/exec/exec.go", "Go", 41, 0, 0, 0, 0, 0, 12, 53
"/opt/projects/swiftkube/vendor/k8s.io/client-go/util/flowcontrol/backoff.go", "Go", 156, 0, 0, 0, 0, 0, 26, 182
"/opt/projects/swiftkube/vendor/k8s.io/client-go/util/flowcontrol/throttle.go", "Go", 153, 0, 0, 0, 0, 0, 40, 193
"/opt/projects/swiftkube/vendor/k8s.io/client-go/util/homedir/homedir.go", "Go", 80, 0, 0, 0, 0, 0, 13, 93
"/opt/projects/swiftkube/vendor/k8s.io/client-go/util/jsonpath/doc.go", "Go", 16, 0, 0, 0, 0, 0, 5, 21
"/opt/projects/swiftkube/vendor/k8s.io/client-go/util/jsonpath/jsonpath.go", "Go", 531, 0, 0, 0, 0, 0, 49, 580
"/opt/projects/swiftkube/vendor/k8s.io/client-go/util/jsonpath/node.go", "Go", 207, 0, 0, 0, 0, 0, 50, 257
"/opt/projects/swiftkube/vendor/k8s.io/client-go/util/jsonpath/parser.go", "Go", 480, 0, 0, 0, 0, 0, 48, 528
"/opt/projects/swiftkube/vendor/k8s.io/client-go/util/keyutil/key.go", "Go", 282, 0, 0, 0, 0, 0, 41, 323
"/opt/projects/swiftkube/vendor/k8s.io/client-go/util/retry/util.go", "Go", 95, 0, 0, 0, 0, 0, 11, 106
"/opt/projects/swiftkube/vendor/k8s.io/client-go/util/workqueue/default_rate_limiters.go", "Go", 186, 0, 0, 0, 0, 0, 53, 239
"/opt/projects/swiftkube/vendor/k8s.io/client-go/util/workqueue/delaying_queue.go", "Go", 269, 0, 0, 0, 0, 0, 57, 326
"/opt/projects/swiftkube/vendor/k8s.io/client-go/util/workqueue/doc.go", "Go", 22, 0, 0, 0, 0, 0, 5, 27
"/opt/projects/swiftkube/vendor/k8s.io/client-go/util/workqueue/metrics.go", "Go", 216, 0, 0, 0, 0, 0, 51, 267
"/opt/projects/swiftkube/vendor/k8s.io/client-go/util/workqueue/parallelizer.go", "Go", 87, 0, 0, 0, 0, 0, 15, 102
"/opt/projects/swiftkube/vendor/k8s.io/client-go/util/workqueue/queue.go", "Go", 272, 0, 0, 0, 0, 0, 57, 329
"/opt/projects/swiftkube/vendor/k8s.io/client-go/util/workqueue/rate_limiting_queue.go", "Go", 94, 0, 0, 0, 0, 0, 26, 120
"/opt/projects/swiftkube/vendor/k8s.io/cloud-provider/api/retry_error.go", "Go", 37, 0, 0, 0, 0, 0, 10, 47
"/opt/projects/swiftkube/vendor/k8s.io/cloud-provider/api/well_known_annotations.go", "Go", 21, 0, 0, 0, 0, 0, 6, 27
"/opt/projects/swiftkube/vendor/k8s.io/cloud-provider/api/well_known_taints.go", "Go", 22, 0, 0, 0, 0, 0, 7, 29
"/opt/projects/swiftkube/vendor/k8s.io/cloud-provider/app/config/config.go", "Go", 62, 0, 0, 0, 0, 0, 22, 84
"/opt/projects/swiftkube/vendor/k8s.io/cloud-provider/cloud.go", "Go", 298, 0, 0, 0, 0, 0, 27, 325
"/opt/projects/swiftkube/vendor/k8s.io/cloud-provider/config/doc.go", "Go", 15, 0, 0, 0, 0, 0, 6, 21
"/opt/projects/swiftkube/vendor/k8s.io/cloud-provider/config/install/install.go", "Go", 36, 0, 0, 0, 0, 0, 9, 45
"/opt/projects/swiftkube/vendor/k8s.io/cloud-provider/config/register.go", "Go", 34, 0, 0, 0, 0, 0, 9, 43
"/opt/projects/swiftkube/vendor/k8s.io/cloud-provider/config/types.go", "Go", 88, 0, 0, 0, 0, 0, 16, 104
"/opt/projects/swiftkube/vendor/k8s.io/cloud-provider/config/v1alpha1/conversion.go", "Go", 39, 0, 0, 0, 0, 0, 11, 50
"/opt/projects/swiftkube/vendor/k8s.io/cloud-provider/config/v1alpha1/defaults.go", "Go", 60, 0, 0, 0, 0, 0, 12, 72
"/opt/projects/swiftkube/vendor/k8s.io/cloud-provider/config/v1alpha1/doc.go", "Go", 26, 0, 0, 0, 0, 0, 7, 33
"/opt/projects/swiftkube/vendor/k8s.io/cloud-provider/config/v1alpha1/register.go", "Go", 43, 0, 0, 0, 0, 0, 10, 53
"/opt/projects/swiftkube/vendor/k8s.io/cloud-provider/config/v1alpha1/types.go", "Go", 90, 0, 0, 0, 0, 0, 12, 102
"/opt/projects/swiftkube/vendor/k8s.io/cloud-provider/config/v1alpha1/zz_generated.conversion.go", "Go", 184, 0, 0, 0, 0, 0, 23, 207
"/opt/projects/swiftkube/vendor/k8s.io/cloud-provider/config/v1alpha1/zz_generated.deepcopy.go", "Go", 103, 0, 0, 0, 0, 0, 17, 120
"/opt/projects/swiftkube/vendor/k8s.io/cloud-provider/config/v1alpha1/zz_generated.defaults.go", "Go", 32, 0, 0, 0, 0, 0, 10, 42
"/opt/projects/swiftkube/vendor/k8s.io/cloud-provider/config/zz_generated.deepcopy.go", "Go", 98, 0, 0, 0, 0, 0, 17, 115
"/opt/projects/swiftkube/vendor/k8s.io/cloud-provider/controllers/node/config/types.go", "Go", 19, 0, 0, 0, 0, 0, 6, 25
"/opt/projects/swiftkube/vendor/k8s.io/cloud-provider/controllers/node/config/v1alpha1/conversion.go", "Go", 31, 0, 0, 0, 0, 0, 9, 40
"/opt/projects/swiftkube/vendor/k8s.io/cloud-provider/controllers/node/config/v1alpha1/defaults.go", "Go", 18, 0, 0, 0, 0, 0, 6, 24
"/opt/projects/swiftkube/vendor/k8s.io/cloud-provider/controllers/node/config/v1alpha1/doc.go", "Go", 16, 0, 0, 0, 0, 0, 6, 22
"/opt/projects/swiftkube/vendor/k8s.io/cloud-provider/controllers/node/config/v1alpha1/register.go", "Go", 25, 0, 0, 0, 0, 0, 7, 32
"/opt/projects/swiftkube/vendor/k8s.io/cloud-provider/controllers/node/config/v1alpha1/types.go", "Go", 19, 0, 0, 0, 0, 0, 6, 25
"/opt/projects/swiftkube/vendor/k8s.io/cloud-provider/controllers/node/config/v1alpha1/zz_generated.conversion.go", "Go", 47, 0, 0, 0, 0, 0, 12, 59
"/opt/projects/swiftkube/vendor/k8s.io/cloud-provider/controllers/node/config/v1alpha1/zz_generated.deepcopy.go", "Go", 30, 0, 0, 0, 0, 0, 9, 39
"/opt/projects/swiftkube/vendor/k8s.io/cloud-provider/controllers/service/config/doc.go", "Go", 14, 0, 0, 0, 0, 0, 6, 20
"/opt/projects/swiftkube/vendor/k8s.io/cloud-provider/controllers/service/config/types.go", "Go", 20, 0, 0, 0, 0, 0, 6, 26
"/opt/projects/swiftkube/vendor/k8s.io/cloud-provider/controllers/service/config/v1alpha1/conversion.go", "Go", 31, 0, 0, 0, 0, 0, 9, 40
"/opt/projects/swiftkube/vendor/k8s.io/cloud-provider/controllers/service/config/v1alpha1/defaults.go", "Go", 27, 0, 0, 0, 0, 0, 6, 33
"/opt/projects/swiftkube/vendor/k8s.io/cloud-provider/controllers/service/config/v1alpha1/doc.go", "Go", 16, 0, 0, 0, 0, 0, 6, 22
"/opt/projects/swiftkube/vendor/k8s.io/cloud-provider/controllers/service/config/v1alpha1/register.go", "Go", 25, 0, 0, 0, 0, 0, 7, 32
"/opt/projects/swiftkube/vendor/k8s.io/cloud-provider/controllers/service/config/v1alpha1/types.go", "Go", 20, 0, 0, 0, 0, 0, 6, 26
"/opt/projects/swiftkube/vendor/k8s.io/cloud-provider/controllers/service/config/v1alpha1/zz_generated.conversion.go", "Go", 47, 0, 0, 0, 0, 0, 12, 59
"/opt/projects/swiftkube/vendor/k8s.io/cloud-provider/controllers/service/config/v1alpha1/zz_generated.deepcopy.go", "Go", 30, 0, 0, 0, 0, 0, 9, 39
"/opt/projects/swiftkube/vendor/k8s.io/cloud-provider/controllers/service/config/zz_generated.deepcopy.go", "Go", 30, 0, 0, 0, 0, 0, 9, 39
"/opt/projects/swiftkube/vendor/k8s.io/cloud-provider/credentialconfig/registry.go", "Go", 24, 0, 0, 0, 0, 0, 8, 32
"/opt/projects/swiftkube/vendor/k8s.io/cloud-provider/doc.go", "Go", 14, 0, 0, 0, 0, 0, 5, 19
"/opt/projects/swiftkube/vendor/k8s.io/cloud-provider/names/controller_names.go", "Go", 62, 0, 0, 0, 0, 0, 8, 70
"/opt/projects/swiftkube/vendor/k8s.io/cloud-provider/node/helpers/address.go", "Go", 128, 0, 0, 0, 0, 0, 19, 147
"/opt/projects/swiftkube/vendor/k8s.io/cloud-provider/node/helpers/labels.go", "Go", 91, 0, 0, 0, 0, 0, 13, 104
"/opt/projects/swiftkube/vendor/k8s.io/cloud-provider/node/helpers/taints.go", "Go", 217, 0, 0, 0, 0, 0, 29, 246
"/opt/projects/swiftkube/vendor/k8s.io/cloud-provider/options/cloudprovider.go", "Go", 42, 0, 0, 0, 0, 0, 13, 55
"/opt/projects/swiftkube/vendor/k8s.io/cloud-provider/options/kubecloudshared.go", "Go", 90, 0, 0, 0, 0, 0, 21, 111
"/opt/projects/swiftkube/vendor/k8s.io/cloud-provider/options/nodecontroller.go", "Go", 48, 0, 0, 0, 0, 0, 15, 63
"/opt/projects/swiftkube/vendor/k8s.io/cloud-provider/options/options.go", "Go", 260, 0, 0, 0, 0, 0, 48, 308
"/opt/projects/swiftkube/vendor/k8s.io/cloud-provider/options/servicecontroller.go", "Go", 44, 0, 0, 0, 0, 0, 14, 58
"/opt/projects/swiftkube/vendor/k8s.io/cloud-provider/options/webhook.go", "Go", 166, 0, 0, 0, 0, 0, 41, 207
"/opt/projects/swiftkube/vendor/k8s.io/cloud-provider/plugins.go", "Go", 147, 0, 0, 0, 0, 0, 27, 174
"/opt/projects/swiftkube/vendor/k8s.io/cloud-provider/ports.go", "Go", 18, 0, 0, 0, 0, 0, 6, 24
"/opt/projects/swiftkube/vendor/k8s.io/cloud-provider/service/helpers/helper.go", "Go", 157, 0, 0, 0, 0, 0, 28, 185
"/opt/projects/swiftkube/vendor/k8s.io/cloud-provider/volume/constants.go", "Go", 20, 0, 0, 0, 0, 0, 7, 27
"/opt/projects/swiftkube/vendor/k8s.io/cloud-provider/volume/errors/errors.go", "Go", 63, 0, 0, 0, 0, 0, 15, 78
"/opt/projects/swiftkube/vendor/k8s.io/cloud-provider/volume/helpers/rounding.go", "Go", 138, 0, 0, 0, 0, 0, 28, 166
"/opt/projects/swiftkube/vendor/k8s.io/cloud-provider/volume/helpers/zones.go", "Go", 277, 0, 0, 0, 0, 0, 37, 314
"/opt/projects/swiftkube/vendor/k8s.io/code-generator/cmd/applyconfiguration-gen/args/args.go", "Go", 67, 0, 0, 0, 0, 0, 15, 82
"/opt/projects/swiftkube/vendor/k8s.io/code-generator/cmd/applyconfiguration-gen/args/externaltypes.go", "Go", 103, 0, 0, 0, 0, 0, 20, 123
"/opt/projects/swiftkube/vendor/k8s.io/code-generator/cmd/applyconfiguration-gen/generators/applyconfiguration.go", "Go", 382, 0, 0, 0, 0, 0, 42, 424
"/opt/projects/swiftkube/vendor/k8s.io/code-generator/cmd/applyconfiguration-gen/generators/internal.go", "Go", 81, 0, 0, 0, 0, 0, 19, 100
"/opt/projects/swiftkube/vendor/k8s.io/code-generator/cmd/applyconfiguration-gen/generators/jsontagutil.go", "Go", 86, 0, 0, 0, 0, 0, 14, 100
"/opt/projects/swiftkube/vendor/k8s.io/code-generator/cmd/applyconfiguration-gen/generators/openapi.go", "Go", 179, 0, 0, 0, 0, 0, 20, 199
"/opt/projects/swiftkube/vendor/k8s.io/code-generator/cmd/applyconfiguration-gen/generators/packages.go", "Go", 263, 0, 0, 0, 0, 0, 35, 298
"/opt/projects/swiftkube/vendor/k8s.io/code-generator/cmd/applyconfiguration-gen/generators/refgraph.go", "Go", 161, 0, 0, 0, 0, 0, 19, 180
"/opt/projects/swiftkube/vendor/k8s.io/code-generator/cmd/applyconfiguration-gen/generators/types.go", "Go", 27, 0, 0, 0, 0, 0, 7, 34
"/opt/projects/swiftkube/vendor/k8s.io/code-generator/cmd/applyconfiguration-gen/generators/util.go", "Go", 136, 0, 0, 0, 0, 0, 28, 164
"/opt/projects/swiftkube/vendor/k8s.io/code-generator/cmd/applyconfiguration-gen/main.go", "Go", 44, 0, 0, 0, 0, 0, 11, 55
"/opt/projects/swiftkube/vendor/k8s.io/code-generator/cmd/client-gen/args/args.go", "Go", 110, 0, 0, 0, 0, 0, 24, 134
"/opt/projects/swiftkube/vendor/k8s.io/code-generator/cmd/client-gen/args/gvpackages.go", "Go", 145, 0, 0, 0, 0, 0, 29, 174
"/opt/projects/swiftkube/vendor/k8s.io/code-generator/cmd/client-gen/args/gvtype.go", "Go", 94, 0, 0, 0, 0, 0, 17, 111
"/opt/projects/swiftkube/vendor/k8s.io/code-generator/cmd/client-gen/generators/client_generator.go", "Go", 357, 0, 0, 0, 0, 0, 37, 394
"/opt/projects/swiftkube/vendor/k8s.io/code-generator/cmd/client-gen/generators/fake/fake_client_generator.go", "Go", 120, 0, 0, 0, 0, 0, 12, 132
"/opt/projects/swiftkube/vendor/k8s.io/code-generator/cmd/client-gen/generators/fake/generator_fake_for_clientset.go", "Go", 143, 0, 0, 0, 0, 0, 28, 171
"/opt/projects/swiftkube/vendor/k8s.io/code-generator/cmd/client-gen/generators/fake/generator_fake_for_group.go", "Go", 111, 0, 0, 0, 0, 0, 20, 131
"/opt/projects/swiftkube/vendor/k8s.io/code-generator/cmd/client-gen/generators/fake/generator_fake_for_type.go", "Go", 515, 0, 0, 0, 0, 0, 56, 571
"/opt/projects/swiftkube/vendor/k8s.io/code-generator/cmd/client-gen/generators/generator_for_clientset.go", "Go", 183, 0, 0, 0, 0, 0, 27, 210
"/opt/projects/swiftkube/vendor/k8s.io/code-generator/cmd/client-gen/generators/generator_for_expansion.go", "Go", 44, 0, 0, 0, 0, 0, 11, 55
"/opt/projects/swiftkube/vendor/k8s.io/code-generator/cmd/client-gen/generators/generator_for_group.go", "Go", 235, 0, 0, 0, 0, 0, 33, 268
"/opt/projects/swiftkube/vendor/k8s.io/code-generator/cmd/client-gen/generators/generator_for_type.go", "Go", 697, 0, 0, 0, 0, 0, 64, 761
"/opt/projects/swiftkube/vendor/k8s.io/code-generator/cmd/client-gen/generators/scheme/generator_for_scheme.go", "Go", 162, 0, 0, 0, 0, 0, 26, 188
"/opt/projects/swiftkube/vendor/k8s.io/code-generator/cmd/client-gen/generators/util/gvpackages.go", "Go", 24, 0, 0, 0, 0, 0, 7, 31
"/opt/projects/swiftkube/vendor/k8s.io/code-generator/cmd/client-gen/generators/util/tags.go", "Go", 320, 0, 0, 0, 0, 0, 25, 345
"/opt/projects/swiftkube/vendor/k8s.io/code-generator/cmd/client-gen/main.go", "Go", 50, 0, 0, 0, 0, 0, 14, 64
"/opt/projects/swiftkube/vendor/k8s.io/code-generator/cmd/client-gen/path/path.go", "Go", 25, 0, 0, 0, 0, 0, 7, 32
"/opt/projects/swiftkube/vendor/k8s.io/code-generator/cmd/client-gen/types/helpers.go", "Go", 107, 0, 0, 0, 0, 0, 15, 122
"/opt/projects/swiftkube/vendor/k8s.io/code-generator/cmd/client-gen/types/types.go", "Go", 78, 0, 0, 0, 0, 0, 20, 98
"/opt/projects/swiftkube/vendor/k8s.io/code-generator/cmd/conversion-gen/args/args.go", "Go", 74, 0, 0, 0, 0, 0, 17, 91
"/opt/projects/swiftkube/vendor/k8s.io/code-generator/cmd/conversion-gen/generators/conversion.go", "Go", 1117, 0, 0, 0, 0, 0, 106, 1223
"/opt/projects/swiftkube/vendor/k8s.io/code-generator/cmd/conversion-gen/main.go", "Go", 127, 0, 0, 0, 0, 0, 13, 140
"/opt/projects/swiftkube/vendor/k8s.io/code-generator/cmd/deepcopy-gen/args/args.go", "Go", 42, 0, 0, 0, 0, 0, 13, 55
"/opt/projects/swiftkube/vendor/k8s.io/code-generator/cmd/deepcopy-gen/main.go", "Go", 70, 0, 0, 0, 0, 0, 12, 82
"/opt/projects/swiftkube/vendor/k8s.io/code-generator/cmd/defaulter-gen/args/args.go", "Go", 42, 0, 0, 0, 0, 0, 13, 55
"/opt/projects/swiftkube/vendor/k8s.io/code-generator/cmd/defaulter-gen/main.go", "Go", 66, 0, 0, 0, 0, 0, 12, 78
"/opt/projects/swiftkube/vendor/k8s.io/code-generator/cmd/go-to-protobuf/main.go", "Go", 32, 0, 0, 0, 0, 0, 10, 42
"/opt/projects/swiftkube/vendor/k8s.io/code-generator/cmd/go-to-protobuf/protobuf/cmd.go", "Go", 424, 0, 0, 0, 0, 0, 57, 481
"/opt/projects/swiftkube/vendor/k8s.io/code-generator/cmd/go-to-protobuf/protobuf/generator.go", "Go", 704, 0, 0, 0, 0, 0, 70, 774
"/opt/projects/swiftkube/vendor/k8s.io/code-generator/cmd/go-to-protobuf/protobuf/import_tracker.go", "Go", 41, 0, 0, 0, 0, 0, 10, 51
"/opt/projects/swiftkube/vendor/k8s.io/code-generator/cmd/go-to-protobuf/protobuf/namer.go", "Go", 187, 0, 0, 0, 0, 0, 22, 209
"/opt/projects/swiftkube/vendor/k8s.io/code-generator/cmd/go-to-protobuf/protobuf/package.go", "Go", 182, 0, 0, 0, 0, 0, 34, 216
"/opt/projects/swiftkube/vendor/k8s.io/code-generator/cmd/go-to-protobuf/protobuf/parser.go", "Go", 426, 0, 0, 0, 0, 0, 38, 464
"/opt/projects/swiftkube/vendor/k8s.io/code-generator/cmd/go-to-protobuf/protobuf/tags.go", "Go", 27, 0, 0, 0, 0, 0, 7, 34
"/opt/projects/swiftkube/vendor/k8s.io/code-generator/cmd/import-boss/main.go", "Go", 35, 0, 0, 0, 0, 0, 11, 46
"/opt/projects/swiftkube/vendor/k8s.io/code-generator/cmd/informer-gen/args/args.go", "Go", 68, 0, 0, 0, 0, 0, 16, 84
"/opt/projects/swiftkube/vendor/k8s.io/code-generator/cmd/informer-gen/generators/factory.go", "Go", 279, 0, 0, 0, 0, 0, 52, 331
"/opt/projects/swiftkube/vendor/k8s.io/code-generator/cmd/informer-gen/generators/factoryinterface.go", "Go", 70, 0, 0, 0, 0, 0, 21, 91
"/opt/projects/swiftkube/vendor/k8s.io/code-generator/cmd/informer-gen/generators/generic.go", "Go", 155, 0, 0, 0, 0, 0, 30, 185
"/opt/projects/swiftkube/vendor/k8s.io/code-generator/cmd/informer-gen/generators/groupinterface.go", "Go", 98, 0, 0, 0, 0, 0, 21, 119
"/opt/projects/swiftkube/vendor/k8s.io/code-generator/cmd/informer-gen/generators/informer.go", "Go", 159, 0, 0, 0, 0, 0, 28, 187
"/opt/projects/swiftkube/vendor/k8s.io/code-generator/cmd/informer-gen/generators/packages.go", "Go", 303, 0, 0, 0, 0, 0, 45, 348
"/opt/projects/swiftkube/vendor/k8s.io/code-generator/cmd/informer-gen/generators/types.go", "Go", 36, 0, 0, 0, 0, 0, 7, 43
"/opt/projects/swiftkube/vendor/k8s.io/code-generator/cmd/informer-gen/generators/versioninterface.go", "Go", 89, 0, 0, 0, 0, 0, 21, 110
"/opt/projects/swiftkube/vendor/k8s.io/code-generator/cmd/informer-gen/main.go", "Go", 48, 0, 0, 0, 0, 0, 13, 61
"/opt/projects/swiftkube/vendor/k8s.io/code-generator/cmd/lister-gen/args/args.go", "Go", 50, 0, 0, 0, 0, 0, 15, 65
"/opt/projects/swiftkube/vendor/k8s.io/code-generator/cmd/lister-gen/generators/expansion.go", "Go", 55, 0, 0, 0, 0, 0, 13, 68
"/opt/projects/swiftkube/vendor/k8s.io/code-generator/cmd/lister-gen/generators/lister.go", "Go", 327, 0, 0, 0, 0, 0, 50, 377
"/opt/projects/swiftkube/vendor/k8s.io/code-generator/cmd/lister-gen/main.go", "Go", 45, 0, 0, 0, 0, 0, 13, 58
"/opt/projects/swiftkube/vendor/k8s.io/code-generator/cmd/openapi-gen/main.go", "Go", 44, 0, 0, 0, 0, 0, 14, 58
"/opt/projects/swiftkube/vendor/k8s.io/code-generator/cmd/register-gen/args/args.go", "Go", 30, 0, 0, 0, 0, 0, 10, 40
"/opt/projects/swiftkube/vendor/k8s.io/code-generator/cmd/register-gen/generators/packages.go", "Go", 120, 0, 0, 0, 0, 0, 18, 138
"/opt/projects/swiftkube/vendor/k8s.io/code-generator/cmd/register-gen/generators/register_external.go", "Go", 96, 0, 0, 0, 0, 0, 22, 118
"/opt/projects/swiftkube/vendor/k8s.io/code-generator/cmd/register-gen/main.go", "Go", 39, 0, 0, 0, 0, 0, 11, 50
"/opt/projects/swiftkube/vendor/k8s.io/code-generator/cmd/set-gen/main.go", "Go", 43, 0, 0, 0, 0, 0, 11, 54
"/opt/projects/swiftkube/vendor/k8s.io/code-generator/doc.go", "Go", 13, 0, 0, 0, 0, 0, 5, 18
"/opt/projects/swiftkube/vendor/k8s.io/code-generator/pkg/namer/tag-override.go", "Go", 47, 0, 0, 0, 0, 0, 12, 59
"/opt/projects/swiftkube/vendor/k8s.io/code-generator/pkg/util/build.go", "Go", 50, 0, 0, 0, 0, 0, 11, 61
"/opt/projects/swiftkube/vendor/k8s.io/code-generator/pkg/util/plural_exceptions.go", "Go", 31, 0, 0, 0, 0, 0, 7, 38
"/opt/projects/swiftkube/vendor/k8s.io/code-generator/third_party/forked/golang/reflect/type.go", "Go", 80, 0, 0, 0, 0, 0, 12, 92
"/opt/projects/swiftkube/vendor/k8s.io/code-generator/tools.go", "Go", 31, 0, 0, 0, 0, 0, 7, 38
"/opt/projects/swiftkube/vendor/k8s.io/component-base/cli/flag/ciphersuites_flag.go", "Go", 128, 0, 0, 0, 0, 0, 20, 148
"/opt/projects/swiftkube/vendor/k8s.io/component-base/cli/flag/colon_separated_multimap_string_string.go", "Go", 91, 0, 0, 0, 0, 0, 12, 103
"/opt/projects/swiftkube/vendor/k8s.io/component-base/cli/flag/configuration_map.go", "Go", 44, 0, 0, 0, 0, 0, 10, 54
"/opt/projects/swiftkube/vendor/k8s.io/component-base/cli/flag/flags.go", "Go", 54, 0, 0, 0, 0, 0, 13, 67
"/opt/projects/swiftkube/vendor/k8s.io/component-base/cli/flag/langle_separated_map_string_string.go", "Go", 71, 0, 0, 0, 0, 0, 12, 83
"/opt/projects/swiftkube/vendor/k8s.io/component-base/cli/flag/map_string_bool.go", "Go", 79, 0, 0, 0, 0, 0, 12, 91
"/opt/projects/swiftkube/vendor/k8s.io/component-base/cli/flag/map_string_string.go", "Go", 97, 0, 0, 0, 0, 0, 16, 113
"/opt/projects/swiftkube/vendor/k8s.io/component-base/cli/flag/namedcertkey_flag.go", "Go", 97, 0, 0, 0, 0, 0, 17, 114
"/opt/projects/swiftkube/vendor/k8s.io/component-base/cli/flag/noop.go", "Go", 31, 0, 0, 0, 0, 0, 11, 42
"/opt/projects/swiftkube/vendor/k8s.io/component-base/cli/flag/omitempty.go", "Go", 19, 0, 0, 0, 0, 0, 6, 25
"/opt/projects/swiftkube/vendor/k8s.io/component-base/cli/flag/sectioned.go", "Go", 90, 0, 0, 0, 0, 0, 16, 106
"/opt/projects/swiftkube/vendor/k8s.io/component-base/cli/flag/string_flag.go", "Go", 43, 0, 0, 0, 0, 0, 14, 57
"/opt/projects/swiftkube/vendor/k8s.io/component-base/cli/flag/string_slice_flag.go", "Go", 50, 0, 0, 0, 0, 0, 13, 63
"/opt/projects/swiftkube/vendor/k8s.io/component-base/cli/flag/tristate.go", "Go", 67, 0, 0, 0, 0, 0, 17, 84
"/opt/projects/swiftkube/vendor/k8s.io/component-base/cli/run.go", "Go", 132, 0, 0, 0, 0, 0, 17, 149
"/opt/projects/swiftkube/vendor/k8s.io/component-base/codec/codec.go", "Go", 32, 0, 0, 0, 0, 0, 8, 40
"/opt/projects/swiftkube/vendor/k8s.io/component-base/config/doc.go", "Go", 14, 0, 0, 0, 0, 0, 6, 20
"/opt/projects/swiftkube/vendor/k8s.io/component-base/config/options/leaderelectionconfig.go", "Go", 47, 0, 0, 0, 0, 0, 7, 54
"/opt/projects/swiftkube/vendor/k8s.io/component-base/config/types.go", "Go", 72, 0, 0, 0, 0, 0, 9, 81
"/opt/projects/swiftkube/vendor/k8s.io/component-base/config/v1alpha1/conversion.go", "Go", 41, 0, 0, 0, 0, 0, 13, 54
"/opt/projects/swiftkube/vendor/k8s.io/component-base/config/v1alpha1/defaults.go", "Go", 88, 0, 0, 0, 0, 0, 11, 99
"/opt/projects/swiftkube/vendor/k8s.io/component-base/config/v1alpha1/doc.go", "Go", 15, 0, 0, 0, 0, 0, 6, 21
"/opt/projects/swiftkube/vendor/k8s.io/component-base/config/v1alpha1/register.go", "Go", 25, 0, 0, 0, 0, 0, 7, 32
"/opt/projects/swiftkube/vendor/k8s.io/component-base/config/v1alpha1/types.go", "Go", 73, 0, 0, 0, 0, 0, 10, 83
"/opt/projects/swiftkube/vendor/k8s.io/component-base/config/v1alpha1/zz_generated.conversion.go", "Go", 118, 0, 0, 0, 0, 0, 16, 134
"/opt/projects/swiftkube/vendor/k8s.io/component-base/config/v1alpha1/zz_generated.deepcopy.go", "Go", 76, 0, 0, 0, 0, 0, 13, 89
"/opt/projects/swiftkube/vendor/k8s.io/component-base/config/validation/validation.go", "Go", 54, 0, 0, 0, 0, 0, 8, 62
"/opt/projects/swiftkube/vendor/k8s.io/component-base/config/zz_generated.deepcopy.go", "Go", 61, 0, 0, 0, 0, 0, 13, 74
"/opt/projects/swiftkube/vendor/k8s.io/component-base/configz/configz.go", "Go", 110, 0, 0, 0, 0, 0, 16, 126
"/opt/projects/swiftkube/vendor/k8s.io/component-base/featuregate/feature_gate.go", "Go", 328, 0, 0, 0, 0, 0, 58, 386
"/opt/projects/swiftkube/vendor/k8s.io/component-base/logs/api/v1/doc.go", "Go", 26, 0, 0, 0, 0, 0, 7, 33
"/opt/projects/swiftkube/vendor/k8s.io/component-base/logs/api/v1/kube_features.go", "Go", 57, 0, 0, 0, 0, 0, 14, 71
"/opt/projects/swiftkube/vendor/k8s.io/component-base/logs/api/v1/options.go", "Go", 367, 0, 0, 0, 0, 0, 54, 421
"/opt/projects/swiftkube/vendor/k8s.io/component-base/logs/api/v1/pflags.go", "Go", 95, 0, 0, 0, 0, 0, 19, 114
"/opt/projects/swiftkube/vendor/k8s.io/component-base/logs/api/v1/registry.go", "Go", 115, 0, 0, 0, 0, 0, 21, 136
"/opt/projects/swiftkube/vendor/k8s.io/component-base/logs/api/v1/types.go", "Go", 115, 0, 0, 0, 0, 0, 19, 134
"/opt/projects/swiftkube/vendor/k8s.io/component-base/logs/api/v1/zz_generated.deepcopy.go", "Go", 114, 0, 0, 0, 0, 0, 19, 133
"/opt/projects/swiftkube/vendor/k8s.io/component-base/logs/internal/setverbositylevel/setverbositylevel.go", "Go", 27, 0, 0, 0, 0, 0, 8, 35
"/opt/projects/swiftkube/vendor/k8s.io/component-base/logs/klogflags/klogflags.go", "Go", 34, 0, 0, 0, 0, 0, 8, 42
"/opt/projects/swiftkube/vendor/k8s.io/component-base/logs/logreduction/logreduction.go", "Go", 67, 0, 0, 0, 0, 0, 12, 79
"/opt/projects/swiftkube/vendor/k8s.io/component-base/logs/logs.go", "Go", 179, 0, 0, 0, 0, 0, 31, 210
"/opt/projects/swiftkube/vendor/k8s.io/component-base/metrics/buckets.go", "Go", 34, 0, 0, 0, 0, 0, 10, 44
"/opt/projects/swiftkube/vendor/k8s.io/component-base/metrics/collector.go", "Go", 150, 0, 0, 0, 0, 0, 41, 191
"/opt/projects/swiftkube/vendor/k8s.io/component-base/metrics/counter.go", "Go", 204, 0, 0, 0, 0, 0, 39, 243
"/opt/projects/swiftkube/vendor/k8s.io/component-base/metrics/desc.go", "Go", 190, 0, 0, 0, 0, 0, 36, 226
"/opt/projects/swiftkube/vendor/k8s.io/component-base/metrics/features/kube_features.go", "Go", 31, 0, 0, 0, 0, 0, 9, 40
"/opt/projects/swiftkube/vendor/k8s.io/component-base/metrics/gauge.go", "Go", 235, 0, 0, 0, 0, 0, 43, 278
"/opt/projects/swiftkube/vendor/k8s.io/component-base/metrics/histogram.go", "Go", 182, 0, 0, 0, 0, 0, 33, 215
"/opt/projects/swiftkube/vendor/k8s.io/component-base/metrics/http.go", "Go", 72, 0, 0, 0, 0, 0, 16, 88
"/opt/projects/swiftkube/vendor/k8s.io/component-base/metrics/labels.go", "Go", 16, 0, 0, 0, 0, 0, 7, 23
"/opt/projects/swiftkube/vendor/k8s.io/component-base/metrics/legacyregistry/registry.go", "Go", 73, 0, 0, 0, 0, 0, 20, 93
"/opt/projects/swiftkube/vendor/k8s.io/component-base/metrics/metric.go", "Go", 205, 0, 0, 0, 0, 0, 31, 236
"/opt/projects/swiftkube/vendor/k8s.io/component-base/metrics/options.go", "Go", 107, 0, 0, 0, 0, 0, 19, 126
"/opt/projects/swiftkube/vendor/k8s.io/component-base/metrics/opts.go", "Go", 318, 0, 0, 0, 0, 0, 39, 357
"/opt/projects/swiftkube/vendor/k8s.io/component-base/metrics/processstarttime.go", "Go", 42, 0, 0, 0, 0, 0, 10, 52
"/opt/projects/swiftkube/vendor/k8s.io/component-base/metrics/processstarttime_others.go", "Go", 30, 0, 0, 0, 0, 0, 10, 40
"/opt/projects/swiftkube/vendor/k8s.io/component-base/metrics/processstarttime_windows.go", "Go", 26, 0, 0, 0, 0, 0, 9, 35
"/opt/projects/swiftkube/vendor/k8s.io/component-base/metrics/prometheus/feature/metrics.go", "Go", 43, 0, 0, 0, 0, 0, 11, 54
"/opt/projects/swiftkube/vendor/k8s.io/component-base/metrics/prometheus/slis/metrics.go", "Go", 62, 0, 0, 0, 0, 0, 15, 77
"/opt/projects/swiftkube/vendor/k8s.io/component-base/metrics/prometheus/slis/registry.go", "Go", 21, 0, 0, 0, 0, 0, 7, 28
"/opt/projects/swiftkube/vendor/k8s.io/component-base/metrics/prometheus/slis/routes.go", "Go", 41, 0, 0, 0, 0, 0, 13, 54
"/opt/projects/swiftkube/vendor/k8s.io/component-base/metrics/prometheus/workqueue/metrics.go", "Go", 113, 0, 0, 0, 0, 0, 25, 138
"/opt/projects/swiftkube/vendor/k8s.io/component-base/metrics/prometheusextension/timing_histogram.go", "Go", 158, 0, 0, 0, 0, 0, 32, 190
"/opt/projects/swiftkube/vendor/k8s.io/component-base/metrics/prometheusextension/timing_histogram_vec.go", "Go", 94, 0, 0, 0, 0, 0, 18, 112
"/opt/projects/swiftkube/vendor/k8s.io/component-base/metrics/prometheusextension/weighted_histogram.go", "Go", 174, 0, 0, 0, 0, 0, 30, 204
"/opt/projects/swiftkube/vendor/k8s.io/component-base/metrics/prometheusextension/weighted_histogram_vec.go", "Go", 91, 0, 0, 0, 0, 0, 16, 107
"/opt/projects/swiftkube/vendor/k8s.io/component-base/metrics/registry.go", "Go", 328, 0, 0, 0, 0, 0, 58, 386
"/opt/projects/swiftkube/vendor/k8s.io/component-base/metrics/summary.go", "Go", 194, 0, 0, 0, 0, 0, 33, 227
"/opt/projects/swiftkube/vendor/k8s.io/component-base/metrics/testutil/metrics.go", "Go", 374, 0, 0, 0, 0, 0, 62, 436
"/opt/projects/swiftkube/vendor/k8s.io/component-base/metrics/testutil/promlint.go", "Go", 122, 0, 0, 0, 0, 0, 30, 152
"/opt/projects/swiftkube/vendor/k8s.io/component-base/metrics/testutil/testutil.go", "Go", 134, 0, 0, 0, 0, 0, 21, 155
"/opt/projects/swiftkube/vendor/k8s.io/component-base/metrics/timing_histogram.go", "Go", 235, 0, 0, 0, 0, 0, 36, 271
"/opt/projects/swiftkube/vendor/k8s.io/component-base/metrics/value.go", "Go", 57, 0, 0, 0, 0, 0, 14, 71
"/opt/projects/swiftkube/vendor/k8s.io/component-base/metrics/version.go", "Go", 30, 0, 0, 0, 0, 0, 8, 38
"/opt/projects/swiftkube/vendor/k8s.io/component-base/metrics/version_parser.go", "Go", 39, 0, 0, 0, 0, 0, 12, 51
"/opt/projects/swiftkube/vendor/k8s.io/component-base/metrics/wrappers.go", "Go", 140, 0, 0, 0, 0, 0, 28, 168
"/opt/projects/swiftkube/vendor/k8s.io/component-base/tracing/api/v1/config.go", "Go", 78, 0, 0, 0, 0, 0, 11, 89
"/opt/projects/swiftkube/vendor/k8s.io/component-base/tracing/api/v1/doc.go", "Go", 23, 0, 0, 0, 0, 0, 7, 30
"/opt/projects/swiftkube/vendor/k8s.io/component-base/tracing/api/v1/types.go", "Go", 26, 0, 0, 0, 0, 0, 7, 33
"/opt/projects/swiftkube/vendor/k8s.io/component-base/tracing/api/v1/zz_generated.deepcopy.go", "Go", 40, 0, 0, 0, 0, 0, 9, 49
"/opt/projects/swiftkube/vendor/k8s.io/component-base/tracing/tracing.go", "Go", 77, 0, 0, 0, 0, 0, 16, 93
"/opt/projects/swiftkube/vendor/k8s.io/component-base/tracing/utils.go", "Go", 108, 0, 0, 0, 0, 0, 17, 125
"/opt/projects/swiftkube/vendor/k8s.io/component-base/version/base.go", "Go", 55, 0, 0, 0, 0, 0, 9, 64
"/opt/projects/swiftkube/vendor/k8s.io/component-base/version/dynamic.go", "Go", 66, 0, 0, 0, 0, 0, 12, 78
"/opt/projects/swiftkube/vendor/k8s.io/component-base/version/verflag/verflag.go", "Go", 103, 0, 0, 0, 0, 0, 25, 128
"/opt/projects/swiftkube/vendor/k8s.io/component-base/version/version.go", "Go", 35, 0, 0, 0, 0, 0, 8, 43
"/opt/projects/swiftkube/vendor/k8s.io/component-helpers/apimachinery/lease/controller.go", "Go", 219, 0, 0, 0, 0, 0, 25, 244
"/opt/projects/swiftkube/vendor/k8s.io/component-helpers/auth/rbac/reconciliation/clusterrole_interfaces.go", "Go", 83, 0, 0, 0, 0, 0, 24, 107
"/opt/projects/swiftkube/vendor/k8s.io/component-helpers/auth/rbac/reconciliation/clusterrolebinding_interfaces.go", "Go", 87, 0, 0, 0, 0, 0, 25, 112
"/opt/projects/swiftkube/vendor/k8s.io/component-helpers/auth/rbac/reconciliation/namespace.go", "Go", 36, 0, 0, 0, 0, 0, 10, 46
"/opt/projects/swiftkube/vendor/k8s.io/component-helpers/auth/rbac/reconciliation/reconcile_role.go", "Go", 244, 0, 0, 0, 0, 0, 46, 290
"/opt/projects/swiftkube/vendor/k8s.io/component-helpers/auth/rbac/reconciliation/reconcile_rolebindings.go", "Go", 215, 0, 0, 0, 0, 0, 36, 251
"/opt/projects/swiftkube/vendor/k8s.io/component-helpers/auth/rbac/reconciliation/role_interfaces.go", "Go", 87, 0, 0, 0, 0, 0, 25, 112
"/opt/projects/swiftkube/vendor/k8s.io/component-helpers/auth/rbac/reconciliation/rolebinding_interfaces.go", "Go", 92, 0, 0, 0, 0, 0, 26, 118
"/opt/projects/swiftkube/vendor/k8s.io/component-helpers/auth/rbac/reconciliation/zz_generated.deepcopy.go", "Go", 111, 0, 0, 0, 0, 0, 20, 131
"/opt/projects/swiftkube/vendor/k8s.io/component-helpers/auth/rbac/validation/policy_comparator.go", "Go", 146, 0, 0, 0, 0, 0, 28, 174
"/opt/projects/swiftkube/vendor/k8s.io/component-helpers/node/topology/helpers.go", "Go", 48, 0, 0, 0, 0, 0, 11, 59
"/opt/projects/swiftkube/vendor/k8s.io/component-helpers/node/util/cidr.go", "Go", 48, 0, 0, 0, 0, 0, 11, 59
"/opt/projects/swiftkube/vendor/k8s.io/component-helpers/node/util/conditions.go", "Go", 49, 0, 0, 0, 0, 0, 9, 58
"/opt/projects/swiftkube/vendor/k8s.io/component-helpers/node/util/hostname.go", "Go", 38, 0, 0, 0, 0, 0, 9, 47
"/opt/projects/swiftkube/vendor/k8s.io/component-helpers/node/util/ips.go", "Go", 70, 0, 0, 0, 0, 0, 13, 83
"/opt/projects/swiftkube/vendor/k8s.io/component-helpers/node/util/status.go", "Go", 116, 0, 0, 0, 0, 0, 19, 135
"/opt/projects/swiftkube/vendor/k8s.io/component-helpers/node/util/sysctl/sysctl.go", "Go", 86, 0, 0, 0, 0, 0, 15, 101
"/opt/projects/swiftkube/vendor/k8s.io/component-helpers/scheduling/corev1/doc.go", "Go", 19, 0, 0, 0, 0, 0, 5, 24
"/opt/projects/swiftkube/vendor/k8s.io/component-helpers/scheduling/corev1/helpers.go", "Go", 88, 0, 0, 0, 0, 0, 14, 102
"/opt/projects/swiftkube/vendor/k8s.io/component-helpers/scheduling/corev1/nodeaffinity/nodeaffinity.go", "Go", 301, 0, 0, 0, 0, 0, 33, 334
"/opt/projects/swiftkube/vendor/k8s.io/component-helpers/storage/ephemeral/ephemeral.go", "Go", 49, 0, 0, 0, 0, 0, 9, 58
"/opt/projects/swiftkube/vendor/k8s.io/component-helpers/storage/volume/helpers.go", "Go", 56, 0, 0, 0, 0, 0, 15, 71
"/opt/projects/swiftkube/vendor/k8s.io/component-helpers/storage/volume/pv_helpers.go", "Go", 295, 0, 0, 0, 0, 0, 48, 343
"/opt/projects/swiftkube/vendor/k8s.io/controller-manager/config/doc.go", "Go", 14, 0, 0, 0, 0, 0, 6, 20
"/opt/projects/swiftkube/vendor/k8s.io/controller-manager/config/register.go", "Go", 37, 0, 0, 0, 0, 0, 10, 47
"/opt/projects/swiftkube/vendor/k8s.io/controller-manager/config/types.go", "Go", 70, 0, 0, 0, 0, 0, 13, 83
"/opt/projects/swiftkube/vendor/k8s.io/controller-manager/config/v1/conversion.go", "Go", 69, 0, 0, 0, 0, 0, 14, 83
"/opt/projects/swiftkube/vendor/k8s.io/controller-manager/config/v1/doc.go", "Go", 15, 0, 0, 0, 0, 0, 6, 21
"/opt/projects/swiftkube/vendor/k8s.io/controller-manager/config/v1/register.go", "Go", 39, 0, 0, 0, 0, 0, 10, 49
"/opt/projects/swiftkube/vendor/k8s.io/controller-manager/config/v1/types.go", "Go", 37, 0, 0, 0, 0, 0, 11, 48
"/opt/projects/swiftkube/vendor/k8s.io/controller-manager/config/v1/zz_generated.deepcopy.go", "Go", 60, 0, 0, 0, 0, 0, 13, 73
"/opt/projects/swiftkube/vendor/k8s.io/controller-manager/config/v1alpha1/conversion.go", "Go", 31, 0, 0, 0, 0, 0, 9, 40
"/opt/projects/swiftkube/vendor/k8s.io/controller-manager/config/v1alpha1/defaults.go", "Go", 42, 0, 0, 0, 0, 0, 10, 52
"/opt/projects/swiftkube/vendor/k8s.io/controller-manager/config/v1alpha1/doc.go", "Go", 18, 0, 0, 0, 0, 0, 6, 24
"/opt/projects/swiftkube/vendor/k8s.io/controller-manager/config/v1alpha1/register.go", "Go", 39, 0, 0, 0, 0, 0, 10, 49
"/opt/projects/swiftkube/vendor/k8s.io/controller-manager/config/v1alpha1/types.go", "Go", 69, 0, 0, 0, 0, 0, 13, 82
"/opt/projects/swiftkube/vendor/k8s.io/controller-manager/config/v1alpha1/zz_generated.conversion.go", "Go", 141, 0, 0, 0, 0, 0, 21, 162
"/opt/projects/swiftkube/vendor/k8s.io/controller-manager/config/v1alpha1/zz_generated.deepcopy.go", "Go", 85, 0, 0, 0, 0, 0, 15, 100
"/opt/projects/swiftkube/vendor/k8s.io/controller-manager/config/v1beta1/doc.go", "Go", 17, 0, 0, 0, 0, 0, 6, 23
"/opt/projects/swiftkube/vendor/k8s.io/controller-manager/config/v1beta1/register.go", "Go", 39, 0, 0, 0, 0, 0, 10, 49
"/opt/projects/swiftkube/vendor/k8s.io/controller-manager/config/v1beta1/types.go", "Go", 40, 0, 0, 0, 0, 0, 12, 52
"/opt/projects/swiftkube/vendor/k8s.io/controller-manager/config/v1beta1/zz_generated.conversion.go", "Go", 88, 0, 0, 0, 0, 0, 19, 107
"/opt/projects/swiftkube/vendor/k8s.io/controller-manager/config/v1beta1/zz_generated.deepcopy.go", "Go", 60, 0, 0, 0, 0, 0, 13, 73
"/opt/projects/swiftkube/vendor/k8s.io/controller-manager/config/zz_generated.deepcopy.go", "Go", 85, 0, 0, 0, 0, 0, 15, 100
"/opt/projects/swiftkube/vendor/k8s.io/controller-manager/options/debugging.go", "Go", 57, 0, 0, 0, 0, 0, 16, 73
"/opt/projects/swiftkube/vendor/k8s.io/controller-manager/options/generic.go", "Go", 119, 0, 0, 0, 0, 0, 22, 141
"/opt/projects/swiftkube/vendor/k8s.io/controller-manager/pkg/clientbuilder/client_builder.go", "Go", 89, 0, 0, 0, 0, 0, 14, 103
"/opt/projects/swiftkube/vendor/k8s.io/controller-manager/pkg/clientbuilder/client_builder_dynamic.go", "Go", 232, 0, 0, 0, 0, 0, 40, 272
"/opt/projects/swiftkube/vendor/k8s.io/controller-manager/pkg/features/kube_features.go", "Go", 56, 0, 0, 0, 0, 0, 12, 68
"/opt/projects/swiftkube/vendor/k8s.io/controller-manager/pkg/features/register/register.go", "Go", 21, 0, 0, 0, 0, 0, 7, 28
"/opt/projects/swiftkube/vendor/k8s.io/controller-manager/pkg/leadermigration/config/config.go", "Go", 93, 0, 0, 0, 0, 0, 17, 110
"/opt/projects/swiftkube/vendor/k8s.io/controller-manager/pkg/leadermigration/config/default.go", "Go", 34, 0, 0, 0, 0, 0, 7, 41
"/opt/projects/swiftkube/vendor/k8s.io/controller-manager/pkg/leadermigration/options/options.go", "Go", 74, 0, 0, 0, 0, 0, 12, 86
"/opt/projects/swiftkube/vendor/k8s.io/cri-api/pkg/apis/runtime/v1/api.pb.go", "Go", 45655, 0, 0, 0, 0, 0, 1745, 47400
"/opt/projects/swiftkube/vendor/k8s.io/cri-api/pkg/apis/runtime/v1/api.proto", "Protocol Buffers", 0, 0, 795, 0, 0, 865, 195, 1855
"/opt/projects/swiftkube/vendor/k8s.io/cri-api/pkg/apis/runtime/v1/constants.go", "Go", 45, 0, 0, 0, 0, 0, 11, 56
"/opt/projects/swiftkube/vendor/k8s.io/cri-api/pkg/apis/services.go", "Go", 123, 0, 0, 0, 0, 0, 14, 137
"/opt/projects/swiftkube/vendor/k8s.io/cri-api/pkg/errors/doc.go", "Go", 15, 0, 0, 0, 0, 0, 5, 20
"/opt/projects/swiftkube/vendor/k8s.io/cri-api/pkg/errors/errors.go", "Go", 38, 0, 0, 0, 0, 0, 11, 49
"/opt/projects/swiftkube/vendor/k8s.io/csi-translation-lib/plugins/aws_ebs.go", "Go", 264, 0, 0, 0, 0, 0, 41, 305
"/opt/projects/swiftkube/vendor/k8s.io/csi-translation-lib/plugins/azure_disk.go", "Go", 263, 0, 0, 0, 0, 0, 46, 309
"/opt/projects/swiftkube/vendor/k8s.io/csi-translation-lib/plugins/azure_file.go", "Go", 242, 0, 0, 0, 0, 0, 41, 283
"/opt/projects/swiftkube/vendor/k8s.io/csi-translation-lib/plugins/const.go", "Go", 16, 0, 0, 0, 0, 0, 6, 22
"/opt/projects/swiftkube/vendor/k8s.io/csi-translation-lib/plugins/gce_pd.go", "Go", 344, 0, 0, 0, 0, 0, 56, 400
"/opt/projects/swiftkube/vendor/k8s.io/csi-translation-lib/plugins/in_tree_volume.go", "Go", 343, 0, 0, 0, 0, 0, 55, 398
"/opt/projects/swiftkube/vendor/k8s.io/csi-translation-lib/plugins/openstack_cinder.go", "Go", 153, 0, 0, 0, 0, 0, 32, 185
"/opt/projects/swiftkube/vendor/k8s.io/csi-translation-lib/plugins/portworx.go", "Go", 121, 0, 0, 0, 0, 0, 25, 146
"/opt/projects/swiftkube/vendor/k8s.io/csi-translation-lib/plugins/rbd.go", "Go", 292, 0, 0, 0, 0, 0, 34, 326
"/opt/projects/swiftkube/vendor/k8s.io/csi-translation-lib/plugins/vsphere_volume.go", "Go", 267, 0, 0, 0, 0, 0, 36, 303
"/opt/projects/swiftkube/vendor/k8s.io/csi-translation-lib/translate.go", "Go", 191, 0, 0, 0, 0, 0, 22, 213
"/opt/projects/swiftkube/vendor/k8s.io/dynamic-resource-allocation/resourceclaim/resourceclaim.go", "Go", 98, 0, 0, 0, 0, 0, 13, 111
"/opt/projects/swiftkube/vendor/k8s.io/gengo/args/args.go", "Go", 181, 0, 0, 0, 0, 0, 38, 219
"/opt/projects/swiftkube/vendor/k8s.io/gengo/examples/deepcopy-gen/generators/deepcopy.go", "Go", 833, 0, 0, 0, 0, 0, 97, 930
"/opt/projects/swiftkube/vendor/k8s.io/gengo/examples/defaulter-gen/generators/defaulter.go", "Go", 1012, 0, 0, 0, 0, 0, 106, 1118
"/opt/projects/swiftkube/vendor/k8s.io/gengo/examples/import-boss/generators/import_restrict.go", "Go", 359, 0, 0, 0, 0, 0, 61, 420
"/opt/projects/swiftkube/vendor/k8s.io/gengo/examples/set-gen/generators/sets.go", "Go", 336, 0, 0, 0, 0, 0, 43, 379
"/opt/projects/swiftkube/vendor/k8s.io/gengo/examples/set-gen/generators/tags.go", "Go", 27, 0, 0, 0, 0, 0, 7, 34
"/opt/projects/swiftkube/vendor/k8s.io/gengo/examples/set-gen/sets/byte.go", "Go", 192, 0, 0, 0, 0, 0, 30, 222
"/opt/projects/swiftkube/vendor/k8s.io/gengo/examples/set-gen/sets/doc.go", "Go", 15, 0, 0, 0, 0, 0, 6, 21
"/opt/projects/swiftkube/vendor/k8s.io/gengo/examples/set-gen/sets/empty.go", "Go", 17, 0, 0, 0, 0, 0, 7, 24
"/opt/projects/swiftkube/vendor/k8s.io/gengo/examples/set-gen/sets/int.go", "Go", 192, 0, 0, 0, 0, 0, 30, 222
"/opt/projects/swiftkube/vendor/k8s.io/gengo/examples/set-gen/sets/int64.go", "Go", 192, 0, 0, 0, 0, 0, 30, 222
"/opt/projects/swiftkube/vendor/k8s.io/gengo/examples/set-gen/sets/string.go", "Go", 192, 0, 0, 0, 0, 0, 30, 222
"/opt/projects/swiftkube/vendor/k8s.io/gengo/generator/default_generator.go", "Go", 50, 0, 0, 0, 0, 0, 13, 63
"/opt/projects/swiftkube/vendor/k8s.io/gengo/generator/default_package.go", "Go", 60, 0, 0, 0, 0, 0, 16, 76
"/opt/projects/swiftkube/vendor/k8s.io/gengo/generator/doc.go", "Go", 27, 0, 0, 0, 0, 0, 5, 32
"/opt/projects/swiftkube/vendor/k8s.io/gengo/generator/error_tracker.go", "Go", 41, 0, 0, 0, 0, 0, 10, 51
"/opt/projects/swiftkube/vendor/k8s.io/gengo/generator/execute.go", "Go", 298, 0, 0, 0, 0, 0, 32, 330
"/opt/projects/swiftkube/vendor/k8s.io/gengo/generator/generator.go", "Go", 218, 0, 0, 0, 0, 0, 42, 260
"/opt/projects/swiftkube/vendor/k8s.io/gengo/generator/import_tracker.go", "Go", 56, 0, 0, 0, 0, 0, 15, 71
"/opt/projects/swiftkube/vendor/k8s.io/gengo/generator/snippet_writer.go", "Go", 141, 0, 0, 0, 0, 0, 14, 155
"/opt/projects/swiftkube/vendor/k8s.io/gengo/generator/transitive_closure.go", "Go", 54, 0, 0, 0, 0, 0, 12, 66
"/opt/projects/swiftkube/vendor/k8s.io/gengo/namer/doc.go", "Go", 27, 0, 0, 0, 0, 0, 5, 32
"/opt/projects/swiftkube/vendor/k8s.io/gengo/namer/import_tracker.go", "Go", 97, 0, 0, 0, 0, 0, 16, 113
"/opt/projects/swiftkube/vendor/k8s.io/gengo/namer/namer.go", "Go", 364, 0, 0, 0, 0, 0, 31, 395
"/opt/projects/swiftkube/vendor/k8s.io/gengo/namer/order.go", "Go", 61, 0, 0, 0, 0, 0, 12, 73
"/opt/projects/swiftkube/vendor/k8s.io/gengo/namer/plural_namer.go", "Go", 102, 0, 0, 0, 0, 0, 19, 121
"/opt/projects/swiftkube/vendor/k8s.io/gengo/parser/doc.go", "Go", 15, 0, 0, 0, 0, 0, 5, 20
"/opt/projects/swiftkube/vendor/k8s.io/gengo/parser/parse.go", "Go", 839, 0, 0, 0, 0, 0, 87, 926
"/opt/projects/swiftkube/vendor/k8s.io/gengo/types/comments.go", "Go", 75, 0, 0, 0, 0, 0, 8, 83
"/opt/projects/swiftkube/vendor/k8s.io/gengo/types/doc.go", "Go", 15, 0, 0, 0, 0, 0, 5, 20
"/opt/projects/swiftkube/vendor/k8s.io/gengo/types/flatten.go", "Go", 52, 0, 0, 0, 0, 0, 6, 58
"/opt/projects/swiftkube/vendor/k8s.io/gengo/types/types.go", "Go", 468, 0, 0, 0, 0, 0, 70, 538
"/opt/projects/swiftkube/vendor/k8s.io/klog/v2/contextual.go", "Go", 186, 0, 0, 0, 0, 0, 27, 213
"/opt/projects/swiftkube/vendor/k8s.io/klog/v2/exit.go", "Go", 62, 0, 0, 0, 0, 0, 8, 70
"/opt/projects/swiftkube/vendor/k8s.io/klog/v2/format.go", "Go", 54, 0, 0, 0, 0, 0, 12, 66
"/opt/projects/swiftkube/vendor/k8s.io/klog/v2/imports.go", "Go", 28, 0, 0, 0, 0, 0, 11, 39
"/opt/projects/swiftkube/vendor/k8s.io/klog/v2/internal/buffer/buffer.go", "Go", 158, 0, 0, 0, 0, 0, 19, 177
"/opt/projects/swiftkube/vendor/k8s.io/klog/v2/internal/clock/clock.go", "Go", 148, 0, 0, 0, 0, 0, 31, 179
"/opt/projects/swiftkube/vendor/k8s.io/klog/v2/internal/dbg/dbg.go", "Go", 39, 0, 0, 0, 0, 0, 4, 43
"/opt/projects/swiftkube/vendor/k8s.io/klog/v2/internal/serialize/keyvalues.go", "Go", 325, 0, 0, 0, 0, 0, 31, 356
"/opt/projects/swiftkube/vendor/k8s.io/klog/v2/internal/severity/severity.go", "Go", 51, 0, 0, 0, 0, 0, 8, 59
"/opt/projects/swiftkube/vendor/k8s.io/klog/v2/k8s_references.go", "Go", 187, 0, 0, 0, 0, 0, 26, 213
"/opt/projects/swiftkube/vendor/k8s.io/klog/v2/klog.go", "Go", 1519, 0, 0, 0, 0, 0, 197, 1716
"/opt/projects/swiftkube/vendor/k8s.io/klog/v2/klog_file.go", "Go", 117, 0, 0, 0, 0, 0, 14, 131
"/opt/projects/swiftkube/vendor/k8s.io/klog/v2/klog_file_others.go", "Go", 15, 0, 0, 0, 0, 0, 5, 20
"/opt/projects/swiftkube/vendor/k8s.io/klog/v2/klog_file_windows.go", "Go", 29, 0, 0, 0, 0, 0, 6, 35
"/opt/projects/swiftkube/vendor/k8s.io/klog/v2/klogr.go", "Go", 73, 0, 0, 0, 0, 0, 17, 90
"/opt/projects/swiftkube/vendor/k8s.io/kms/apis/v1beta1/api.pb.go", "Go", 455, 0, 0, 0, 0, 0, 56, 511
"/opt/projects/swiftkube/vendor/k8s.io/kms/apis/v1beta1/api.proto", "Protocol Buffers", 0, 0, 43, 0, 0, 21, 14, 78
"/opt/projects/swiftkube/vendor/k8s.io/kms/apis/v1beta1/v1beta1.go", "Go", 19, 0, 0, 0, 0, 0, 6, 25
"/opt/projects/swiftkube/vendor/k8s.io/kms/apis/v2/api.pb.go", "Go", 484, 0, 0, 0, 0, 0, 59, 543
"/opt/projects/swiftkube/vendor/k8s.io/kms/apis/v2/api.proto", "Protocol Buffers", 0, 0, 44, 0, 0, 21, 14, 79
"/opt/projects/swiftkube/vendor/k8s.io/kms/apis/v2/v2.go", "Go", 14, 0, 0, 0, 0, 0, 5, 19
"/opt/projects/swiftkube/vendor/k8s.io/kms/pkg/service/grpc_service.go", "Go", 114, 0, 0, 0, 0, 0, 28, 142
"/opt/projects/swiftkube/vendor/k8s.io/kms/pkg/service/interface.go", "Go", 41, 0, 0, 0, 0, 0, 10, 51
"/opt/projects/swiftkube/vendor/k8s.io/kms/pkg/util/util.go", "Go", 43, 0, 0, 0, 0, 0, 12, 55
"/opt/projects/swiftkube/vendor/k8s.io/kube-openapi/cmd/openapi-gen/args/args.go", "Go", 63, 0, 0, 0, 0, 0, 14, 77
"/opt/projects/swiftkube/vendor/k8s.io/kube-openapi/pkg/builder/doc.go", "Go", 16, 0, 0, 0, 0, 0, 5, 21
"/opt/projects/swiftkube/vendor/k8s.io/kube-openapi/pkg/builder/openapi.go", "Go", 438, 0, 0, 0, 0, 0, 31, 469
"/opt/projects/swiftkube/vendor/k8s.io/kube-openapi/pkg/builder/parameters.go", "Go", 219, 0, 0, 0, 0, 0, 41, 260
"/opt/projects/swiftkube/vendor/k8s.io/kube-openapi/pkg/builder/util.go", "Go", 48, 0, 0, 0, 0, 0, 14, 62
"/opt/projects/swiftkube/vendor/k8s.io/kube-openapi/pkg/builder3/openapi.go", "Go", 440, 0, 0, 0, 0, 0, 51, 491
"/opt/projects/swiftkube/vendor/k8s.io/kube-openapi/pkg/builder3/util.go", "Go", 40, 0, 0, 0, 0, 0, 13, 53
"/opt/projects/swiftkube/vendor/k8s.io/kube-openapi/pkg/builder3/util/util.go", "Go", 44, 0, 0, 0, 0, 0, 8, 52
"/opt/projects/swiftkube/vendor/k8s.io/kube-openapi/pkg/cached/cache.go", "Go", 284, 0, 0, 0, 0, 0, 29, 313
"/opt/projects/swiftkube/vendor/k8s.io/kube-openapi/pkg/common/common.go", "Go", 271, 0, 0, 0, 0, 0, 54, 325
"/opt/projects/swiftkube/vendor/k8s.io/kube-openapi/pkg/common/doc.go", "Go", 15, 0, 0, 0, 0, 0, 5, 20
"/opt/projects/swiftkube/vendor/k8s.io/kube-openapi/pkg/common/interfaces.go", "Go", 77, 0, 0, 0, 0, 0, 12, 89
"/opt/projects/swiftkube/vendor/k8s.io/kube-openapi/pkg/common/restfuladapter/adapter.go", "Go", 13, 0, 0, 0, 0, 0, 3, 16
"/opt/projects/swiftkube/vendor/k8s.io/kube-openapi/pkg/common/restfuladapter/param_adapter.go", "Go", 44, 0, 0, 0, 0, 0, 11, 55
"/opt/projects/swiftkube/vendor/k8s.io/kube-openapi/pkg/common/restfuladapter/response_error_adapter.go", "Go", 19, 0, 0, 0, 0, 0, 7, 26
"/opt/projects/swiftkube/vendor/k8s.io/kube-openapi/pkg/common/restfuladapter/route_adapter.go", "Go", 53, 0, 0, 0, 0, 0, 16, 69
"/opt/projects/swiftkube/vendor/k8s.io/kube-openapi/pkg/common/restfuladapter/webservice_adapter.go", "Go", 28, 0, 0, 0, 0, 0, 7, 35
"/opt/projects/swiftkube/vendor/k8s.io/kube-openapi/pkg/generators/api_linter.go", "Go", 188, 0, 0, 0, 0, 0, 32, 220
"/opt/projects/swiftkube/vendor/k8s.io/kube-openapi/pkg/generators/config.go", "Go", 75, 0, 0, 0, 0, 0, 17, 92
"/opt/projects/swiftkube/vendor/k8s.io/kube-openapi/pkg/generators/enum.go", "Go", 138, 0, 0, 0, 0, 0, 25, 163
"/opt/projects/swiftkube/vendor/k8s.io/kube-openapi/pkg/generators/extension.go", "Go", 181, 0, 0, 0, 0, 0, 22, 203
"/opt/projects/swiftkube/vendor/k8s.io/kube-openapi/pkg/generators/openapi.go", "Go", 756, 0, 0, 0, 0, 0, 70, 826
"/opt/projects/swiftkube/vendor/k8s.io/kube-openapi/pkg/generators/rules/doc.go", "Go", 19, 0, 0, 0, 0, 0, 5, 24
"/opt/projects/swiftkube/vendor/k8s.io/kube-openapi/pkg/generators/rules/idl_tag.go", "Go", 43, 0, 0, 0, 0, 0, 11, 54
"/opt/projects/swiftkube/vendor/k8s.io/kube-openapi/pkg/generators/rules/names_match.go", "Go", 156, 0, 0, 0, 0, 0, 23, 179
"/opt/projects/swiftkube/vendor/k8s.io/kube-openapi/pkg/generators/rules/omitempty_match_case.go", "Go", 53, 0, 0, 0, 0, 0, 12, 65
"/opt/projects/swiftkube/vendor/k8s.io/kube-openapi/pkg/generators/union.go", "Go", 187, 0, 0, 0, 0, 0, 21, 208
"/opt/projects/swiftkube/vendor/k8s.io/kube-openapi/pkg/handler/default_pruning.go", "Go", 187, 0, 0, 0, 0, 0, 22, 209
"/opt/projects/swiftkube/vendor/k8s.io/kube-openapi/pkg/handler/handler.go", "Go", 179, 0, 0, 0, 0, 0, 23, 202
"/opt/projects/swiftkube/vendor/k8s.io/kube-openapi/pkg/handler3/handler.go", "Go", 260, 0, 0, 0, 0, 0, 35, 295
"/opt/projects/swiftkube/vendor/k8s.io/kube-openapi/pkg/internal/flags.go", "Go", 18, 0, 0, 0, 0, 0, 7, 25
"/opt/projects/swiftkube/vendor/k8s.io/kube-openapi/pkg/internal/serialization.go", "Go", 56, 0, 0, 0, 0, 0, 10, 66
"/opt/projects/swiftkube/vendor/k8s.io/kube-openapi/pkg/internal/third_party/go-json-experiment/json/arshal.go", "Go", 480, 0, 0, 0, 0, 0, 34, 514
"/opt/projects/swiftkube/vendor/k8s.io/kube-openapi/pkg/internal/third_party/go-json-experiment/json/arshal_any.go", "Go", 223, 0, 0, 0, 0, 0, 16, 239
"/opt/projects/swiftkube/vendor/k8s.io/kube-openapi/pkg/internal/third_party/go-json-experiment/json/arshal_default.go", "Go", 1413, 0, 0, 0, 0, 0, 73, 1486
"/opt/projects/swiftkube/vendor/k8s.io/kube-openapi/pkg/internal/third_party/go-json-experiment/json/arshal_funcs.go", "Go", 362, 0, 0, 0, 0, 0, 26, 388
"/opt/projects/swiftkube/vendor/k8s.io/kube-openapi/pkg/internal/third_party/go-json-experiment/json/arshal_inlined.go", "Go", 200, 0, 0, 0, 0, 0, 14, 214
"/opt/projects/swiftkube/vendor/k8s.io/kube-openapi/pkg/internal/third_party/go-json-experiment/json/arshal_methods.go", "Go", 214, 0, 0, 0, 0, 0, 16, 230
"/opt/projects/swiftkube/vendor/k8s.io/kube-openapi/pkg/internal/third_party/go-json-experiment/json/arshal_time.go", "Go", 231, 0, 0, 0, 0, 0, 11, 242
"/opt/projects/swiftkube/vendor/k8s.io/kube-openapi/pkg/internal/third_party/go-json-experiment/json/decode.go", "Go", 1540, 0, 0, 0, 0, 0, 116, 1656
"/opt/projects/swiftkube/vendor/k8s.io/kube-openapi/pkg/internal/third_party/go-json-experiment/json/doc.go", "Go", 179, 0, 0, 0, 0, 0, 4, 183
"/opt/projects/swiftkube/vendor/k8s.io/kube-openapi/pkg/internal/third_party/go-json-experiment/json/encode.go", "Go", 1074, 0, 0, 0, 0, 0, 97, 1171
"/opt/projects/swiftkube/vendor/k8s.io/kube-openapi/pkg/internal/third_party/go-json-experiment/json/errors.go", "Go", 157, 0, 0, 0, 0, 0, 27, 184
"/opt/projects/swiftkube/vendor/k8s.io/kube-openapi/pkg/internal/third_party/go-json-experiment/json/fields.go", "Go", 470, 0, 0, 0, 0, 0, 40, 510
"/opt/projects/swiftkube/vendor/k8s.io/kube-openapi/pkg/internal/third_party/go-json-experiment/json/fold.go", "Go", 52, 0, 0, 0, 0, 0, 5, 57
"/opt/projects/swiftkube/vendor/k8s.io/kube-openapi/pkg/internal/third_party/go-json-experiment/json/intern.go", "Go", 79, 0, 0, 0, 0, 0, 8, 87
"/opt/projects/swiftkube/vendor/k8s.io/kube-openapi/pkg/internal/third_party/go-json-experiment/json/pools.go", "Go", 162, 0, 0, 0, 0, 0, 21, 183
"/opt/projects/swiftkube/vendor/k8s.io/kube-openapi/pkg/internal/third_party/go-json-experiment/json/state.go", "Go", 668, 0, 0, 0, 0, 0, 80, 748
"/opt/projects/swiftkube/vendor/k8s.io/kube-openapi/pkg/internal/third_party/go-json-experiment/json/token.go", "Go", 478, 0, 0, 0, 0, 0, 45, 523
"/opt/projects/swiftkube/vendor/k8s.io/kube-openapi/pkg/internal/third_party/go-json-experiment/json/value.go", "Go", 344, 0, 0, 0, 0, 0, 38, 382
"/opt/projects/swiftkube/vendor/k8s.io/kube-openapi/pkg/openapiconv/convert.go", "Go", 288, 0, 0, 0, 0, 0, 35, 323
"/opt/projects/swiftkube/vendor/k8s.io/kube-openapi/pkg/schemaconv/openapi.go", "Go", 224, 0, 0, 0, 0, 0, 37, 261
"/opt/projects/swiftkube/vendor/k8s.io/kube-openapi/pkg/schemaconv/proto_models.go", "Go", 149, 0, 0, 0, 0, 0, 30, 179
"/opt/projects/swiftkube/vendor/k8s.io/kube-openapi/pkg/schemaconv/smd.go", "Go", 296, 0, 0, 0, 0, 0, 42, 338
"/opt/projects/swiftkube/vendor/k8s.io/kube-openapi/pkg/schemamutation/walker.go", "Go", 457, 0, 0, 0, 0, 0, 63, 520
"/opt/projects/swiftkube/vendor/k8s.io/kube-openapi/pkg/spec3/component.go", "Go", 40, 0, 0, 0, 0, 0, 8, 48
"/opt/projects/swiftkube/vendor/k8s.io/kube-openapi/pkg/spec3/encoding.go", "Go", 72, 0, 0, 0, 0, 0, 13, 85
"/opt/projects/swiftkube/vendor/k8s.io/kube-openapi/pkg/spec3/example.go", "Go", 82, 0, 0, 0, 0, 0, 15, 97
"/opt/projects/swiftkube/vendor/k8s.io/kube-openapi/pkg/spec3/external_documentation.go", "Go", 66, 0, 0, 0, 0, 0, 12, 78
"/opt/projects/swiftkube/vendor/k8s.io/kube-openapi/pkg/spec3/fuzz.go", "Go", 240, 0, 0, 0, 0, 0, 15, 255
"/opt/projects/swiftkube/vendor/k8s.io/kube-openapi/pkg/spec3/header.go", "Go", 99, 0, 0, 0, 0, 0, 13, 112
"/opt/projects/swiftkube/vendor/k8s.io/kube-openapi/pkg/spec3/media_type.go", "Go", 74, 0, 0, 0, 0, 0, 13, 87
"/opt/projects/swiftkube/vendor/k8s.io/kube-openapi/pkg/spec3/operation.go", "Go", 86, 0, 0, 0, 0, 0, 12, 98
"/opt/projects/swiftkube/vendor/k8s.io/kube-openapi/pkg/spec3/parameter.go", "Go", 103, 0, 0, 0, 0, 0, 14, 117
"/opt/projects/swiftkube/vendor/k8s.io/kube-openapi/pkg/spec3/path.go", "Go", 201, 0, 0, 0, 0, 0, 22, 223
"/opt/projects/swiftkube/vendor/k8s.io/kube-openapi/pkg/spec3/request_body.go", "Go", 83, 0, 0, 0, 0, 0, 12, 95
"/opt/projects/swiftkube/vendor/k8s.io/kube-openapi/pkg/spec3/response.go", "Go", 284, 0, 0, 0, 0, 0, 27, 311
"/opt/projects/swiftkube/vendor/k8s.io/kube-openapi/pkg/spec3/security_scheme.go", "Go", 104, 0, 0, 0, 0, 0, 15, 119
"/opt/projects/swiftkube/vendor/k8s.io/kube-openapi/pkg/spec3/server.go", "Go", 116, 0, 0, 0, 0, 0, 20, 136
"/opt/projects/swiftkube/vendor/k8s.io/kube-openapi/pkg/spec3/spec.go", "Go", 42, 0, 0, 0, 0, 0, 9, 51
"/opt/projects/swiftkube/vendor/k8s.io/kube-openapi/pkg/util/proto/doc.go", "Go", 15, 0, 0, 0, 0, 0, 5, 20
"/opt/projects/swiftkube/vendor/k8s.io/kube-openapi/pkg/util/proto/document.go", "Go", 321, 0, 0, 0, 0, 0, 42, 363
"/opt/projects/swiftkube/vendor/k8s.io/kube-openapi/pkg/util/proto/document_v3.go", "Go", 279, 0, 0, 0, 0, 0, 46, 325
"/opt/projects/swiftkube/vendor/k8s.io/kube-openapi/pkg/util/proto/openapi.go", "Go", 232, 0, 0, 0, 0, 0, 54, 286
"/opt/projects/swiftkube/vendor/k8s.io/kube-openapi/pkg/util/proto/validation/errors.go", "Go", 61, 0, 0, 0, 0, 0, 19, 80
"/opt/projects/swiftkube/vendor/k8s.io/kube-openapi/pkg/util/proto/validation/types.go", "Go", 254, 0, 0, 0, 0, 0, 46, 300
"/opt/projects/swiftkube/vendor/k8s.io/kube-openapi/pkg/util/proto/validation/validation.go", "Go", 24, 0, 0, 0, 0, 0, 7, 31
"/opt/projects/swiftkube/vendor/k8s.io/kube-openapi/pkg/util/sets/empty.go", "Go", 20, 0, 0, 0, 0, 0, 8, 28
"/opt/projects/swiftkube/vendor/k8s.io/kube-openapi/pkg/util/sets/string.go", "Go", 179, 0, 0, 0, 0, 0, 29, 208
"/opt/projects/swiftkube/vendor/k8s.io/kube-openapi/pkg/util/trie.go", "Go", 70, 0, 0, 0, 0, 0, 10, 80
"/opt/projects/swiftkube/vendor/k8s.io/kube-openapi/pkg/util/util.go", "Go", 106, 0, 0, 0, 0, 0, 10, 116
"/opt/projects/swiftkube/vendor/k8s.io/kube-openapi/pkg/validation/errors/api.go", "Go", 39, 0, 0, 0, 0, 0, 8, 47
"/opt/projects/swiftkube/vendor/k8s.io/kube-openapi/pkg/validation/errors/doc.go", "Go", 23, 0, 0, 0, 0, 0, 4, 27
"/opt/projects/swiftkube/vendor/k8s.io/kube-openapi/pkg/validation/errors/headers.go", "Go", 39, 0, 0, 0, 0, 0, 6, 45
"/opt/projects/swiftkube/vendor/k8s.io/kube-openapi/pkg/validation/errors/schema.go", "Go", 534, 0, 0, 0, 0, 0, 40, 574
"/opt/projects/swiftkube/vendor/k8s.io/kube-openapi/pkg/validation/spec/contact_info.go", "Go", 22, 0, 0, 0, 0, 0, 3, 25
"/opt/projects/swiftkube/vendor/k8s.io/kube-openapi/pkg/validation/spec/external_docs.go", "Go", 22, 0, 0, 0, 0, 0, 3, 25
"/opt/projects/swiftkube/vendor/k8s.io/kube-openapi/pkg/validation/spec/fuzz.go", "Go", 446, 0, 0, 0, 0, 0, 57, 503
"/opt/projects/swiftkube/vendor/k8s.io/kube-openapi/pkg/validation/spec/gnostic.go", "Go", 1260, 0, 0, 0, 0, 0, 258, 1518
"/opt/projects/swiftkube/vendor/k8s.io/kube-openapi/pkg/validation/spec/header.go", "Go", 104, 0, 0, 0, 0, 0, 15, 119
"/opt/projects/swiftkube/vendor/k8s.io/kube-openapi/pkg/validation/spec/info.go", "Go", 198, 0, 0, 0, 0, 0, 22, 220
"/opt/projects/swiftkube/vendor/k8s.io/kube-openapi/pkg/validation/spec/items.go", "Go", 165, 0, 0, 0, 0, 0, 16, 181
"/opt/projects/swiftkube/vendor/k8s.io/kube-openapi/pkg/validation/spec/license.go", "Go", 21, 0, 0, 0, 0, 0, 3, 24
"/opt/projects/swiftkube/vendor/k8s.io/kube-openapi/pkg/validation/spec/operation.go", "Go", 134, 0, 0, 0, 0, 0, 13, 147
"/opt/projects/swiftkube/vendor/k8s.io/kube-openapi/pkg/validation/spec/parameter.go", "Go", 161, 0, 0, 0, 0, 0, 12, 173
"/opt/projects/swiftkube/vendor/k8s.io/kube-openapi/pkg/validation/spec/path_item.go", "Go", 101, 0, 0, 0, 0, 0, 13, 114
"/opt/projects/swiftkube/vendor/k8s.io/kube-openapi/pkg/validation/spec/paths.go", "Go", 150, 0, 0, 0, 0, 0, 15, 165
"/opt/projects/swiftkube/vendor/k8s.io/kube-openapi/pkg/validation/spec/ref.go", "Go", 131, 0, 0, 0, 0, 0, 25, 156
"/opt/projects/swiftkube/vendor/k8s.io/kube-openapi/pkg/validation/spec/response.go", "Go", 114, 0, 0, 0, 0, 0, 18, 132
"/opt/projects/swiftkube/vendor/k8s.io/kube-openapi/pkg/validation/spec/responses.go", "Go", 193, 0, 0, 0, 0, 0, 16, 209
"/opt/projects/swiftkube/vendor/k8s.io/kube-openapi/pkg/validation/spec/schema.go", "Go", 550, 0, 0, 0, 0, 0, 82, 632
"/opt/projects/swiftkube/vendor/k8s.io/kube-openapi/pkg/validation/spec/security_scheme.go", "Go", 83, 0, 0, 0, 0, 0, 10, 93
"/opt/projects/swiftkube/vendor/k8s.io/kube-openapi/pkg/validation/spec/swagger.go", "Go", 395, 0, 0, 0, 0, 0, 45, 440
"/opt/projects/swiftkube/vendor/k8s.io/kube-openapi/pkg/validation/spec/tag.go", "Go", 81, 0, 0, 0, 0, 0, 11, 92
"/opt/projects/swiftkube/vendor/k8s.io/kube-openapi/pkg/validation/strfmt/bson.go", "Go", 90, 0, 0, 0, 0, 0, 14, 104
"/opt/projects/swiftkube/vendor/k8s.io/kube-openapi/pkg/validation/strfmt/bson/objectid.go", "Go", 103, 0, 0, 0, 0, 0, 20, 123
"/opt/projects/swiftkube/vendor/k8s.io/kube-openapi/pkg/validation/strfmt/date.go", "Go", 90, 0, 0, 0, 0, 0, 14, 104
"/opt/projects/swiftkube/vendor/k8s.io/kube-openapi/pkg/validation/strfmt/default.go", "Go", 1324, 0, 0, 0, 0, 0, 239, 1563
"/opt/projects/swiftkube/vendor/k8s.io/kube-openapi/pkg/validation/strfmt/doc.go", "Go", 17, 0, 0, 0, 0, 0, 2, 19
"/opt/projects/swiftkube/vendor/k8s.io/kube-openapi/pkg/validation/strfmt/duration.go", "Go", 156, 0, 0, 0, 0, 0, 25, 181
"/opt/projects/swiftkube/vendor/k8s.io/kube-openapi/pkg/validation/strfmt/format.go", "Go", 203, 0, 0, 0, 0, 0, 31, 234
"/opt/projects/swiftkube/vendor/k8s.io/kube-openapi/pkg/validation/strfmt/time.go", "Go", 152, 0, 0, 0, 0, 0, 21, 173
"/opt/projects/swiftkube/vendor/k8s.io/kube-scheduler/config/v1/doc.go", "Go", 16, 0, 0, 0, 0, 0, 6, 22
"/opt/projects/swiftkube/vendor/k8s.io/kube-scheduler/config/v1/register.go", "Go", 41, 0, 0, 0, 0, 0, 10, 51
"/opt/projects/swiftkube/vendor/k8s.io/kube-scheduler/config/v1/types.go", "Go", 346, 0, 0, 0, 0, 0, 52, 398
"/opt/projects/swiftkube/vendor/k8s.io/kube-scheduler/config/v1/types_pluginargs.go", "Go", 189, 0, 0, 0, 0, 0, 41, 230
"/opt/projects/swiftkube/vendor/k8s.io/kube-scheduler/config/v1/zz_generated.deepcopy.go", "Go", 554, 0, 0, 0, 0, 0, 56, 610
"/opt/projects/swiftkube/vendor/k8s.io/kube-scheduler/config/v1beta3/doc.go", "Go", 16, 0, 0, 0, 0, 0, 6, 22
"/opt/projects/swiftkube/vendor/k8s.io/kube-scheduler/config/v1beta3/register.go", "Go", 41, 0, 0, 0, 0, 0, 10, 51
"/opt/projects/swiftkube/vendor/k8s.io/kube-scheduler/config/v1beta3/types.go", "Go", 328, 0, 0, 0, 0, 0, 50, 378
"/opt/projects/swiftkube/vendor/k8s.io/kube-scheduler/config/v1beta3/types_pluginargs.go", "Go", 189, 0, 0, 0, 0, 0, 41, 230
"/opt/projects/swiftkube/vendor/k8s.io/kube-scheduler/config/v1beta3/zz_generated.deepcopy.go", "Go", 549, 0, 0, 0, 0, 0, 56, 605
"/opt/projects/swiftkube/vendor/k8s.io/kube-scheduler/extender/v1/doc.go", "Go", 15, 0, 0, 0, 0, 0, 6, 21
"/opt/projects/swiftkube/vendor/k8s.io/kube-scheduler/extender/v1/types.go", "Go", 113, 0, 0, 0, 0, 0, 20, 133
"/opt/projects/swiftkube/vendor/k8s.io/kube-scheduler/extender/v1/zz_generated.deepcopy.go", "Go", 316, 0, 0, 0, 0, 0, 32, 348
"/opt/projects/swiftkube/vendor/k8s.io/kubectl/pkg/apps/kind_visitor.go", "Go", 65, 0, 0, 0, 0, 0, 11, 76
"/opt/projects/swiftkube/vendor/k8s.io/kubectl/pkg/cmd/alpha.go", "Go", 36, 0, 0, 0, 0, 0, 11, 47
"/opt/projects/swiftkube/vendor/k8s.io/kubectl/pkg/cmd/annotate/annotate.go", "Go", 413, 0, 0, 0, 0, 0, 71, 484
"/opt/projects/swiftkube/vendor/k8s.io/kubectl/pkg/cmd/apiresources/apiresources.go", "Go", 253, 0, 0, 0, 0, 0, 41, 294
"/opt/projects/swiftkube/vendor/k8s.io/kubectl/pkg/cmd/apiresources/apiversions.go", "Go", 81, 0, 0, 0, 0, 0, 16, 97
"/opt/projects/swiftkube/vendor/k8s.io/kubectl/pkg/cmd/apply/apply.go", "Go", 927, 0, 0, 0, 0, 0, 161, 1088
"/opt/projects/swiftkube/vendor/k8s.io/kubectl/pkg/cmd/apply/apply_edit_last_applied.go", "Go", 71, 0, 0, 0, 0, 0, 19, 90
"/opt/projects/swiftkube/vendor/k8s.io/kubectl/pkg/cmd/apply/apply_set_last_applied.go", "Go", 186, 0, 0, 0, 0, 0, 34, 220
"/opt/projects/swiftkube/vendor/k8s.io/kubectl/pkg/cmd/apply/apply_view_last_applied.go", "Go", 147, 0, 0, 0, 0, 0, 28, 175
"/opt/projects/swiftkube/vendor/k8s.io/kubectl/pkg/cmd/apply/applyset.go", "Go", 489, 0, 0, 0, 0, 0, 72, 561
"/opt/projects/swiftkube/vendor/k8s.io/kubectl/pkg/cmd/apply/applyset_pruner.go", "Go", 159, 0, 0, 0, 0, 0, 35, 194
"/opt/projects/swiftkube/vendor/k8s.io/kubectl/pkg/cmd/apply/patcher.go", "Go", 266, 0, 0, 0, 0, 0, 40, 306
"/opt/projects/swiftkube/vendor/k8s.io/kubectl/pkg/cmd/apply/prune.go", "Go", 134, 0, 0, 0, 0, 0, 29, 163
"/opt/projects/swiftkube/vendor/k8s.io/kubectl/pkg/cmd/attach/attach.go", "Go", 283, 0, 0, 0, 0, 0, 52, 335
"/opt/projects/swiftkube/vendor/k8s.io/kubectl/pkg/cmd/auth/auth.go", "Go", 32, 0, 0, 0, 0, 0, 10, 42
"/opt/projects/swiftkube/vendor/k8s.io/kubectl/pkg/cmd/auth/cani.go", "Go", 377, 0, 0, 0, 0, 0, 58, 435
"/opt/projects/swiftkube/vendor/k8s.io/kubectl/pkg/cmd/auth/reconcile.go", "Go", 303, 0, 0, 0, 0, 0, 47, 350
"/opt/projects/swiftkube/vendor/k8s.io/kubectl/pkg/cmd/auth/whoami.go", "Go", 222, 0, 0, 0, 0, 0, 42, 264
"/opt/projects/swiftkube/vendor/k8s.io/kubectl/pkg/cmd/autoscale/autoscale.go", "Go", 246, 0, 0, 0, 0, 0, 48, 294
"/opt/projects/swiftkube/vendor/k8s.io/kubectl/pkg/cmd/certificates/certificates.go", "Go", 262, 0, 0, 0, 0, 0, 45, 307
"/opt/projects/swiftkube/vendor/k8s.io/kubectl/pkg/cmd/clusterinfo/clusterinfo.go", "Go", 141, 0, 0, 0, 0, 0, 27, 168
"/opt/projects/swiftkube/vendor/k8s.io/kubectl/pkg/cmd/clusterinfo/clusterinfo_dump.go", "Go", 259, 0, 0, 0, 0, 0, 52, 311
"/opt/projects/swiftkube/vendor/k8s.io/kubectl/pkg/cmd/cmd.go", "Go", 505, 0, 0, 0, 0, 0, 59, 564
"/opt/projects/swiftkube/vendor/k8s.io/kubectl/pkg/cmd/completion/completion.go", "Go", 171, 0, 0, 0, 0, 0, 38, 209
"/opt/projects/swiftkube/vendor/k8s.io/kubectl/pkg/cmd/config/config.go", "Go", 77, 0, 0, 0, 0, 0, 18, 95
"/opt/projects/swiftkube/vendor/k8s.io/kubectl/pkg/cmd/config/current_context.go", "Go", 60, 0, 0, 0, 0, 0, 17, 77
"/opt/projects/swiftkube/vendor/k8s.io/kubectl/pkg/cmd/config/delete_cluster.go", "Go", 69, 0, 0, 0, 0, 0, 18, 87
"/opt/projects/swiftkube/vendor/k8s.io/kubectl/pkg/cmd/config/delete_context.go", "Go", 72, 0, 0, 0, 0, 0, 19, 91
"/opt/projects/swiftkube/vendor/k8s.io/kubectl/pkg/cmd/config/delete_user.go", "Go", 97, 0, 0, 0, 0, 0, 26, 123
"/opt/projects/swiftkube/vendor/k8s.io/kubectl/pkg/cmd/config/get_clusters.go", "Go", 52, 0, 0, 0, 0, 0, 13, 65
"/opt/projects/swiftkube/vendor/k8s.io/kubectl/pkg/cmd/config/get_contexts.go", "Go", 156, 0, 0, 0, 0, 0, 28, 184
"/opt/projects/swiftkube/vendor/k8s.io/kubectl/pkg/cmd/config/get_users.go", "Go", 72, 0, 0, 0, 0, 0, 19, 91
"/opt/projects/swiftkube/vendor/k8s.io/kubectl/pkg/cmd/config/navigation_step_parser.go", "Go", 119, 0, 0, 0, 0, 0, 29, 148
"/opt/projects/swiftkube/vendor/k8s.io/kubectl/pkg/cmd/config/rename_context.go", "Go", 107, 0, 0, 0, 0, 0, 29, 136
"/opt/projects/swiftkube/vendor/k8s.io/kubectl/pkg/cmd/config/set.go", "Go", 209, 0, 0, 0, 0, 0, 54, 263
"/opt/projects/swiftkube/vendor/k8s.io/kubectl/pkg/cmd/config/set_cluster.go", "Go", 166, 0, 0, 0, 0, 0, 33, 199
"/opt/projects/swiftkube/vendor/k8s.io/kubectl/pkg/cmd/config/set_context.go", "Go", 128, 0, 0, 0, 0, 0, 28, 156
"/opt/projects/swiftkube/vendor/k8s.io/kubectl/pkg/cmd/config/set_credentials.go", "Go", 380, 0, 0, 0, 0, 0, 62, 442
"/opt/projects/swiftkube/vendor/k8s.io/kubectl/pkg/cmd/config/unset.go", "Go", 92, 0, 0, 0, 0, 0, 25, 117
"/opt/projects/swiftkube/vendor/k8s.io/kubectl/pkg/cmd/config/use_context.go", "Go", 84, 0, 0, 0, 0, 0, 22, 106
"/opt/projects/swiftkube/vendor/k8s.io/kubectl/pkg/cmd/config/view.go", "Go", 152, 0, 0, 0, 0, 0, 36, 188
"/opt/projects/swiftkube/vendor/k8s.io/kubectl/pkg/cmd/cp/cp.go", "Go", 500, 0, 0, 0, 0, 0, 76, 576
"/opt/projects/swiftkube/vendor/k8s.io/kubectl/pkg/cmd/cp/filespec.go", "Go", 128, 0, 0, 0, 0, 0, 34, 162
"/opt/projects/swiftkube/vendor/k8s.io/kubectl/pkg/cmd/create/create.go", "Go", 403, 0, 0, 0, 0, 0, 70, 473
"/opt/projects/swiftkube/vendor/k8s.io/kubectl/pkg/cmd/create/create_clusterrole.go", "Go", 189, 0, 0, 0, 0, 0, 39, 228
"/opt/projects/swiftkube/vendor/k8s.io/kubectl/pkg/cmd/create/create_clusterrolebinding.go", "Go", 193, 0, 0, 0, 0, 0, 36, 229
"/opt/projects/swiftkube/vendor/k8s.io/kubectl/pkg/cmd/create/create_configmap.go", "Go", 357, 0, 0, 0, 0, 0, 58, 415
"/opt/projects/swiftkube/vendor/k8s.io/kubectl/pkg/cmd/create/create_cronjob.go", "Go", 195, 0, 0, 0, 0, 0, 32, 227
"/opt/projects/swiftkube/vendor/k8s.io/kubectl/pkg/cmd/create/create_deployment.go", "Go", 235, 0, 0, 0, 0, 0, 41, 276
"/opt/projects/swiftkube/vendor/k8s.io/kubectl/pkg/cmd/create/create_ingress.go", "Go", 378, 0, 0, 0, 0, 0, 81, 459
"/opt/projects/swiftkube/vendor/k8s.io/kubectl/pkg/cmd/create/create_job.go", "Go", 239, 0, 0, 0, 0, 0, 37, 276
"/opt/projects/swiftkube/vendor/k8s.io/kubectl/pkg/cmd/create/create_namespace.go", "Go", 149, 0, 0, 0, 0, 0, 31, 180
"/opt/projects/swiftkube/vendor/k8s.io/kubectl/pkg/cmd/create/create_pdb.go", "Go", 214, 0, 0, 0, 0, 0, 48, 262
"/opt/projects/swiftkube/vendor/k8s.io/kubectl/pkg/cmd/create/create_priorityclass.go", "Go", 166, 0, 0, 0, 0, 0, 33, 199
"/opt/projects/swiftkube/vendor/k8s.io/kubectl/pkg/cmd/create/create_quota.go", "Go", 225, 0, 0, 0, 0, 0, 44, 269
"/opt/projects/swiftkube/vendor/k8s.io/kubectl/pkg/cmd/create/create_role.go", "Go", 384, 0, 0, 0, 0, 0, 62, 446
"/opt/projects/swiftkube/vendor/k8s.io/kubectl/pkg/cmd/create/create_rolebinding.go", "Go", 219, 0, 0, 0, 0, 0, 33, 252
"/opt/projects/swiftkube/vendor/k8s.io/kubectl/pkg/cmd/create/create_secret.go", "Go", 361, 0, 0, 0, 0, 0, 61, 422
"/opt/projects/swiftkube/vendor/k8s.io/kubectl/pkg/cmd/create/create_secret_docker.go", "Go", 252, 0, 0, 0, 0, 0, 47, 299
"/opt/projects/swiftkube/vendor/k8s.io/kubectl/pkg/cmd/create/create_secret_tls.go", "Go", 211, 0, 0, 0, 0, 0, 39, 250
"/opt/projects/swiftkube/vendor/k8s.io/kubectl/pkg/cmd/create/create_service.go", "Go", 350, 0, 0, 0, 0, 0, 63, 413
"/opt/projects/swiftkube/vendor/k8s.io/kubectl/pkg/cmd/create/create_serviceaccount.go", "Go", 169, 0, 0, 0, 0, 0, 34, 203
"/opt/projects/swiftkube/vendor/k8s.io/kubectl/pkg/cmd/create/create_token.go", "Go", 224, 0, 0, 0, 0, 0, 46, 270
"/opt/projects/swiftkube/vendor/k8s.io/kubectl/pkg/cmd/debug/debug.go", "Go", 743, 0, 0, 0, 0, 0, 117, 860
"/opt/projects/swiftkube/vendor/k8s.io/kubectl/pkg/cmd/debug/profiles.go", "Go", 323, 0, 0, 0, 0, 0, 54, 377
"/opt/projects/swiftkube/vendor/k8s.io/kubectl/pkg/cmd/delete/delete.go", "Go", 466, 0, 0, 0, 0, 0, 77, 543
"/opt/projects/swiftkube/vendor/k8s.io/kubectl/pkg/cmd/delete/delete_flags.go", "Go", 235, 0, 0, 0, 0, 0, 29, 264
"/opt/projects/swiftkube/vendor/k8s.io/kubectl/pkg/cmd/describe/describe.go", "Go", 249, 0, 0, 0, 0, 0, 46, 295
"/opt/projects/swiftkube/vendor/k8s.io/kubectl/pkg/cmd/diff/diff.go", "Go", 695, 0, 0, 0, 0, 0, 105, 800
"/opt/projects/swiftkube/vendor/k8s.io/kubectl/pkg/cmd/diff/prune.go", "Go", 116, 0, 0, 0, 0, 0, 21, 137
"/opt/projects/swiftkube/vendor/k8s.io/kubectl/pkg/cmd/drain/drain.go", "Go", 377, 0, 0, 0, 0, 0, 69, 446
"/opt/projects/swiftkube/vendor/k8s.io/kubectl/pkg/cmd/edit/edit.go", "Go", 86, 0, 0, 0, 0, 0, 23, 109
"/opt/projects/swiftkube/vendor/k8s.io/kubectl/pkg/cmd/events/event_printer.go", "Go", 106, 0, 0, 0, 0, 0, 21, 127
"/opt/projects/swiftkube/vendor/k8s.io/kubectl/pkg/cmd/events/events.go", "Go", 346, 0, 0, 0, 0, 0, 64, 410
"/opt/projects/swiftkube/vendor/k8s.io/kubectl/pkg/cmd/exec/exec.go", "Go", 322, 0, 0, 0, 0, 0, 61, 383
"/opt/projects/swiftkube/vendor/k8s.io/kubectl/pkg/cmd/explain/explain.go", "Go", 190, 0, 0, 0, 0, 0, 44, 234
"/opt/projects/swiftkube/vendor/k8s.io/kubectl/pkg/cmd/expose/expose.go", "Go", 558, 0, 0, 0, 0, 0, 77, 635
"/opt/projects/swiftkube/vendor/k8s.io/kubectl/pkg/cmd/get/customcolumn.go", "Go", 236, 0, 0, 0, 0, 0, 27, 263
"/opt/projects/swiftkube/vendor/k8s.io/kubectl/pkg/cmd/get/customcolumn_flags.go", "Go", 93, 0, 0, 0, 0, 0, 21, 114
"/opt/projects/swiftkube/vendor/k8s.io/kubectl/pkg/cmd/get/get.go", "Go", 704, 0, 0, 0, 0, 0, 118, 822
"/opt/projects/swiftkube/vendor/k8s.io/kubectl/pkg/cmd/get/get_flags.go", "Go", 140, 0, 0, 0, 0, 0, 31, 171
"/opt/projects/swiftkube/vendor/k8s.io/kubectl/pkg/cmd/get/humanreadable_flags.go", "Go", 114, 0, 0, 0, 0, 0, 25, 139
"/opt/projects/swiftkube/vendor/k8s.io/kubectl/pkg/cmd/get/skip_printer.go", "Go", 38, 0, 0, 0, 0, 0, 11, 49
"/opt/projects/swiftkube/vendor/k8s.io/kubectl/pkg/cmd/get/sorter.go", "Go", 376, 0, 0, 0, 0, 0, 49, 425
"/opt/projects/swiftkube/vendor/k8s.io/kubectl/pkg/cmd/get/table_printer.go", "Go", 79, 0, 0, 0, 0, 0, 16, 95
"/opt/projects/swiftkube/vendor/k8s.io/kubectl/pkg/cmd/kustomize/kustomize.go", "Go", 34, 0, 0, 0, 0, 0, 8, 42
"/opt/projects/swiftkube/vendor/k8s.io/kubectl/pkg/cmd/label/label.go", "Go", 402, 0, 0, 0, 0, 0, 64, 466
"/opt/projects/swiftkube/vendor/k8s.io/kubectl/pkg/cmd/logs/logs.go", "Go", 385, 0, 0, 0, 0, 0, 80, 465
"/opt/projects/swiftkube/vendor/k8s.io/kubectl/pkg/cmd/options/options.go", "Go", 45, 0, 0, 0, 0, 0, 12, 57
"/opt/projects/swiftkube/vendor/k8s.io/kubectl/pkg/cmd/patch/patch.go", "Go", 308, 0, 0, 0, 0, 0, 56, 364
"/opt/projects/swiftkube/vendor/k8s.io/kubectl/pkg/cmd/plugin/plugin.go", "Go", 237, 0, 0, 0, 0, 0, 55, 292
"/opt/projects/swiftkube/vendor/k8s.io/kubectl/pkg/cmd/plugin/plugin_completion.go", "Go", 206, 0, 0, 0, 0, 0, 27, 233
"/opt/projects/swiftkube/vendor/k8s.io/kubectl/pkg/cmd/portforward/portforward.go", "Go", 355, 0, 0, 0, 0, 0, 63, 418
"/opt/projects/swiftkube/vendor/k8s.io/kubectl/pkg/cmd/profiling.go", "Go", 93, 0, 0, 0, 0, 0, 14, 107
"/opt/projects/swiftkube/vendor/k8s.io/kubectl/pkg/cmd/proxy/proxy.go", "Go", 196, 0, 0, 0, 0, 0, 35, 231
"/opt/projects/swiftkube/vendor/k8s.io/kubectl/pkg/cmd/replace/replace.go", "Go", 356, 0, 0, 0, 0, 0, 75, 431
"/opt/projects/swiftkube/vendor/k8s.io/kubectl/pkg/cmd/rollout/rollout.go", "Go", 59, 0, 0, 0, 0, 0, 17, 76
"/opt/projects/swiftkube/vendor/k8s.io/kubectl/pkg/cmd/rollout/rollout_history.go", "Go", 181, 0, 0, 0, 0, 0, 43, 224
"/opt/projects/swiftkube/vendor/k8s.io/kubectl/pkg/cmd/rollout/rollout_pause.go", "Go", 176, 0, 0, 0, 0, 0, 36, 212
"/opt/projects/swiftkube/vendor/k8s.io/kubectl/pkg/cmd/rollout/rollout_restart.go", "Go", 173, 0, 0, 0, 0, 0, 40, 213
"/opt/projects/swiftkube/vendor/k8s.io/kubectl/pkg/cmd/rollout/rollout_resume.go", "Go", 178, 0, 0, 0, 0, 0, 38, 216
"/opt/projects/swiftkube/vendor/k8s.io/kubectl/pkg/cmd/rollout/rollout_status.go", "Go", 202, 0, 0, 0, 0, 0, 42, 244
"/opt/projects/swiftkube/vendor/k8s.io/kubectl/pkg/cmd/rollout/rollout_undo.go", "Go", 148, 0, 0, 0, 0, 0, 32, 180
"/opt/projects/swiftkube/vendor/k8s.io/kubectl/pkg/cmd/run/run.go", "Go", 630, 0, 0, 0, 0, 0, 106, 736
"/opt/projects/swiftkube/vendor/k8s.io/kubectl/pkg/cmd/scale/scale.go", "Go", 233, 0, 0, 0, 0, 0, 46, 279
"/opt/projects/swiftkube/vendor/k8s.io/kubectl/pkg/cmd/set/env/doc.go", "Go", 14, 0, 0, 0, 0, 0, 5, 19
"/opt/projects/swiftkube/vendor/k8s.io/kubectl/pkg/cmd/set/env/env_parse.go", "Go", 123, 0, 0, 0, 0, 0, 16, 139
"/opt/projects/swiftkube/vendor/k8s.io/kubectl/pkg/cmd/set/env/env_resolve.go", "Go", 260, 0, 0, 0, 0, 0, 38, 298
"/opt/projects/swiftkube/vendor/k8s.io/kubectl/pkg/cmd/set/helper.go", "Go", 146, 0, 0, 0, 0, 0, 18, 164
"/opt/projects/swiftkube/vendor/k8s.io/kubectl/pkg/cmd/set/set.go", "Go", 43, 0, 0, 0, 0, 0, 13, 56
"/opt/projects/swiftkube/vendor/k8s.io/kubectl/pkg/cmd/set/set_env.go", "Go", 468, 0, 0, 0, 0, 0, 76, 544
"/opt/projects/swiftkube/vendor/k8s.io/kubectl/pkg/cmd/set/set_image.go", "Go", 276, 0, 0, 0, 0, 0, 57, 333
"/opt/projects/swiftkube/vendor/k8s.io/kubectl/pkg/cmd/set/set_resources.go", "Go", 252, 0, 0, 0, 0, 0, 50, 302
"/opt/projects/swiftkube/vendor/k8s.io/kubectl/pkg/cmd/set/set_selector.go", "Go", 215, 0, 0, 0, 0, 0, 43, 258
"/opt/projects/swiftkube/vendor/k8s.io/kubectl/pkg/cmd/set/set_serviceaccount.go", "Go", 190, 0, 0, 0, 0, 0, 34, 224
"/opt/projects/swiftkube/vendor/k8s.io/kubectl/pkg/cmd/set/set_subject.go", "Go", 275, 0, 0, 0, 0, 0, 46, 321
"/opt/projects/swiftkube/vendor/k8s.io/kubectl/pkg/cmd/skiplookerr_go118.go", "Go", 18, 0, 0, 0, 0, 0, 7, 25
"/opt/projects/swiftkube/vendor/k8s.io/kubectl/pkg/cmd/skiplookerr_go119.go", "Go", 22, 0, 0, 0, 0, 0, 8, 30
"/opt/projects/swiftkube/vendor/k8s.io/kubectl/pkg/cmd/taint/taint.go", "Go", 321, 0, 0, 0, 0, 0, 51, 372
"/opt/projects/swiftkube/vendor/k8s.io/kubectl/pkg/cmd/taint/utils.go", "Go", 189, 0, 0, 0, 0, 0, 26, 215
"/opt/projects/swiftkube/vendor/k8s.io/kubectl/pkg/cmd/top/top.go", "Go", 62, 0, 0, 0, 0, 0, 15, 77
"/opt/projects/swiftkube/vendor/k8s.io/kubectl/pkg/cmd/top/top_node.go", "Go", 195, 0, 0, 0, 0, 0, 35, 230
"/opt/projects/swiftkube/vendor/k8s.io/kubectl/pkg/cmd/top/top_pod.go", "Go", 252, 0, 0, 0, 0, 0, 37, 289
"/opt/projects/swiftkube/vendor/k8s.io/kubectl/pkg/cmd/util/editor/crlf/crlf.go", "Go", 49, 0, 0, 0, 0, 0, 9, 58
"/opt/projects/swiftkube/vendor/k8s.io/kubectl/pkg/cmd/util/editor/editoptions.go", "Go", 810, 0, 0, 0, 0, 0, 110, 920
"/opt/projects/swiftkube/vendor/k8s.io/kubectl/pkg/cmd/util/editor/editor.go", "Go", 151, 0, 0, 0, 0, 0, 17, 168
"/opt/projects/swiftkube/vendor/k8s.io/kubectl/pkg/cmd/util/env_file.go", "Go", 85, 0, 0, 0, 0, 0, 19, 104
"/opt/projects/swiftkube/vendor/k8s.io/kubectl/pkg/cmd/util/factory.go", "Go", 58, 0, 0, 0, 0, 0, 13, 71
"/opt/projects/swiftkube/vendor/k8s.io/kubectl/pkg/cmd/util/factory_client_access.go", "Go", 191, 0, 0, 0, 0, 0, 33, 224
"/opt/projects/swiftkube/vendor/k8s.io/kubectl/pkg/cmd/util/helpers.go", "Go", 809, 0, 0, 0, 0, 0, 95, 904
"/opt/projects/swiftkube/vendor/k8s.io/kubectl/pkg/cmd/util/kubectl_match_version.go", "Go", 107, 0, 0, 0, 0, 0, 23, 130
"/opt/projects/swiftkube/vendor/k8s.io/kubectl/pkg/cmd/util/override_options.go", "Go", 70, 0, 0, 0, 0, 0, 21, 91
"/opt/projects/swiftkube/vendor/k8s.io/kubectl/pkg/cmd/util/podcmd/podcmd.go", "Go", 89, 0, 0, 0, 0, 0, 16, 105
"/opt/projects/swiftkube/vendor/k8s.io/kubectl/pkg/cmd/util/printing.go", "Go", 22, 0, 0, 0, 0, 0, 8, 30
"/opt/projects/swiftkube/vendor/k8s.io/kubectl/pkg/cmd/version/skew_warning.go", "Go", 43, 0, 0, 0, 0, 0, 12, 55
"/opt/projects/swiftkube/vendor/k8s.io/kubectl/pkg/cmd/version/version.go", "Go", 161, 0, 0, 0, 0, 0, 31, 192
"/opt/projects/swiftkube/vendor/k8s.io/kubectl/pkg/cmd/wait/wait.go", "Go", 601, 0, 0, 0, 0, 0, 81, 682
"/opt/projects/swiftkube/vendor/k8s.io/kubectl/pkg/describe/describe.go", "Go", 4955, 0, 0, 0, 0, 0, 585, 5540
"/opt/projects/swiftkube/vendor/k8s.io/kubectl/pkg/describe/interface.go", "Go", 58, 0, 0, 0, 0, 0, 15, 73
"/opt/projects/swiftkube/vendor/k8s.io/kubectl/pkg/drain/cordon.go", "Go", 91, 0, 0, 0, 0, 0, 21, 112
"/opt/projects/swiftkube/vendor/k8s.io/kubectl/pkg/drain/default.go", "Go", 62, 0, 0, 0, 0, 0, 14, 76
"/opt/projects/swiftkube/vendor/k8s.io/kubectl/pkg/drain/drain.go", "Go", 396, 0, 0, 0, 0, 0, 46, 442
"/opt/projects/swiftkube/vendor/k8s.io/kubectl/pkg/drain/filters.go", "Go", 223, 0, 0, 0, 0, 0, 36, 259
"/opt/projects/swiftkube/vendor/k8s.io/kubectl/pkg/explain/explain.go", "Go", 142, 0, 0, 0, 0, 0, 27, 169
"/opt/projects/swiftkube/vendor/k8s.io/kubectl/pkg/explain/field_lookup.go", "Go", 88, 0, 0, 0, 0, 0, 24, 112
"/opt/projects/swiftkube/vendor/k8s.io/kubectl/pkg/explain/fields_printer.go", "Go", 67, 0, 0, 0, 0, 0, 16, 83
"/opt/projects/swiftkube/vendor/k8s.io/kubectl/pkg/explain/fields_printer_builder.go", "Go", 29, 0, 0, 0, 0, 0, 8, 37
"/opt/projects/swiftkube/vendor/k8s.io/kubectl/pkg/explain/formatter.go", "Go", 155, 0, 0, 0, 0, 0, 24, 179
"/opt/projects/swiftkube/vendor/k8s.io/kubectl/pkg/explain/model_printer.go", "Go", 142, 0, 0, 0, 0, 0, 22, 164
"/opt/projects/swiftkube/vendor/k8s.io/kubectl/pkg/explain/recursive_fields_printer.go", "Go", 67, 0, 0, 0, 0, 0, 15, 82
"/opt/projects/swiftkube/vendor/k8s.io/kubectl/pkg/explain/typename.go", "Go", 52, 0, 0, 0, 0, 0, 15, 67
"/opt/projects/swiftkube/vendor/k8s.io/kubectl/pkg/explain/v2/explain.go", "Go", 79, 0, 0, 0, 0, 0, 19, 98
"/opt/projects/swiftkube/vendor/k8s.io/kubectl/pkg/explain/v2/funcs.go", "Go", 212, 0, 0, 0, 0, 0, 29, 241
"/opt/projects/swiftkube/vendor/k8s.io/kubectl/pkg/explain/v2/generator.go", "Go", 86, 0, 0, 0, 0, 0, 17, 103
"/opt/projects/swiftkube/vendor/k8s.io/kubectl/pkg/explain/v2/template.go", "Go", 39, 0, 0, 0, 0, 0, 12, 51
"/opt/projects/swiftkube/vendor/k8s.io/kubectl/pkg/explain/v2/templates/plaintext.tmpl", "Go Template File", 0, 0, 0, 255, 0, 0, 28, 283
"/opt/projects/swiftkube/vendor/k8s.io/kubectl/pkg/generate/generate.go", "Go", 185, 0, 0, 0, 0, 0, 23, 208
"/opt/projects/swiftkube/vendor/k8s.io/kubectl/pkg/generate/versioned/generator.go", "Go", 40, 0, 0, 0, 0, 0, 10, 50
"/opt/projects/swiftkube/vendor/k8s.io/kubectl/pkg/generate/versioned/run.go", "Go", 339, 0, 0, 0, 0, 0, 41, 380
"/opt/projects/swiftkube/vendor/k8s.io/kubectl/pkg/generate/versioned/service.go", "Go", 218, 0, 0, 0, 0, 0, 23, 241
"/opt/projects/swiftkube/vendor/k8s.io/kubectl/pkg/metricsutil/metrics_printer.go", "Go", 203, 0, 0, 0, 0, 0, 34, 237
"/opt/projects/swiftkube/vendor/k8s.io/kubectl/pkg/metricsutil/metrics_resource_adder.go", "Go", 37, 0, 0, 0, 0, 0, 9, 46
"/opt/projects/swiftkube/vendor/k8s.io/kubectl/pkg/metricsutil/metrics_sorter.go", "Go", 109, 0, 0, 0, 0, 0, 22, 131
"/opt/projects/swiftkube/vendor/k8s.io/kubectl/pkg/polymorphichelpers/attachablepodforobject.go", "Go", 45, 0, 0, 0, 0, 0, 10, 55
"/opt/projects/swiftkube/vendor/k8s.io/kubectl/pkg/polymorphichelpers/canbeexposed.go", "Go", 37, 0, 0, 0, 0, 0, 8, 45
"/opt/projects/swiftkube/vendor/k8s.io/kubectl/pkg/polymorphichelpers/helpers.go", "Go", 171, 0, 0, 0, 0, 0, 21, 192
"/opt/projects/swiftkube/vendor/k8s.io/kubectl/pkg/polymorphichelpers/history.go", "Go", 421, 0, 0, 0, 0, 0, 57, 478
"/opt/projects/swiftkube/vendor/k8s.io/kubectl/pkg/polymorphichelpers/historyviewer.go", "Go", 30, 0, 0, 0, 0, 0, 8, 38
"/opt/projects/swiftkube/vendor/k8s.io/kubectl/pkg/polymorphichelpers/interface.go", "Go", 90, 0, 0, 0, 0, 0, 35, 125
"/opt/projects/swiftkube/vendor/k8s.io/kubectl/pkg/polymorphichelpers/logsforobject.go", "Go", 150, 0, 0, 0, 0, 0, 20, 170
"/opt/projects/swiftkube/vendor/k8s.io/kubectl/pkg/polymorphichelpers/mapbasedselectorforobject.go", "Go", 141, 0, 0, 0, 0, 0, 20, 161
"/opt/projects/swiftkube/vendor/k8s.io/kubectl/pkg/polymorphichelpers/multiprotocolsforobject.go", "Go", 81, 0, 0, 0, 0, 0, 15, 96
"/opt/projects/swiftkube/vendor/k8s.io/kubectl/pkg/polymorphichelpers/objectpauser.go", "Go", 54, 0, 0, 0, 0, 0, 12, 66
"/opt/projects/swiftkube/vendor/k8s.io/kubectl/pkg/polymorphichelpers/objectrestarter.go", "Go", 102, 0, 0, 0, 0, 0, 18, 120
"/opt/projects/swiftkube/vendor/k8s.io/kubectl/pkg/polymorphichelpers/objectresumer.go", "Go", 53, 0, 0, 0, 0, 0, 12, 65
"/opt/projects/swiftkube/vendor/k8s.io/kubectl/pkg/polymorphichelpers/portsforobject.go", "Go", 77, 0, 0, 0, 0, 0, 14, 91
"/opt/projects/swiftkube/vendor/k8s.io/kubectl/pkg/polymorphichelpers/protocolsforobject.go", "Go", 75, 0, 0, 0, 0, 0, 15, 90
"/opt/projects/swiftkube/vendor/k8s.io/kubectl/pkg/polymorphichelpers/rollback.go", "Go", 437, 0, 0, 0, 0, 0, 64, 501
"/opt/projects/swiftkube/vendor/k8s.io/kubectl/pkg/polymorphichelpers/rollbacker.go", "Go", 30, 0, 0, 0, 0, 0, 8, 38
"/opt/projects/swiftkube/vendor/k8s.io/kubectl/pkg/polymorphichelpers/rollout_status.go", "Go", 133, 0, 0, 0, 0, 0, 20, 153
"/opt/projects/swiftkube/vendor/k8s.io/kubectl/pkg/polymorphichelpers/statusviewer.go", "Go", 20, 0, 0, 0, 0, 0, 7, 27
"/opt/projects/swiftkube/vendor/k8s.io/kubectl/pkg/polymorphichelpers/updatepodspec.go", "Go", 76, 0, 0, 0, 0, 0, 15, 91
"/opt/projects/swiftkube/vendor/k8s.io/kubectl/pkg/proxy/proxy_server.go", "Go", 247, 0, 0, 0, 0, 0, 31, 278
"/opt/projects/swiftkube/vendor/k8s.io/kubectl/pkg/rawhttp/raw.go", "Go", 78, 0, 0, 0, 0, 0, 18, 96
"/opt/projects/swiftkube/vendor/k8s.io/kubectl/pkg/scale/scale.go", "Go", 192, 0, 0, 0, 0, 0, 23, 215
"/opt/projects/swiftkube/vendor/k8s.io/kubectl/pkg/scheme/install.go", "Go", 75, 0, 0, 0, 0, 0, 8, 83
"/opt/projects/swiftkube/vendor/k8s.io/kubectl/pkg/scheme/scheme.go", "Go", 29, 0, 0, 0, 0, 0, 11, 40
"/opt/projects/swiftkube/vendor/k8s.io/kubectl/pkg/util/apply.go", "Go", 120, 0, 0, 0, 0, 0, 27, 147
"/opt/projects/swiftkube/vendor/k8s.io/kubectl/pkg/util/certificate/certificate.go", "Go", 31, 0, 0, 0, 0, 0, 8, 39
"/opt/projects/swiftkube/vendor/k8s.io/kubectl/pkg/util/completion/completion.go", "Go", 410, 0, 0, 0, 0, 0, 48, 458
"/opt/projects/swiftkube/vendor/k8s.io/kubectl/pkg/util/deployment/deployment.go", "Go", 235, 0, 0, 0, 0, 0, 23, 258
"/opt/projects/swiftkube/vendor/k8s.io/kubectl/pkg/util/event/sorted_event_list.go", "Go", 27, 0, 0, 0, 0, 0, 10, 37
"/opt/projects/swiftkube/vendor/k8s.io/kubectl/pkg/util/fieldpath/fieldpath.go", "Go", 98, 0, 0, 0, 0, 0, 15, 113
"/opt/projects/swiftkube/vendor/k8s.io/kubectl/pkg/util/hash/hash.go", "Go", 118, 0, 0, 0, 0, 0, 13, 131
"/opt/projects/swiftkube/vendor/k8s.io/kubectl/pkg/util/i18n/i18n.go", "Go", 193, 0, 0, 0, 0, 0, 23, 216
"/opt/projects/swiftkube/vendor/k8s.io/kubectl/pkg/util/interrupt/interrupt.go", "Go", 92, 0, 0, 0, 0, 0, 13, 105
"/opt/projects/swiftkube/vendor/k8s.io/kubectl/pkg/util/openapi/doc.go", "Go", 17, 0, 0, 0, 0, 0, 5, 22
"/opt/projects/swiftkube/vendor/k8s.io/kubectl/pkg/util/openapi/openapi.go", "Go", 145, 0, 0, 0, 0, 0, 26, 171
"/opt/projects/swiftkube/vendor/k8s.io/kubectl/pkg/util/openapi/openapi_getter.go", "Go", 65, 0, 0, 0, 0, 0, 18, 83
"/opt/projects/swiftkube/vendor/k8s.io/kubectl/pkg/util/pod_port.go", "Go", 28, 0, 0, 0, 0, 0, 9, 37
"/opt/projects/swiftkube/vendor/k8s.io/kubectl/pkg/util/podutils/podutils.go", "Go", 223, 0, 0, 0, 0, 0, 30, 253
"/opt/projects/swiftkube/vendor/k8s.io/kubectl/pkg/util/prune/prune.go", "Go", 103, 0, 0, 0, 0, 0, 17, 120
"/opt/projects/swiftkube/vendor/k8s.io/kubectl/pkg/util/qos/qos.go", "Go", 90, 0, 0, 0, 0, 0, 10, 100
"/opt/projects/swiftkube/vendor/k8s.io/kubectl/pkg/util/rbac/rbac.go", "Go", 112, 0, 0, 0, 0, 0, 24, 136
"/opt/projects/swiftkube/vendor/k8s.io/kubectl/pkg/util/resource/resource.go", "Go", 152, 0, 0, 0, 0, 0, 21, 173
"/opt/projects/swiftkube/vendor/k8s.io/kubectl/pkg/util/service_port.go", "Go", 50, 0, 0, 0, 0, 0, 10, 60
"/opt/projects/swiftkube/vendor/k8s.io/kubectl/pkg/util/slice/slice.go", "Go", 49, 0, 0, 0, 0, 0, 9, 58
"/opt/projects/swiftkube/vendor/k8s.io/kubectl/pkg/util/storage/storage.go", "Go", 92, 0, 0, 0, 0, 0, 19, 111
"/opt/projects/swiftkube/vendor/k8s.io/kubectl/pkg/util/templates/command_groups.go", "Go", 49, 0, 0, 0, 0, 0, 11, 60
"/opt/projects/swiftkube/vendor/k8s.io/kubectl/pkg/util/templates/help_flags_printer.go", "Go", 62, 0, 0, 0, 0, 0, 15, 77
"/opt/projects/swiftkube/vendor/k8s.io/kubectl/pkg/util/templates/markdown.go", "Go", 101, 0, 0, 0, 0, 0, 16, 117
"/opt/projects/swiftkube/vendor/k8s.io/kubectl/pkg/util/templates/normalizers.go", "Go", 81, 0, 0, 0, 0, 0, 17, 98
"/opt/projects/swiftkube/vendor/k8s.io/kubectl/pkg/util/templates/templater.go", "Go", 283, 0, 0, 0, 0, 0, 37, 320
"/opt/projects/swiftkube/vendor/k8s.io/kubectl/pkg/util/templates/templates.go", "Go", 81, 0, 0, 0, 0, 0, 24, 105
"/opt/projects/swiftkube/vendor/k8s.io/kubectl/pkg/util/term/resize.go", "Go", 109, 0, 0, 0, 0, 0, 24, 133
"/opt/projects/swiftkube/vendor/k8s.io/kubectl/pkg/util/term/resizeevents.go", "Go", 51, 0, 0, 0, 0, 0, 12, 63
"/opt/projects/swiftkube/vendor/k8s.io/kubectl/pkg/util/term/resizeevents_windows.go", "Go", 50, 0, 0, 0, 0, 0, 13, 63
"/opt/projects/swiftkube/vendor/k8s.io/kubectl/pkg/util/term/term.go", "Go", 115, 0, 0, 0, 0, 0, 23, 138
"/opt/projects/swiftkube/vendor/k8s.io/kubectl/pkg/util/term/term_writer.go", "Go", 127, 0, 0, 0, 0, 0, 20, 147
"/opt/projects/swiftkube/vendor/k8s.io/kubectl/pkg/util/umask.go", "Go", 22, 0, 0, 0, 0, 0, 8, 30
"/opt/projects/swiftkube/vendor/k8s.io/kubectl/pkg/util/umask_windows.go", "Go", 22, 0, 0, 0, 0, 0, 8, 30
"/opt/projects/swiftkube/vendor/k8s.io/kubectl/pkg/util/util.go", "Go", 82, 0, 0, 0, 0, 0, 12, 94
"/opt/projects/swiftkube/vendor/k8s.io/kubectl/pkg/validation/schema.go", "Go", 134, 0, 0, 0, 0, 0, 20, 154
"/opt/projects/swiftkube/vendor/k8s.io/kubectl/pkg/validation/validation.go", "Go", 120, 0, 0, 0, 0, 0, 21, 141
"/opt/projects/swiftkube/vendor/k8s.io/kubelet/config/v1/doc.go", "Go", 16, 0, 0, 0, 0, 0, 6, 22
"/opt/projects/swiftkube/vendor/k8s.io/kubelet/config/v1/register.go", "Go", 34, 0, 0, 0, 0, 0, 10, 44
"/opt/projects/swiftkube/vendor/k8s.io/kubelet/config/v1/types.go", "Go", 82, 0, 0, 0, 0, 0, 16, 98
"/opt/projects/swiftkube/vendor/k8s.io/kubelet/config/v1/zz_generated.deepcopy.go", "Go", 97, 0, 0, 0, 0, 0, 15, 112
"/opt/projects/swiftkube/vendor/k8s.io/kubelet/config/v1alpha1/doc.go", "Go", 16, 0, 0, 0, 0, 0, 6, 22
"/opt/projects/swiftkube/vendor/k8s.io/kubelet/config/v1alpha1/register.go", "Go", 34, 0, 0, 0, 0, 0, 10, 44
"/opt/projects/swiftkube/vendor/k8s.io/kubelet/config/v1alpha1/types.go", "Go", 82, 0, 0, 0, 0, 0, 16, 98
"/opt/projects/swiftkube/vendor/k8s.io/kubelet/config/v1alpha1/zz_generated.deepcopy.go", "Go", 97, 0, 0, 0, 0, 0, 15, 112
"/opt/projects/swiftkube/vendor/k8s.io/kubelet/config/v1beta1/doc.go", "Go", 16, 0, 0, 0, 0, 0, 6, 22
"/opt/projects/swiftkube/vendor/k8s.io/kubelet/config/v1beta1/register.go", "Go", 36, 0, 0, 0, 0, 0, 10, 46
"/opt/projects/swiftkube/vendor/k8s.io/kubelet/config/v1beta1/types.go", "Go", 970, 0, 0, 0, 0, 0, 42, 1012
"/opt/projects/swiftkube/vendor/k8s.io/kubelet/config/v1beta1/zz_generated.deepcopy.go", "Go", 595, 0, 0, 0, 0, 0, 39, 634
"/opt/projects/swiftkube/vendor/k8s.io/kubelet/pkg/apis/credentialprovider/doc.go", "Go", 15, 0, 0, 0, 0, 0, 6, 21
"/opt/projects/swiftkube/vendor/k8s.io/kubelet/pkg/apis/credentialprovider/install/install.go", "Go", 31, 0, 0, 0, 0, 0, 7, 38
"/opt/projects/swiftkube/vendor/k8s.io/kubelet/pkg/apis/credentialprovider/register.go", "Go", 32, 0, 0, 0, 0, 0, 10, 42
"/opt/projects/swiftkube/vendor/k8s.io/kubelet/pkg/apis/credentialprovider/types.go", "Go", 100, 0, 0, 0, 0, 0, 18, 118
"/opt/projects/swiftkube/vendor/k8s.io/kubelet/pkg/apis/credentialprovider/v1/doc.go", "Go", 17, 0, 0, 0, 0, 0, 6, 23
"/opt/projects/swiftkube/vendor/k8s.io/kubelet/pkg/apis/credentialprovider/v1/register.go", "Go", 37, 0, 0, 0, 0, 0, 10, 47
"/opt/projects/swiftkube/vendor/k8s.io/kubelet/pkg/apis/credentialprovider/v1/types.go", "Go", 100, 0, 0, 0, 0, 0, 18, 118
"/opt/projects/swiftkube/vendor/k8s.io/kubelet/pkg/apis/credentialprovider/v1/zz_generated.conversion.go", "Go", 115, 0, 0, 0, 0, 0, 23, 138
"/opt/projects/swiftkube/vendor/k8s.io/kubelet/pkg/apis/credentialprovider/v1/zz_generated.deepcopy.go", "Go", 90, 0, 0, 0, 0, 0, 16, 106
"/opt/projects/swiftkube/vendor/k8s.io/kubelet/pkg/apis/credentialprovider/v1/zz_generated.defaults.go", "Go", 25, 0, 0, 0, 0, 0, 9, 34
"/opt/projects/swiftkube/vendor/k8s.io/kubelet/pkg/apis/credentialprovider/v1alpha1/doc.go", "Go", 17, 0, 0, 0, 0, 0, 6, 23
"/opt/projects/swiftkube/vendor/k8s.io/kubelet/pkg/apis/credentialprovider/v1alpha1/register.go", "Go", 37, 0, 0, 0, 0, 0, 10, 47
"/opt/projects/swiftkube/vendor/k8s.io/kubelet/pkg/apis/credentialprovider/v1alpha1/types.go", "Go", 100, 0, 0, 0, 0, 0, 18, 118
"/opt/projects/swiftkube/vendor/k8s.io/kubelet/pkg/apis/credentialprovider/v1alpha1/zz_generated.conversion.go", "Go", 115, 0, 0, 0, 0, 0, 23, 138
"/opt/projects/swiftkube/vendor/k8s.io/kubelet/pkg/apis/credentialprovider/v1alpha1/zz_generated.deepcopy.go", "Go", 90, 0, 0, 0, 0, 0, 16, 106
"/opt/projects/swiftkube/vendor/k8s.io/kubelet/pkg/apis/credentialprovider/v1alpha1/zz_generated.defaults.go", "Go", 25, 0, 0, 0, 0, 0, 9, 34
"/opt/projects/swiftkube/vendor/k8s.io/kubelet/pkg/apis/credentialprovider/v1beta1/doc.go", "Go", 17, 0, 0, 0, 0, 0, 6, 23
"/opt/projects/swiftkube/vendor/k8s.io/kubelet/pkg/apis/credentialprovider/v1beta1/register.go", "Go", 37, 0, 0, 0, 0, 0, 10, 47
"/opt/projects/swiftkube/vendor/k8s.io/kubelet/pkg/apis/credentialprovider/v1beta1/types.go", "Go", 100, 0, 0, 0, 0, 0, 18, 118
"/opt/projects/swiftkube/vendor/k8s.io/kubelet/pkg/apis/credentialprovider/v1beta1/zz_generated.conversion.go", "Go", 115, 0, 0, 0, 0, 0, 23, 138
"/opt/projects/swiftkube/vendor/k8s.io/kubelet/pkg/apis/credentialprovider/v1beta1/zz_generated.deepcopy.go", "Go", 90, 0, 0, 0, 0, 0, 16, 106
"/opt/projects/swiftkube/vendor/k8s.io/kubelet/pkg/apis/credentialprovider/v1beta1/zz_generated.defaults.go", "Go", 25, 0, 0, 0, 0, 0, 9, 34
"/opt/projects/swiftkube/vendor/k8s.io/kubelet/pkg/apis/credentialprovider/zz_generated.deepcopy.go", "Go", 90, 0, 0, 0, 0, 0, 16, 106
"/opt/projects/swiftkube/vendor/k8s.io/kubelet/pkg/apis/deviceplugin/v1beta1/api.pb.go", "Go", 5134, 0, 0, 0, 0, 0, 244, 5378
"/opt/projects/swiftkube/vendor/k8s.io/kubelet/pkg/apis/deviceplugin/v1beta1/api.proto", "Protocol Buffers", 0, 0, 103, 0, 0, 90, 31, 224
"/opt/projects/swiftkube/vendor/k8s.io/kubelet/pkg/apis/deviceplugin/v1beta1/constants.go", "Go", 39, 0, 0, 0, 0, 0, 10, 49
"/opt/projects/swiftkube/vendor/k8s.io/kubelet/pkg/apis/dra/v1alpha2/api.pb.go", "Go", 1244, 0, 0, 0, 0, 0, 69, 1313
"/opt/projects/swiftkube/vendor/k8s.io/kubelet/pkg/apis/dra/v1alpha2/api.proto", "Protocol Buffers", 0, 0, 46, 0, 0, 21, 15, 82
"/opt/projects/swiftkube/vendor/k8s.io/kubelet/pkg/apis/dra/v1alpha3/api.pb.go", "Go", 2040, 0, 0, 0, 0, 0, 95, 2135
"/opt/projects/swiftkube/vendor/k8s.io/kubelet/pkg/apis/dra/v1alpha3/api.proto", "Protocol Buffers", 0, 0, 54, 0, 0, 32, 18, 104
"/opt/projects/swiftkube/vendor/k8s.io/kubelet/pkg/apis/pluginregistration/v1/api.pb.go", "Go", 1083, 0, 0, 0, 0, 0, 66, 1149
"/opt/projects/swiftkube/vendor/k8s.io/kubelet/pkg/apis/pluginregistration/v1/api.proto", "Protocol Buffers", 0, 0, 29, 0, 0, 24, 9, 62
"/opt/projects/swiftkube/vendor/k8s.io/kubelet/pkg/apis/pluginregistration/v1/constants.go", "Go", 21, 0, 0, 0, 0, 0, 6, 27
"/opt/projects/swiftkube/vendor/k8s.io/kubelet/pkg/apis/podresources/v1/api.pb.go", "Go", 3925, 0, 0, 0, 0, 0, 179, 4104
"/opt/projects/swiftkube/vendor/k8s.io/kubelet/pkg/apis/podresources/v1/api.proto", "Protocol Buffers", 0, 0, 73, 0, 0, 21, 21, 115
"/opt/projects/swiftkube/vendor/k8s.io/kubelet/pkg/apis/podresources/v1alpha1/api.pb.go", "Go", 1314, 0, 0, 0, 0, 0, 74, 1388
"/opt/projects/swiftkube/vendor/k8s.io/kubelet/pkg/apis/podresources/v1alpha1/api.proto", "Protocol Buffers", 0, 0, 31, 0, 0, 8, 11, 50
"/opt/projects/swiftkube/vendor/k8s.io/kubelet/pkg/apis/stats/v1alpha1/types.go", "Go", 338, 0, 0, 0, 0, 0, 43, 381
"/opt/projects/swiftkube/vendor/k8s.io/kubelet/pkg/apis/well_known_labels.go", "Go", 71, 0, 0, 0, 0, 0, 17, 88
"/opt/projects/swiftkube/vendor/k8s.io/kubelet/pkg/cri/streaming/errors.go", "Go", 43, 0, 0, 0, 0, 0, 9, 52
"/opt/projects/swiftkube/vendor/k8s.io/kubelet/pkg/cri/streaming/portforward/constants.go", "Go", 18, 0, 0, 0, 0, 0, 7, 25
"/opt/projects/swiftkube/vendor/k8s.io/kubelet/pkg/cri/streaming/portforward/httpstream.go", "Go", 275, 0, 0, 0, 0, 0, 41, 316
"/opt/projects/swiftkube/vendor/k8s.io/kubelet/pkg/cri/streaming/portforward/portforward.go", "Go", 45, 0, 0, 0, 0, 0, 10, 55
"/opt/projects/swiftkube/vendor/k8s.io/kubelet/pkg/cri/streaming/portforward/websocket.go", "Go", 173, 0, 0, 0, 0, 0, 27, 200
"/opt/projects/swiftkube/vendor/k8s.io/kubelet/pkg/cri/streaming/remotecommand/attach.go", "Go", 51, 0, 0, 0, 0, 0, 10, 61
"/opt/projects/swiftkube/vendor/k8s.io/kubelet/pkg/cri/streaming/remotecommand/doc.go", "Go", 14, 0, 0, 0, 0, 0, 5, 19
"/opt/projects/swiftkube/vendor/k8s.io/kubelet/pkg/cri/streaming/remotecommand/exec.go", "Go", 71, 0, 0, 0, 0, 0, 10, 81
"/opt/projects/swiftkube/vendor/k8s.io/kubelet/pkg/cri/streaming/remotecommand/httpstream.go", "Go", 396, 0, 0, 0, 0, 0, 52, 448
"/opt/projects/swiftkube/vendor/k8s.io/kubelet/pkg/cri/streaming/remotecommand/websocket.go", "Go", 116, 0, 0, 0, 0, 0, 17, 133
"/opt/projects/swiftkube/vendor/k8s.io/kubelet/pkg/cri/streaming/request_cache.go", "Go", 125, 0, 0, 0, 0, 0, 22, 147
"/opt/projects/swiftkube/vendor/k8s.io/kubelet/pkg/cri/streaming/server.go", "Go", 337, 0, 0, 0, 0, 0, 47, 384
"/opt/projects/swiftkube/vendor/k8s.io/kubernetes/cmd/kubelet/app/auth.go", "Go", 118, 0, 0, 0, 0, 0, 23, 141
"/opt/projects/swiftkube/vendor/k8s.io/kubernetes/cmd/kubelet/app/init_others.go", "Go", 18, 0, 0, 0, 0, 0, 7, 25
"/opt/projects/swiftkube/vendor/k8s.io/kubernetes/cmd/kubelet/app/init_windows.go", "Go", 82, 0, 0, 0, 0, 0, 14, 96
"/opt/projects/swiftkube/vendor/k8s.io/kubernetes/cmd/kubelet/app/options/container_runtime.go", "Go", 32, 0, 0, 0, 0, 0, 9, 41
"/opt/projects/swiftkube/vendor/k8s.io/kubernetes/cmd/kubelet/app/options/globalflags.go", "Go", 72, 0, 0, 0, 0, 0, 17, 89
"/opt/projects/swiftkube/vendor/k8s.io/kubernetes/cmd/kubelet/app/options/globalflags_linux.go", "Go", 57, 0, 0, 0, 0, 0, 14, 71
"/opt/projects/swiftkube/vendor/k8s.io/kubernetes/cmd/kubelet/app/options/globalflags_other.go", "Go", 20, 0, 0, 0, 0, 0, 8, 28
"/opt/projects/swiftkube/vendor/k8s.io/kubernetes/cmd/kubelet/app/options/globalflags_providerless.go", "Go", 21, 0, 0, 0, 0, 0, 8, 29
"/opt/projects/swiftkube/vendor/k8s.io/kubernetes/cmd/kubelet/app/options/globalflags_providers.go", "Go", 24, 0, 0, 0, 0, 0, 8, 32
"/opt/projects/swiftkube/vendor/k8s.io/kubernetes/cmd/kubelet/app/options/options.go", "Go", 454, 0, 0, 0, 0, 0, 66, 520
"/opt/projects/swiftkube/vendor/k8s.io/kubernetes/cmd/kubelet/app/options/osflags_others.go", "Go", 20, 0, 0, 0, 0, 0, 8, 28
"/opt/projects/swiftkube/vendor/k8s.io/kubernetes/cmd/kubelet/app/options/osflags_windows.go", "Go", 27, 0, 0, 0, 0, 0, 8, 35
"/opt/projects/swiftkube/vendor/k8s.io/kubernetes/cmd/kubelet/app/plugins.go", "Go", 71, 0, 0, 0, 0, 0, 11, 82
"/opt/projects/swiftkube/vendor/k8s.io/kubernetes/cmd/kubelet/app/plugins_providerless.go", "Go", 23, 0, 0, 0, 0, 0, 9, 32
"/opt/projects/swiftkube/vendor/k8s.io/kubernetes/cmd/kubelet/app/plugins_providers.go", "Go", 67, 0, 0, 0, 0, 0, 14, 81
"/opt/projects/swiftkube/vendor/k8s.io/kubernetes/cmd/kubelet/app/server.go", "Go", 1237, 0, 0, 0, 0, 0, 155, 1392
"/opt/projects/swiftkube/vendor/k8s.io/kubernetes/cmd/kubelet/app/server_linux.go", "Go", 44, 0, 0, 0, 0, 0, 9, 53
"/opt/projects/swiftkube/vendor/k8s.io/kubernetes/cmd/kubelet/app/server_others.go", "Go", 27, 0, 0, 0, 0, 0, 8, 35
"/opt/projects/swiftkube/vendor/k8s.io/kubernetes/cmd/kubelet/app/server_unsupported.go", "Go", 22, 0, 0, 0, 0, 0, 9, 31
"/opt/projects/swiftkube/vendor/k8s.io/kubernetes/cmd/kubelet/app/server_windows.go", "Go", 35, 0, 0, 0, 0, 0, 13, 48
"/opt/projects/swiftkube/vendor/k8s.io/kubernetes/pkg/api/legacyscheme/scheme.go", "Go", 29, 0, 0, 0, 0, 0, 9, 38
"/opt/projects/swiftkube/vendor/k8s.io/kubernetes/pkg/api/service/util.go", "Go", 73, 0, 0, 0, 0, 0, 14, 87
"/opt/projects/swiftkube/vendor/k8s.io/kubernetes/pkg/api/service/warnings.go", "Go", 90, 0, 0, 0, 0, 0, 17, 107
"/opt/projects/swiftkube/vendor/k8s.io/kubernetes/pkg/api/v1/pod/util.go", "Go", 358, 0, 0, 0, 0, 0, 40, 398
"/opt/projects/swiftkube/vendor/k8s.io/kubernetes/pkg/api/v1/resource/helpers.go", "Go", 388, 0, 0, 0, 0, 0, 60, 448
"/opt/projects/swiftkube/vendor/k8s.io/kubernetes/pkg/api/v1/service/util.go", "Go", 80, 0, 0, 0, 0, 0, 14, 94
"/opt/projects/swiftkube/vendor/k8s.io/kubernetes/pkg/apis/apps/doc.go", "Go", 14, 0, 0, 0, 0, 0, 6, 20
"/opt/projects/swiftkube/vendor/k8s.io/kubernetes/pkg/apis/apps/register.go", "Go", 55, 0, 0, 0, 0, 0, 12, 67
"/opt/projects/swiftkube/vendor/k8s.io/kubernetes/pkg/apis/apps/types.go", "Go", 776, 0, 0, 0, 0, 0, 145, 921
"/opt/projects/swiftkube/vendor/k8s.io/kubernetes/pkg/apis/apps/validation/validation.go", "Go", 697, 0, 0, 0, 0, 0, 83, 780
"/opt/projects/swiftkube/vendor/k8s.io/kubernetes/pkg/apis/apps/zz_generated.deepcopy.go", "Go", 768, 0, 0, 0, 0, 0, 83, 851
"/opt/projects/swiftkube/vendor/k8s.io/kubernetes/pkg/apis/autoscaling/annotations.go", "Go", 29, 0, 0, 0, 0, 0, 10, 39
"/opt/projects/swiftkube/vendor/k8s.io/kubernetes/pkg/apis/autoscaling/doc.go", "Go", 14, 0, 0, 0, 0, 0, 6, 20
"/opt/projects/swiftkube/vendor/k8s.io/kubernetes/pkg/apis/autoscaling/helpers.go", "Go", 52, 0, 0, 0, 0, 0, 7, 59
"/opt/projects/swiftkube/vendor/k8s.io/kubernetes/pkg/apis/autoscaling/register.go", "Go", 44, 0, 0, 0, 0, 0, 12, 56
"/opt/projects/swiftkube/vendor/k8s.io/kubernetes/pkg/apis/autoscaling/types.go", "Go", 491, 0, 0, 0, 0, 0, 69, 560
"/opt/projects/swiftkube/vendor/k8s.io/kubernetes/pkg/apis/autoscaling/zz_generated.deepcopy.go", "Go", 606, 0, 0, 0, 0, 0, 65, 671
"/opt/projects/swiftkube/vendor/k8s.io/kubernetes/pkg/apis/core/annotation_key_constants.go", "Go", 120, 0, 0, 0, 0, 0, 26, 146
"/opt/projects/swiftkube/vendor/k8s.io/kubernetes/pkg/apis/core/doc.go", "Go", 19, 0, 0, 0, 0, 0, 6, 25
"/opt/projects/swiftkube/vendor/k8s.io/kubernetes/pkg/apis/core/helper/helpers.go", "Go", 440, 0, 0, 0, 0, 0, 63, 503
"/opt/projects/swiftkube/vendor/k8s.io/kubernetes/pkg/apis/core/helper/qos/qos.go", "Go", 93, 0, 0, 0, 0, 0, 10, 103
"/opt/projects/swiftkube/vendor/k8s.io/kubernetes/pkg/apis/core/install/install.go", "Go", 31, 0, 0, 0, 0, 0, 8, 39
"/opt/projects/swiftkube/vendor/k8s.io/kubernetes/pkg/apis/core/json.go", "Go", 22, 0, 0, 0, 0, 0, 10, 32
"/opt/projects/swiftkube/vendor/k8s.io/kubernetes/pkg/apis/core/objectreference.go", "Go", 28, 0, 0, 0, 0, 0, 10, 38
"/opt/projects/swiftkube/vendor/k8s.io/kubernetes/pkg/apis/core/pods/helpers.go", "Go", 86, 0, 0, 0, 0, 0, 12, 98
"/opt/projects/swiftkube/vendor/k8s.io/kubernetes/pkg/apis/core/register.go", "Go", 89, 0, 0, 0, 0, 0, 14, 103
"/opt/projects/swiftkube/vendor/k8s.io/kubernetes/pkg/apis/core/resource.go", "Go", 46, 0, 0, 0, 0, 0, 13, 59
"/opt/projects/swiftkube/vendor/k8s.io/kubernetes/pkg/apis/core/taint.go", "Go", 34, 0, 0, 0, 0, 0, 9, 43
"/opt/projects/swiftkube/vendor/k8s.io/kubernetes/pkg/apis/core/toleration.go", "Go", 24, 0, 0, 0, 0, 0, 7, 31
"/opt/projects/swiftkube/vendor/k8s.io/kubernetes/pkg/apis/core/types.go", "Go", 5536, 0, 0, 0, 0, 0, 613, 6149
"/opt/projects/swiftkube/vendor/k8s.io/kubernetes/pkg/apis/core/v1/conversion.go", "Go", 496, 0, 0, 0, 0, 0, 61, 557
"/opt/projects/swiftkube/vendor/k8s.io/kubernetes/pkg/apis/core/v1/defaults.go", "Go", 459, 0, 0, 0, 0, 0, 28, 487
"/opt/projects/swiftkube/vendor/k8s.io/kubernetes/pkg/apis/core/v1/doc.go", "Go", 18, 0, 0, 0, 0, 0, 6, 24
"/opt/projects/swiftkube/vendor/k8s.io/kubernetes/pkg/apis/core/v1/helper/helpers.go", "Go", 325, 0, 0, 0, 0, 0, 42, 367
"/opt/projects/swiftkube/vendor/k8s.io/kubernetes/pkg/apis/core/v1/helper/qos/qos.go", "Go", 92, 0, 0, 0, 0, 0, 11, 103
"/opt/projects/swiftkube/vendor/k8s.io/kubernetes/pkg/apis/core/v1/register.go", "Go", 36, 0, 0, 0, 0, 0, 11, 47
"/opt/projects/swiftkube/vendor/k8s.io/kubernetes/pkg/apis/core/v1/validation/validation.go", "Go", 149, 0, 0, 0, 0, 0, 22, 171
"/opt/projects/swiftkube/vendor/k8s.io/kubernetes/pkg/apis/core/v1/zz_generated.conversion.go", "Go", 7752, 0, 0, 0, 0, 0, 885, 8637
"/opt/projects/swiftkube/vendor/k8s.io/kubernetes/pkg/apis/core/v1/zz_generated.defaults.go", "Go", 1057, 0, 0, 0, 0, 0, 36, 1093
"/opt/projects/swiftkube/vendor/k8s.io/kubernetes/pkg/apis/core/validation/doc.go", "Go", 15, 0, 0, 0, 0, 0, 5, 20
"/opt/projects/swiftkube/vendor/k8s.io/kubernetes/pkg/apis/core/validation/events.go", "Go", 172, 0, 0, 0, 0, 0, 22, 194
"/opt/projects/swiftkube/vendor/k8s.io/kubernetes/pkg/apis/core/validation/validation.go", "Go", 6779, 0, 0, 0, 0, 0, 897, 7676
"/opt/projects/swiftkube/vendor/k8s.io/kubernetes/pkg/apis/core/zz_generated.deepcopy.go", "Go", 5766, 0, 0, 0, 0, 0, 491, 6257
"/opt/projects/swiftkube/vendor/k8s.io/kubernetes/pkg/apis/policy/doc.go", "Go", 14, 0, 0, 0, 0, 0, 6, 20
"/opt/projects/swiftkube/vendor/k8s.io/kubernetes/pkg/apis/policy/helper.go", "Go", 41, 0, 0, 0, 0, 0, 11, 52
"/opt/projects/swiftkube/vendor/k8s.io/kubernetes/pkg/apis/policy/register.go", "Go", 47, 0, 0, 0, 0, 0, 12, 59
"/opt/projects/swiftkube/vendor/k8s.io/kubernetes/pkg/apis/policy/types.go", "Go", 468, 0, 0, 0, 0, 0, 62, 530
"/opt/projects/swiftkube/vendor/k8s.io/kubernetes/pkg/apis/policy/validation/validation.go", "Go", 525, 0, 0, 0, 0, 0, 78, 603
"/opt/projects/swiftkube/vendor/k8s.io/kubernetes/pkg/apis/policy/zz_generated.deepcopy.go", "Go", 498, 0, 0, 0, 0, 0, 51, 549
"/opt/projects/swiftkube/vendor/k8s.io/kubernetes/pkg/apis/scheduling/doc.go", "Go", 15, 0, 0, 0, 0, 0, 6, 21
"/opt/projects/swiftkube/vendor/k8s.io/kubernetes/pkg/apis/scheduling/register.go", "Go", 42, 0, 0, 0, 0, 0, 12, 54
"/opt/projects/swiftkube/vendor/k8s.io/kubernetes/pkg/apis/scheduling/types.go", "Go", 74, 0, 0, 0, 0, 0, 16, 90
"/opt/projects/swiftkube/vendor/k8s.io/kubernetes/pkg/apis/scheduling/zz_generated.deepcopy.go", "Go", 78, 0, 0, 0, 0, 0, 14, 92
"/opt/projects/swiftkube/vendor/k8s.io/kubernetes/pkg/capabilities/capabilities.go", "Go", 78, 0, 0, 0, 0, 0, 17, 95
"/opt/projects/swiftkube/vendor/k8s.io/kubernetes/pkg/capabilities/doc.go", "Go", 14, 0, 0, 0, 0, 0, 5, 19
"/opt/projects/swiftkube/vendor/k8s.io/kubernetes/pkg/cloudprovider/providers/doc.go", "Go", 13, 0, 0, 0, 0, 0, 5, 18
"/opt/projects/swiftkube/vendor/k8s.io/kubernetes/pkg/cloudprovider/providers/providers.go", "Go", 21, 0, 0, 0, 0, 0, 7, 28
"/opt/projects/swiftkube/vendor/k8s.io/kubernetes/pkg/cluster/ports/doc.go", "Go", 15, 0, 0, 0, 0, 0, 5, 20
"/opt/projects/swiftkube/vendor/k8s.io/kubernetes/pkg/cluster/ports/ports.go", "Go", 48, 0, 0, 0, 0, 0, 7, 55
"/opt/projects/swiftkube/vendor/k8s.io/kubernetes/pkg/credentialprovider/azure/azure_acr_helper.go", "Go", 247, 0, 0, 0, 0, 0, 45, 292
"/opt/projects/swiftkube/vendor/k8s.io/kubernetes/pkg/credentialprovider/azure/azure_credentials.go", "Go", 301, 0, 0, 0, 0, 0, 50, 351
"/opt/projects/swiftkube/vendor/k8s.io/kubernetes/pkg/credentialprovider/azure/doc.go", "Go", 13, 0, 0, 0, 0, 0, 5, 18
"/opt/projects/swiftkube/vendor/k8s.io/kubernetes/pkg/credentialprovider/config.go", "Go", 269, 0, 0, 0, 0, 0, 51, 320
"/opt/projects/swiftkube/vendor/k8s.io/kubernetes/pkg/credentialprovider/doc.go", "Go", 15, 0, 0, 0, 0, 0, 5, 20
"/opt/projects/swiftkube/vendor/k8s.io/kubernetes/pkg/credentialprovider/gcp/doc.go", "Go", 15, 0, 0, 0, 0, 0, 5, 20
"/opt/projects/swiftkube/vendor/k8s.io/kubernetes/pkg/credentialprovider/gcp/metadata.go", "Go", 245, 0, 0, 0, 0, 0, 29, 274
"/opt/projects/swiftkube/vendor/k8s.io/kubernetes/pkg/credentialprovider/keyring.go", "Go", 262, 0, 0, 0, 0, 0, 43, 305
"/opt/projects/swiftkube/vendor/k8s.io/kubernetes/pkg/credentialprovider/plugin/config.go", "Go", 100, 0, 0, 0, 0, 0, 30, 130
"/opt/projects/swiftkube/vendor/k8s.io/kubernetes/pkg/credentialprovider/plugin/metrics.go", "Go", 50, 0, 0, 0, 0, 0, 12, 62
"/opt/projects/swiftkube/vendor/k8s.io/kubernetes/pkg/credentialprovider/plugin/plugin.go", "Go", 416, 0, 0, 0, 0, 0, 86, 502
"/opt/projects/swiftkube/vendor/k8s.io/kubernetes/pkg/credentialprovider/plugins.go", "Go", 66, 0, 0, 0, 0, 0, 14, 80
"/opt/projects/swiftkube/vendor/k8s.io/kubernetes/pkg/credentialprovider/provider.go", "Go", 91, 0, 0, 0, 0, 0, 19, 110
"/opt/projects/swiftkube/vendor/k8s.io/kubernetes/pkg/credentialprovider/secrets/secrets.go", "Go", 47, 0, 0, 0, 0, 0, 12, 59
"/opt/projects/swiftkube/vendor/k8s.io/kubernetes/pkg/features/kube_features.go", "Go", 961, 0, 0, 0, 0, 0, 261, 1222
"/opt/projects/swiftkube/vendor/k8s.io/kubernetes/pkg/fieldpath/doc.go", "Go", 15, 0, 0, 0, 0, 0, 5, 20
"/opt/projects/swiftkube/vendor/k8s.io/kubernetes/pkg/fieldpath/fieldpath.go", "Go", 108, 0, 0, 0, 0, 0, 13, 121
"/opt/projects/swiftkube/vendor/k8s.io/kubernetes/pkg/kubelet/active_deadline.go", "Go", 85, 0, 0, 0, 0, 0, 14, 99
"/opt/projects/swiftkube/vendor/k8s.io/kubernetes/pkg/kubelet/apis/config/doc.go", "Go", 15, 0, 0, 0, 0, 0, 6, 21
"/opt/projects/swiftkube/vendor/k8s.io/kubernetes/pkg/kubelet/apis/config/helpers.go", "Go", 26, 0, 0, 0, 0, 0, 6, 32
"/opt/projects/swiftkube/vendor/k8s.io/kubernetes/pkg/kubelet/apis/config/register.go", "Go", 36, 0, 0, 0, 0, 0, 10, 46
"/opt/projects/swiftkube/vendor/k8s.io/kubernetes/pkg/kubelet/apis/config/scheme/scheme.go", "Go", 38, 0, 0, 0, 0, 0, 8, 46
"/opt/projects/swiftkube/vendor/k8s.io/kubernetes/pkg/kubelet/apis/config/types.go", "Go", 618, 0, 0, 0, 0, 0, 43, 661
"/opt/projects/swiftkube/vendor/k8s.io/kubernetes/pkg/kubelet/apis/config/v1/doc.go", "Go", 19, 0, 0, 0, 0, 0, 6, 25
"/opt/projects/swiftkube/vendor/k8s.io/kubernetes/pkg/kubelet/apis/config/v1/register.go", "Go", 28, 0, 0, 0, 0, 0, 9, 37
"/opt/projects/swiftkube/vendor/k8s.io/kubernetes/pkg/kubelet/apis/config/v1/zz_generated.conversion.go", "Go", 122, 0, 0, 0, 0, 0, 23, 145
"/opt/projects/swiftkube/vendor/k8s.io/kubernetes/pkg/kubelet/apis/config/v1/zz_generated.deepcopy.go", "Go", 16, 0, 0, 0, 0, 0, 7, 23
"/opt/projects/swiftkube/vendor/k8s.io/kubernetes/pkg/kubelet/apis/config/v1/zz_generated.defaults.go", "Go", 25, 0, 0, 0, 0, 0, 9, 34
"/opt/projects/swiftkube/vendor/k8s.io/kubernetes/pkg/kubelet/apis/config/v1alpha1/doc.go", "Go", 19, 0, 0, 0, 0, 0, 6, 25
"/opt/projects/swiftkube/vendor/k8s.io/kubernetes/pkg/kubelet/apis/config/v1alpha1/register.go", "Go", 28, 0, 0, 0, 0, 0, 9, 37
"/opt/projects/swiftkube/vendor/k8s.io/kubernetes/pkg/kubelet/apis/config/v1alpha1/zz_generated.conversion.go", "Go", 122, 0, 0, 0, 0, 0, 23, 145
"/opt/projects/swiftkube/vendor/k8s.io/kubernetes/pkg/kubelet/apis/config/v1alpha1/zz_generated.deepcopy.go", "Go", 16, 0, 0, 0, 0, 0, 7, 23
"/opt/projects/swiftkube/vendor/k8s.io/kubernetes/pkg/kubelet/apis/config/v1alpha1/zz_generated.defaults.go", "Go", 25, 0, 0, 0, 0, 0, 9, 34
"/opt/projects/swiftkube/vendor/k8s.io/kubernetes/pkg/kubelet/apis/config/v1beta1/defaults.go", "Go", 264, 0, 0, 0, 0, 0, 14, 278
"/opt/projects/swiftkube/vendor/k8s.io/kubernetes/pkg/kubelet/apis/config/v1beta1/doc.go", "Go", 19, 0, 0, 0, 0, 0, 6, 25
"/opt/projects/swiftkube/vendor/k8s.io/kubernetes/pkg/kubelet/apis/config/v1beta1/register.go", "Go", 34, 0, 0, 0, 0, 0, 10, 44
"/opt/projects/swiftkube/vendor/k8s.io/kubernetes/pkg/kubelet/apis/config/v1beta1/zz_generated.conversion.go", "Go", 798, 0, 0, 0, 0, 0, 67, 865
"/opt/projects/swiftkube/vendor/k8s.io/kubernetes/pkg/kubelet/apis/config/v1beta1/zz_generated.deepcopy.go", "Go", 16, 0, 0, 0, 0, 0, 7, 23
"/opt/projects/swiftkube/vendor/k8s.io/kubernetes/pkg/kubelet/apis/config/v1beta1/zz_generated.defaults.go", "Go", 35, 0, 0, 0, 0, 0, 10, 45
"/opt/projects/swiftkube/vendor/k8s.io/kubernetes/pkg/kubelet/apis/config/validation/validation.go", "Go", 251, 0, 0, 0, 0, 0, 24, 275
"/opt/projects/swiftkube/vendor/k8s.io/kubernetes/pkg/kubelet/apis/config/validation/validation_others.go", "Go", 22, 0, 0, 0, 0, 0, 8, 30
"/opt/projects/swiftkube/vendor/k8s.io/kubernetes/pkg/kubelet/apis/config/validation/validation_reserved_memory.go", "Go", 51, 0, 0, 0, 0, 0, 14, 65
"/opt/projects/swiftkube/vendor/k8s.io/kubernetes/pkg/kubelet/apis/config/validation/validation_windows.go", "Go", 32, 0, 0, 0, 0, 0, 12, 44
"/opt/projects/swiftkube/vendor/k8s.io/kubernetes/pkg/kubelet/apis/config/zz_generated.deepcopy.go", "Go", 441, 0, 0, 0, 0, 0, 39, 480
"/opt/projects/swiftkube/vendor/k8s.io/kubernetes/pkg/kubelet/apis/podresources/client.go", "Go", 60, 0, 0, 0, 0, 0, 13, 73
"/opt/projects/swiftkube/vendor/k8s.io/kubernetes/pkg/kubelet/apis/podresources/constants.go", "Go", 17, 0, 0, 0, 0, 0, 6, 23
"/opt/projects/swiftkube/vendor/k8s.io/kubernetes/pkg/kubelet/apis/podresources/grpc/ratelimit.go", "Go", 55, 0, 0, 0, 0, 0, 13, 68
"/opt/projects/swiftkube/vendor/k8s.io/kubernetes/pkg/kubelet/apis/podresources/server_v1.go", "Go", 116, 0, 0, 0, 0, 0, 25, 141
"/opt/projects/swiftkube/vendor/k8s.io/kubernetes/pkg/kubelet/apis/podresources/server_v1alpha1.go", "Go", 67, 0, 0, 0, 0, 0, 16, 83
"/opt/projects/swiftkube/vendor/k8s.io/kubernetes/pkg/kubelet/apis/podresources/types.go", "Go", 56, 0, 0, 0, 0, 0, 12, 68
"/opt/projects/swiftkube/vendor/k8s.io/kubernetes/pkg/kubelet/cadvisor/cadvisor_cloudproviders.go", "Go", 21, 0, 0, 0, 0, 0, 7, 28
"/opt/projects/swiftkube/vendor/k8s.io/kubernetes/pkg/kubelet/cadvisor/cadvisor_linux.go", "Go", 160, 0, 0, 0, 0, 0, 32, 192
"/opt/projects/swiftkube/vendor/k8s.io/kubernetes/pkg/kubelet/cadvisor/cadvisor_unsupported.go", "Go", 65, 0, 0, 0, 0, 0, 24, 89
"/opt/projects/swiftkube/vendor/k8s.io/kubernetes/pkg/kubelet/cadvisor/cadvisor_windows.go", "Go", 71, 0, 0, 0, 0, 0, 22, 93
"/opt/projects/swiftkube/vendor/k8s.io/kubernetes/pkg/kubelet/cadvisor/doc.go", "Go", 14, 0, 0, 0, 0, 0, 5, 19
"/opt/projects/swiftkube/vendor/k8s.io/kubernetes/pkg/kubelet/cadvisor/helpers_linux.go", "Go", 39, 0, 0, 0, 0, 0, 11, 50
"/opt/projects/swiftkube/vendor/k8s.io/kubernetes/pkg/kubelet/cadvisor/helpers_unsupported.go", "Go", 26, 0, 0, 0, 0, 0, 10, 36
"/opt/projects/swiftkube/vendor/k8s.io/kubernetes/pkg/kubelet/cadvisor/types.go", "Go", 43, 0, 0, 0, 0, 0, 13, 56
"/opt/projects/swiftkube/vendor/k8s.io/kubernetes/pkg/kubelet/cadvisor/util.go", "Go", 62, 0, 0, 0, 0, 0, 12, 74
"/opt/projects/swiftkube/vendor/k8s.io/kubernetes/pkg/kubelet/certificate/bootstrap/bootstrap.go", "Go", 350, 0, 0, 0, 0, 0, 48, 398
"/opt/projects/swiftkube/vendor/k8s.io/kubernetes/pkg/kubelet/certificate/kubelet.go", "Go", 216, 0, 0, 0, 0, 0, 21, 237
"/opt/projects/swiftkube/vendor/k8s.io/kubernetes/pkg/kubelet/certificate/transport.go", "Go", 159, 0, 0, 0, 0, 0, 27, 186
"/opt/projects/swiftkube/vendor/k8s.io/kubernetes/pkg/kubelet/checkpointmanager/checkpoint_manager.go", "Go", 95, 0, 0, 0, 0, 0, 16, 111
"/opt/projects/swiftkube/vendor/k8s.io/kubernetes/pkg/kubelet/checkpointmanager/checksum/checksum.go", "Go", 37, 0, 0, 0, 0, 0, 11, 48
"/opt/projects/swiftkube/vendor/k8s.io/kubernetes/pkg/kubelet/checkpointmanager/errors/errors.go", "Go", 18, 0, 0, 0, 0, 0, 8, 26
"/opt/projects/swiftkube/vendor/k8s.io/kubernetes/pkg/kubelet/cloudresource/cloud_request_manager.go", "Go", 112, 0, 0, 0, 0, 0, 24, 136
"/opt/projects/swiftkube/vendor/k8s.io/kubernetes/pkg/kubelet/cm/admission/errors.go", "Go", 47, 0, 0, 0, 0, 0, 16, 63
"/opt/projects/swiftkube/vendor/k8s.io/kubernetes/pkg/kubelet/cm/cgroup_manager_linux.go", "Go", 670, 0, 0, 0, 0, 0, 80, 750
"/opt/projects/swiftkube/vendor/k8s.io/kubernetes/pkg/kubelet/cm/cgroup_manager_unsupported.go", "Go", 85, 0, 0, 0, 0, 0, 32, 117
"/opt/projects/swiftkube/vendor/k8s.io/kubernetes/pkg/kubelet/cm/container_manager.go", "Go", 206, 0, 0, 0, 0, 0, 41, 247
"/opt/projects/swiftkube/vendor/k8s.io/kubernetes/pkg/kubelet/cm/container_manager_linux.go", "Go", 901, 0, 0, 0, 0, 0, 126, 1027
"/opt/projects/swiftkube/vendor/k8s.io/kubernetes/pkg/kubelet/cm/container_manager_stub.go", "Go", 153, 0, 0, 0, 0, 0, 45, 198
"/opt/projects/swiftkube/vendor/k8s.io/kubernetes/pkg/kubelet/cm/container_manager_unsupported.go", "Go", 36, 0, 0, 0, 0, 0, 13, 49
"/opt/projects/swiftkube/vendor/k8s.io/kubernetes/pkg/kubelet/cm/container_manager_windows.go", "Go", 223, 0, 0, 0, 0, 0, 52, 275
"/opt/projects/swiftkube/vendor/k8s.io/kubernetes/pkg/kubelet/cm/containermap/container_map.go", "Go", 65, 0, 0, 0, 0, 0, 14, 79
"/opt/projects/swiftkube/vendor/k8s.io/kubernetes/pkg/kubelet/cm/cpumanager/cpu_assignment.go", "Go", 683, 0, 0, 0, 0, 0, 100, 783
"/opt/projects/swiftkube/vendor/k8s.io/kubernetes/pkg/kubelet/cm/cpumanager/cpu_manager.go", "Go", 452, 0, 0, 0, 0, 0, 94, 546
"/opt/projects/swiftkube/vendor/k8s.io/kubernetes/pkg/kubelet/cm/cpumanager/fake_cpu_manager.go", "Go", 75, 0, 0, 0, 0, 0, 19, 94
"/opt/projects/swiftkube/vendor/k8s.io/kubernetes/pkg/kubelet/cm/cpumanager/policy.go", "Go", 38, 0, 0, 0, 0, 0, 8, 46
"/opt/projects/swiftkube/vendor/k8s.io/kubernetes/pkg/kubelet/cm/cpumanager/policy_none.go", "Go", 59, 0, 0, 0, 0, 0, 18, 77
"/opt/projects/swiftkube/vendor/k8s.io/kubernetes/pkg/kubelet/cm/cpumanager/policy_options.go", "Go", 118, 0, 0, 0, 0, 0, 17, 135
"/opt/projects/swiftkube/vendor/k8s.io/kubernetes/pkg/kubelet/cm/cpumanager/policy_static.go", "Go", 606, 0, 0, 0, 0, 0, 85, 691
"/opt/projects/swiftkube/vendor/k8s.io/kubernetes/pkg/kubelet/cm/cpumanager/state/checkpoint.go", "Go", 109, 0, 0, 0, 0, 0, 23, 132
"/opt/projects/swiftkube/vendor/k8s.io/kubernetes/pkg/kubelet/cm/cpumanager/state/state.go", "Go", 48, 0, 0, 0, 0, 0, 11, 59
"/opt/projects/swiftkube/vendor/k8s.io/kubernetes/pkg/kubelet/cm/cpumanager/state/state_checkpoint.go", "Go", 212, 0, 0, 0, 0, 0, 39, 251
"/opt/projects/swiftkube/vendor/k8s.io/kubernetes/pkg/kubelet/cm/cpumanager/state/state_mem.go", "Go", 91, 0, 0, 0, 0, 0, 27, 118
"/opt/projects/swiftkube/vendor/k8s.io/kubernetes/pkg/kubelet/cm/cpumanager/topology/doc.go", "Go", 14, 0, 0, 0, 0, 0, 5, 19
"/opt/projects/swiftkube/vendor/k8s.io/kubernetes/pkg/kubelet/cm/cpumanager/topology/topology.go", "Go", 269, 0, 0, 0, 0, 0, 36, 305
"/opt/projects/swiftkube/vendor/k8s.io/kubernetes/pkg/kubelet/cm/devicemanager/checkpoint/checkpoint.go", "Go", 89, 0, 0, 0, 0, 0, 21, 110
"/opt/projects/swiftkube/vendor/k8s.io/kubernetes/pkg/kubelet/cm/devicemanager/checkpoint/checkpointv1.go", "Go", 102, 0, 0, 0, 0, 0, 16, 118
"/opt/projects/swiftkube/vendor/k8s.io/kubernetes/pkg/kubelet/cm/devicemanager/endpoint.go", "Go", 107, 0, 0, 0, 0, 0, 17, 124
"/opt/projects/swiftkube/vendor/k8s.io/kubernetes/pkg/kubelet/cm/devicemanager/manager.go", "Go", 970, 0, 0, 0, 0, 0, 133, 1103
"/opt/projects/swiftkube/vendor/k8s.io/kubernetes/pkg/kubelet/cm/devicemanager/plugin/v1beta1/api.go", "Go", 41, 0, 0, 0, 0, 0, 9, 50
"/opt/projects/swiftkube/vendor/k8s.io/kubernetes/pkg/kubelet/cm/devicemanager/plugin/v1beta1/client.go", "Go", 119, 0, 0, 0, 0, 0, 23, 142
"/opt/projects/swiftkube/vendor/k8s.io/kubernetes/pkg/kubelet/cm/devicemanager/plugin/v1beta1/handler.go", "Go", 96, 0, 0, 0, 0, 0, 27, 123
"/opt/projects/swiftkube/vendor/k8s.io/kubernetes/pkg/kubelet/cm/devicemanager/plugin/v1beta1/server.go", "Go", 156, 0, 0, 0, 0, 0, 35, 191
"/opt/projects/swiftkube/vendor/k8s.io/kubernetes/pkg/kubelet/cm/devicemanager/plugin/v1beta1/stub.go", "Go", 234, 0, 0, 0, 0, 0, 55, 289
"/opt/projects/swiftkube/vendor/k8s.io/kubernetes/pkg/kubelet/cm/devicemanager/pod_devices.go", "Go", 437, 0, 0, 0, 0, 0, 47, 484
"/opt/projects/swiftkube/vendor/k8s.io/kubernetes/pkg/kubelet/cm/devicemanager/topology_hints.go", "Go", 225, 0, 0, 0, 0, 0, 36, 261
"/opt/projects/swiftkube/vendor/k8s.io/kubernetes/pkg/kubelet/cm/devicemanager/types.go", "Go", 90, 0, 0, 0, 0, 0, 23, 113
"/opt/projects/swiftkube/vendor/k8s.io/kubernetes/pkg/kubelet/cm/dra/claiminfo.go", "Go", 152, 0, 0, 0, 0, 0, 36, 188
"/opt/projects/swiftkube/vendor/k8s.io/kubernetes/pkg/kubelet/cm/dra/manager.go", "Go", 393, 0, 0, 0, 0, 0, 55, 448
"/opt/projects/swiftkube/vendor/k8s.io/kubernetes/pkg/kubelet/cm/dra/plugin/client.go", "Go", 174, 0, 0, 0, 0, 0, 33, 207
"/opt/projects/swiftkube/vendor/k8s.io/kubernetes/pkg/kubelet/cm/dra/plugin/plugin.go", "Go", 144, 0, 0, 0, 0, 0, 35, 179
"/opt/projects/swiftkube/vendor/k8s.io/kubernetes/pkg/kubelet/cm/dra/plugin/plugins_store.go", "Go", 59, 0, 0, 0, 0, 0, 18, 77
"/opt/projects/swiftkube/vendor/k8s.io/kubernetes/pkg/kubelet/cm/dra/state/checkpoint.go", "Go", 105, 0, 0, 0, 0, 0, 18, 123
"/opt/projects/swiftkube/vendor/k8s.io/kubernetes/pkg/kubelet/cm/dra/state/state_checkpoint.go", "Go", 118, 0, 0, 0, 0, 0, 35, 153
"/opt/projects/swiftkube/vendor/k8s.io/kubernetes/pkg/kubelet/cm/dra/types.go", "Go", 41, 0, 0, 0, 0, 0, 12, 53
"/opt/projects/swiftkube/vendor/k8s.io/kubernetes/pkg/kubelet/cm/fake_container_manager.go", "Go", 215, 0, 0, 0, 0, 0, 41, 256
"/opt/projects/swiftkube/vendor/k8s.io/kubernetes/pkg/kubelet/cm/fake_internal_container_lifecycle.go", "Go", 30, 0, 0, 0, 0, 0, 11, 41
"/opt/projects/swiftkube/vendor/k8s.io/kubernetes/pkg/kubelet/cm/fake_pod_container_manager.go", "Go", 107, 0, 0, 0, 0, 0, 21, 128
"/opt/projects/swiftkube/vendor/k8s.io/kubernetes/pkg/kubelet/cm/helpers.go", "Go", 69, 0, 0, 0, 0, 0, 10, 79
"/opt/projects/swiftkube/vendor/k8s.io/kubernetes/pkg/kubelet/cm/helpers_linux.go", "Go", 289, 0, 0, 0, 0, 0, 39, 328
"/opt/projects/swiftkube/vendor/k8s.io/kubernetes/pkg/kubelet/cm/helpers_unsupported.go", "Go", 58, 0, 0, 0, 0, 0, 18, 76
"/opt/projects/swiftkube/vendor/k8s.io/kubernetes/pkg/kubelet/cm/internal_container_lifecycle.go", "Go", 44, 0, 0, 0, 0, 0, 13, 57
"/opt/projects/swiftkube/vendor/k8s.io/kubernetes/pkg/kubelet/cm/internal_container_lifecycle_linux.go", "Go", 40, 0, 0, 0, 0, 0, 11, 51
"/opt/projects/swiftkube/vendor/k8s.io/kubernetes/pkg/kubelet/cm/internal_container_lifecycle_unsupported.go", "Go", 22, 0, 0, 0, 0, 0, 8, 30
"/opt/projects/swiftkube/vendor/k8s.io/kubernetes/pkg/kubelet/cm/internal_container_lifecycle_windows.go", "Go", 22, 0, 0, 0, 0, 0, 8, 30
"/opt/projects/swiftkube/vendor/k8s.io/kubernetes/pkg/kubelet/cm/memorymanager/fake_memory_manager.go", "Go", 76, 0, 0, 0, 0, 0, 19, 95
"/opt/projects/swiftkube/vendor/k8s.io/kubernetes/pkg/kubelet/cm/memorymanager/memory_manager.go", "Go", 371, 0, 0, 0, 0, 0, 95, 466
"/opt/projects/swiftkube/vendor/k8s.io/kubernetes/pkg/kubelet/cm/memorymanager/policy.go", "Go", 39, 0, 0, 0, 0, 0, 8, 47
"/opt/projects/swiftkube/vendor/k8s.io/kubernetes/pkg/kubelet/cm/memorymanager/policy_none.go", "Go", 56, 0, 0, 0, 0, 0, 17, 73
"/opt/projects/swiftkube/vendor/k8s.io/kubernetes/pkg/kubelet/cm/memorymanager/policy_static.go", "Go", 809, 0, 0, 0, 0, 0, 157, 966
"/opt/projects/swiftkube/vendor/k8s.io/kubernetes/pkg/kubelet/cm/memorymanager/state/checkpoint.go", "Go", 53, 0, 0, 0, 0, 0, 13, 66
"/opt/projects/swiftkube/vendor/k8s.io/kubernetes/pkg/kubelet/cm/memorymanager/state/state.go", "Go", 112, 0, 0, 0, 0, 0, 19, 131
"/opt/projects/swiftkube/vendor/k8s.io/kubernetes/pkg/kubelet/cm/memorymanager/state/state_checkpoint.go", "Go", 149, 0, 0, 0, 0, 0, 36, 185
"/opt/projects/swiftkube/vendor/k8s.io/kubernetes/pkg/kubelet/cm/memorymanager/state/state_mem.go", "Go", 96, 0, 0, 0, 0, 0, 28, 124
"/opt/projects/swiftkube/vendor/k8s.io/kubernetes/pkg/kubelet/cm/node_container_manager_linux.go", "Go", 239, 0, 0, 0, 0, 0, 29, 268
"/opt/projects/swiftkube/vendor/k8s.io/kubernetes/pkg/kubelet/cm/pod_container_manager_linux.go", "Go", 317, 0, 0, 0, 0, 0, 39, 356
"/opt/projects/swiftkube/vendor/k8s.io/kubernetes/pkg/kubelet/cm/pod_container_manager_stub.go", "Go", 56, 0, 0, 0, 0, 0, 20, 76
"/opt/projects/swiftkube/vendor/k8s.io/kubernetes/pkg/kubelet/cm/pod_container_manager_unsupported.go", "Go", 19, 0, 0, 0, 0, 0, 8, 27
"/opt/projects/swiftkube/vendor/k8s.io/kubernetes/pkg/kubelet/cm/qos_container_manager_linux.go", "Go", 346, 0, 0, 0, 0, 0, 57, 403
"/opt/projects/swiftkube/vendor/k8s.io/kubernetes/pkg/kubelet/cm/topologymanager/bitmask/bitmask.go", "Go", 193, 0, 0, 0, 0, 0, 30, 223
"/opt/projects/swiftkube/vendor/k8s.io/kubernetes/pkg/kubelet/cm/topologymanager/fake_topology_manager.go", "Go", 67, 0, 0, 0, 0, 0, 17, 84
"/opt/projects/swiftkube/vendor/k8s.io/kubernetes/pkg/kubelet/cm/topologymanager/numa_info.go", "Go", 88, 0, 0, 0, 0, 0, 22, 110
"/opt/projects/swiftkube/vendor/k8s.io/kubernetes/pkg/kubelet/cm/topologymanager/policy.go", "Go", 316, 0, 0, 0, 0, 0, 38, 354
"/opt/projects/swiftkube/vendor/k8s.io/kubernetes/pkg/kubelet/cm/topologymanager/policy_best_effort.go", "Go", 38, 0, 0, 0, 0, 0, 12, 50
"/opt/projects/swiftkube/vendor/k8s.io/kubernetes/pkg/kubelet/cm/topologymanager/policy_none.go", "Go", 30, 0, 0, 0, 0, 0, 12, 42
"/opt/projects/swiftkube/vendor/k8s.io/kubernetes/pkg/kubelet/cm/topologymanager/policy_options.go", "Go", 66, 0, 0, 0, 0, 0, 16, 82
"/opt/projects/swiftkube/vendor/k8s.io/kubernetes/pkg/kubelet/cm/topologymanager/policy_restricted.go", "Go", 36, 0, 0, 0, 0, 0, 12, 48
"/opt/projects/swiftkube/vendor/k8s.io/kubernetes/pkg/kubelet/cm/topologymanager/policy_single_numa_node.go", "Go", 60, 0, 0, 0, 0, 0, 16, 76
"/opt/projects/swiftkube/vendor/k8s.io/kubernetes/pkg/kubelet/cm/topologymanager/scope.go", "Go", 133, 0, 0, 0, 0, 0, 26, 159
"/opt/projects/swiftkube/vendor/k8s.io/kubernetes/pkg/kubelet/cm/topologymanager/scope_container.go", "Go", 71, 0, 0, 0, 0, 0, 15, 86
"/opt/projects/swiftkube/vendor/k8s.io/kubernetes/pkg/kubelet/cm/topologymanager/scope_none.go", "Go", 37, 0, 0, 0, 0, 0, 10, 47
"/opt/projects/swiftkube/vendor/k8s.io/kubernetes/pkg/kubelet/cm/topologymanager/scope_pod.go", "Go", 71, 0, 0, 0, 0, 0, 15, 86
"/opt/projects/swiftkube/vendor/k8s.io/kubernetes/pkg/kubelet/cm/topologymanager/topology_manager.go", "Go", 181, 0, 0, 0, 0, 0, 43, 224
"/opt/projects/swiftkube/vendor/k8s.io/kubernetes/pkg/kubelet/cm/types.go", "Go", 115, 0, 0, 0, 0, 0, 21, 136
"/opt/projects/swiftkube/vendor/k8s.io/kubernetes/pkg/kubelet/cm/util/cdi/cdi.go", "Go", 270, 0, 0, 0, 0, 0, 39, 309
"/opt/projects/swiftkube/vendor/k8s.io/kubernetes/pkg/kubelet/cm/util/cgroups_linux.go", "Go", 78, 0, 0, 0, 0, 0, 16, 94
"/opt/projects/swiftkube/vendor/k8s.io/kubernetes/pkg/kubelet/cm/util/cgroups_unsupported.go", "Go", 19, 0, 0, 0, 0, 0, 7, 26
"/opt/projects/swiftkube/vendor/k8s.io/kubernetes/pkg/kubelet/config/apiserver.go", "Go", 58, 0, 0, 0, 0, 0, 11, 69
"/opt/projects/swiftkube/vendor/k8s.io/kubernetes/pkg/kubelet/config/common.go", "Go", 143, 0, 0, 0, 0, 0, 25, 168
"/opt/projects/swiftkube/vendor/k8s.io/kubernetes/pkg/kubelet/config/config.go", "Go", 440, 0, 0, 0, 0, 0, 62, 502
"/opt/projects/swiftkube/vendor/k8s.io/kubernetes/pkg/kubelet/config/defaults.go", "Go", 28, 0, 0, 0, 0, 0, 6, 34
"/opt/projects/swiftkube/vendor/k8s.io/kubernetes/pkg/kubelet/config/doc.go", "Go", 14, 0, 0, 0, 0, 0, 5, 19
"/opt/projects/swiftkube/vendor/k8s.io/kubernetes/pkg/kubelet/config/file.go", "Go", 211, 0, 0, 0, 0, 0, 35, 246
"/opt/projects/swiftkube/vendor/k8s.io/kubernetes/pkg/kubelet/config/file_linux.go", "Go", 133, 0, 0, 0, 0, 0, 22, 155
"/opt/projects/swiftkube/vendor/k8s.io/kubernetes/pkg/kubelet/config/file_unsupported.go", "Go", 25, 0, 0, 0, 0, 0, 10, 35
"/opt/projects/swiftkube/vendor/k8s.io/kubernetes/pkg/kubelet/config/flags.go", "Go", 48, 0, 0, 0, 0, 0, 12, 60
"/opt/projects/swiftkube/vendor/k8s.io/kubernetes/pkg/kubelet/config/http.go", "Go", 128, 0, 0, 0, 0, 0, 16, 144
"/opt/projects/swiftkube/vendor/k8s.io/kubernetes/pkg/kubelet/config/sources.go", "Go", 55, 0, 0, 0, 0, 0, 13, 68
"/opt/projects/swiftkube/vendor/k8s.io/kubernetes/pkg/kubelet/configmap/configmap_manager.go", "Go", 134, 0, 0, 0, 0, 0, 25, 159
"/opt/projects/swiftkube/vendor/k8s.io/kubernetes/pkg/kubelet/configmap/fake_manager.go", "Go", 29, 0, 0, 0, 0, 0, 11, 40
"/opt/projects/swiftkube/vendor/k8s.io/kubernetes/pkg/kubelet/container/cache.go", "Go", 212, 0, 0, 0, 0, 0, 26, 238
"/opt/projects/swiftkube/vendor/k8s.io/kubernetes/pkg/kubelet/container/container_gc.go", "Go", 70, 0, 0, 0, 0, 0, 19, 89
"/opt/projects/swiftkube/vendor/k8s.io/kubernetes/pkg/kubelet/container/helpers.go", "Go", 371, 0, 0, 0, 0, 0, 53, 424
"/opt/projects/swiftkube/vendor/k8s.io/kubernetes/pkg/kubelet/container/os.go", "Go", 102, 0, 0, 0, 0, 0, 23, 125
"/opt/projects/swiftkube/vendor/k8s.io/kubernetes/pkg/kubelet/container/ref.go", "Go", 69, 0, 0, 0, 0, 0, 10, 79
"/opt/projects/swiftkube/vendor/k8s.io/kubernetes/pkg/kubelet/container/runtime.go", "Go", 627, 0, 0, 0, 0, 0, 69, 696
"/opt/projects/swiftkube/vendor/k8s.io/kubernetes/pkg/kubelet/container/runtime_cache.go", "Go", 84, 0, 0, 0, 0, 0, 14, 98
"/opt/projects/swiftkube/vendor/k8s.io/kubernetes/pkg/kubelet/container/runtime_cache_fake.go", "Go", 41, 0, 0, 0, 0, 0, 10, 51
"/opt/projects/swiftkube/vendor/k8s.io/kubernetes/pkg/kubelet/container/sync_result.go", "Go", 114, 0, 0, 0, 0, 0, 21, 135
"/opt/projects/swiftkube/vendor/k8s.io/kubernetes/pkg/kubelet/container/testing/fake_cache.go", "Go", 38, 0, 0, 0, 0, 0, 14, 52
"/opt/projects/swiftkube/vendor/k8s.io/kubernetes/pkg/kubelet/container/testing/fake_runtime.go", "Go", 388, 0, 0, 0, 0, 0, 88, 476
"/opt/projects/swiftkube/vendor/k8s.io/kubernetes/pkg/kubelet/container/testing/fake_runtime_helper.go", "Go", 65, 0, 0, 0, 0, 0, 17, 82
"/opt/projects/swiftkube/vendor/k8s.io/kubernetes/pkg/kubelet/container/testing/mock_runtime_cache.go", "Go", 99, 0, 0, 0, 0, 0, 22, 121
"/opt/projects/swiftkube/vendor/k8s.io/kubernetes/pkg/kubelet/container/testing/mockdirentry.go", "Go", 88, 0, 0, 0, 0, 0, 20, 108
"/opt/projects/swiftkube/vendor/k8s.io/kubernetes/pkg/kubelet/container/testing/os.go", "Go", 124, 0, 0, 0, 0, 0, 22, 146
"/opt/projects/swiftkube/vendor/k8s.io/kubernetes/pkg/kubelet/container/testing/runtime_mock.go", "Go", 561, 0, 0, 0, 0, 0, 98, 659
"/opt/projects/swiftkube/vendor/k8s.io/kubernetes/pkg/kubelet/cri/remote/doc.go", "Go", 15, 0, 0, 0, 0, 0, 5, 20
"/opt/projects/swiftkube/vendor/k8s.io/kubernetes/pkg/kubelet/cri/remote/remote_image.go", "Go", 195, 0, 0, 0, 0, 0, 42, 237
"/opt/projects/swiftkube/vendor/k8s.io/kubernetes/pkg/kubelet/cri/remote/remote_runtime.go", "Go", 730, 0, 0, 0, 0, 0, 153, 883
"/opt/projects/swiftkube/vendor/k8s.io/kubernetes/pkg/kubelet/cri/remote/utils.go", "Go", 60, 0, 0, 0, 0, 0, 20, 80
"/opt/projects/swiftkube/vendor/k8s.io/kubernetes/pkg/kubelet/doc.go", "Go", 15, 0, 0, 0, 0, 0, 5, 20
"/opt/projects/swiftkube/vendor/k8s.io/kubernetes/pkg/kubelet/envvars/doc.go", "Go", 15, 0, 0, 0, 0, 0, 5, 20
"/opt/projects/swiftkube/vendor/k8s.io/kubernetes/pkg/kubelet/envvars/envvars.go", "Go", 99, 0, 0, 0, 0, 0, 15, 114
"/opt/projects/swiftkube/vendor/k8s.io/kubernetes/pkg/kubelet/errors.go", "Go", 22, 0, 0, 0, 0, 0, 8, 30
"/opt/projects/swiftkube/vendor/k8s.io/kubernetes/pkg/kubelet/events/event.go", "Go", 93, 0, 0, 0, 0, 0, 14, 107
"/opt/projects/swiftkube/vendor/k8s.io/kubernetes/pkg/kubelet/eviction/api/types.go", "Go", 86, 0, 0, 0, 0, 0, 16, 102
"/opt/projects/swiftkube/vendor/k8s.io/kubernetes/pkg/kubelet/eviction/defaults_linux.go", "Go", 22, 0, 0, 0, 0, 0, 7, 29
"/opt/projects/swiftkube/vendor/k8s.io/kubernetes/pkg/kubelet/eviction/defaults_others.go", "Go", 21, 0, 0, 0, 0, 0, 7, 28
"/opt/projects/swiftkube/vendor/k8s.io/kubernetes/pkg/kubelet/eviction/doc.go", "Go", 15, 0, 0, 0, 0, 0, 5, 20
"/opt/projects/swiftkube/vendor/k8s.io/kubernetes/pkg/kubelet/eviction/eviction_manager.go", "Go", 528, 0, 0, 0, 0, 0, 68, 596
"/opt/projects/swiftkube/vendor/k8s.io/kubernetes/pkg/kubelet/eviction/helpers.go", "Go", 985, 0, 0, 0, 0, 0, 84, 1069
"/opt/projects/swiftkube/vendor/k8s.io/kubernetes/pkg/kubelet/eviction/memory_threshold_notifier.go", "Go", 117, 0, 0, 0, 0, 0, 19, 136
"/opt/projects/swiftkube/vendor/k8s.io/kubernetes/pkg/kubelet/eviction/threshold_notifier_linux.go", "Go", 182, 0, 0, 0, 0, 0, 19, 201
"/opt/projects/swiftkube/vendor/k8s.io/kubernetes/pkg/kubelet/eviction/threshold_notifier_unsupported.go", "Go", 24, 0, 0, 0, 0, 0, 11, 35
"/opt/projects/swiftkube/vendor/k8s.io/kubernetes/pkg/kubelet/eviction/types.go", "Go", 135, 0, 0, 0, 0, 0, 32, 167
"/opt/projects/swiftkube/vendor/k8s.io/kubernetes/pkg/kubelet/images/doc.go", "Go", 14, 0, 0, 0, 0, 0, 5, 19
"/opt/projects/swiftkube/vendor/k8s.io/kubernetes/pkg/kubelet/images/helpers.go", "Go", 43, 0, 0, 0, 0, 0, 10, 53
"/opt/projects/swiftkube/vendor/k8s.io/kubernetes/pkg/kubelet/images/image_gc_manager.go", "Go", 371, 0, 0, 0, 0, 0, 73, 444
"/opt/projects/swiftkube/vendor/k8s.io/kubernetes/pkg/kubelet/images/image_manager.go", "Go", 193, 0, 0, 0, 0, 0, 29, 222
"/opt/projects/swiftkube/vendor/k8s.io/kubernetes/pkg/kubelet/images/puller.go", "Go", 93, 0, 0, 0, 0, 0, 19, 112
"/opt/projects/swiftkube/vendor/k8s.io/kubernetes/pkg/kubelet/images/types.go", "Go", 41, 0, 0, 0, 0, 0, 14, 55
"/opt/projects/swiftkube/vendor/k8s.io/kubernetes/pkg/kubelet/kubelet.go", "Go", 2677, 0, 0, 0, 0, 0, 343, 3020
"/opt/projects/swiftkube/vendor/k8s.io/kubernetes/pkg/kubelet/kubelet_getters.go", "Go", 383, 0, 0, 0, 0, 0, 55, 438
"/opt/projects/swiftkube/vendor/k8s.io/kubernetes/pkg/kubelet/kubelet_network.go", "Go", 59, 0, 0, 0, 0, 0, 13, 72
"/opt/projects/swiftkube/vendor/k8s.io/kubernetes/pkg/kubelet/kubelet_network_linux.go", "Go", 97, 0, 0, 0, 0, 0, 19, 116
"/opt/projects/swiftkube/vendor/k8s.io/kubernetes/pkg/kubelet/kubelet_network_others.go", "Go", 17, 0, 0, 0, 0, 0, 7, 24
"/opt/projects/swiftkube/vendor/k8s.io/kubernetes/pkg/kubelet/kubelet_node_status.go", "Go", 747, 0, 0, 0, 0, 0, 98, 845
"/opt/projects/swiftkube/vendor/k8s.io/kubernetes/pkg/kubelet/kubelet_node_status_others.go", "Go", 18, 0, 0, 0, 0, 0, 7, 25
"/opt/projects/swiftkube/vendor/k8s.io/kubernetes/pkg/kubelet/kubelet_node_status_windows.go", "Go", 26, 0, 0, 0, 0, 0, 9, 35
"/opt/projects/swiftkube/vendor/k8s.io/kubernetes/pkg/kubelet/kubelet_pods.go", "Go", 2125, 0, 0, 0, 0, 0, 188, 2313
"/opt/projects/swiftkube/vendor/k8s.io/kubernetes/pkg/kubelet/kubelet_resources.go", "Go", 47, 0, 0, 0, 0, 0, 11, 58
"/opt/projects/swiftkube/vendor/k8s.io/kubernetes/pkg/kubelet/kubelet_server_journal.go", "Go", 386, 0, 0, 0, 0, 0, 59, 445
"/opt/projects/swiftkube/vendor/k8s.io/kubernetes/pkg/kubelet/kubelet_server_journal_linux.go", "Go", 63, 0, 0, 0, 0, 0, 12, 75
"/opt/projects/swiftkube/vendor/k8s.io/kubernetes/pkg/kubelet/kubelet_server_journal_others.go", "Go", 26, 0, 0, 0, 0, 0, 9, 35
"/opt/projects/swiftkube/vendor/k8s.io/kubernetes/pkg/kubelet/kubelet_server_journal_windows.go", "Go", 73, 0, 0, 0, 0, 0, 14, 87
"/opt/projects/swiftkube/vendor/k8s.io/kubernetes/pkg/kubelet/kubelet_volumes.go", "Go", 243, 0, 0, 0, 0, 0, 30, 273
"/opt/projects/swiftkube/vendor/k8s.io/kubernetes/pkg/kubelet/kubeletconfig/configfiles/configfiles.go", "Go", 75, 0, 0, 0, 0, 0, 16, 91
"/opt/projects/swiftkube/vendor/k8s.io/kubernetes/pkg/kubelet/kubeletconfig/util/codec/codec.go", "Go", 90, 0, 0, 0, 0, 0, 18, 108
"/opt/projects/swiftkube/vendor/k8s.io/kubernetes/pkg/kubelet/kuberuntime/convert.go", "Go", 51, 0, 0, 0, 0, 0, 12, 63
"/opt/projects/swiftkube/vendor/k8s.io/kubernetes/pkg/kubelet/kuberuntime/doc.go", "Go", 15, 0, 0, 0, 0, 0, 5, 20
"/opt/projects/swiftkube/vendor/k8s.io/kubernetes/pkg/kubelet/kuberuntime/fake_kuberuntime_manager.go", "Go", 130, 0, 0, 0, 0, 0, 24, 154
"/opt/projects/swiftkube/vendor/k8s.io/kubernetes/pkg/kubelet/kuberuntime/helpers.go", "Go", 226, 0, 0, 0, 0, 0, 43, 269
"/opt/projects/swiftkube/vendor/k8s.io/kubernetes/pkg/kubelet/kuberuntime/helpers_linux.go", "Go", 65, 0, 0, 0, 0, 0, 15, 80
"/opt/projects/swiftkube/vendor/k8s.io/kubernetes/pkg/kubelet/kuberuntime/helpers_unsupported.go", "Go", 15, 0, 0, 0, 0, 0, 6, 21
"/opt/projects/swiftkube/vendor/k8s.io/kubernetes/pkg/kubelet/kuberuntime/instrumented_services.go", "Go", 292, 0, 0, 0, 0, 0, 81, 373
"/opt/projects/swiftkube/vendor/k8s.io/kubernetes/pkg/kubelet/kuberuntime/kuberuntime_container.go", "Go", 1152, 0, 0, 0, 0, 0, 124, 1276
"/opt/projects/swiftkube/vendor/k8s.io/kubernetes/pkg/kubelet/kuberuntime/kuberuntime_container_linux.go", "Go", 371, 0, 0, 0, 0, 0, 57, 428
"/opt/projects/swiftkube/vendor/k8s.io/kubernetes/pkg/kubelet/kuberuntime/kuberuntime_container_unsupported.go", "Go", 31, 0, 0, 0, 0, 0, 10, 41
"/opt/projects/swiftkube/vendor/k8s.io/kubernetes/pkg/kubelet/kuberuntime/kuberuntime_container_windows.go", "Go", 117, 0, 0, 0, 0, 0, 23, 140
"/opt/projects/swiftkube/vendor/k8s.io/kubernetes/pkg/kubelet/kuberuntime/kuberuntime_gc.go", "Go", 379, 0, 0, 0, 0, 0, 48, 427
"/opt/projects/swiftkube/vendor/k8s.io/kubernetes/pkg/kubelet/kuberuntime/kuberuntime_image.go", "Go", 123, 0, 0, 0, 0, 0, 25, 148
"/opt/projects/swiftkube/vendor/k8s.io/kubernetes/pkg/kubelet/kuberuntime/kuberuntime_logs.go", "Go", 28, 0, 0, 0, 0, 0, 9, 37
"/opt/projects/swiftkube/vendor/k8s.io/kubernetes/pkg/kubelet/kuberuntime/kuberuntime_manager.go", "Go", 1391, 0, 0, 0, 0, 0, 152, 1543
"/opt/projects/swiftkube/vendor/k8s.io/kubernetes/pkg/kubelet/kuberuntime/kuberuntime_sandbox.go", "Go", 333, 0, 0, 0, 0, 0, 53, 386
"/opt/projects/swiftkube/vendor/k8s.io/kubernetes/pkg/kubelet/kuberuntime/kuberuntime_sandbox_linux.go", "Go", 52, 0, 0, 0, 0, 0, 15, 67
"/opt/projects/swiftkube/vendor/k8s.io/kubernetes/pkg/kubelet/kuberuntime/kuberuntime_sandbox_unsupported.go", "Go", 22, 0, 0, 0, 0, 0, 8, 30
"/opt/projects/swiftkube/vendor/k8s.io/kubernetes/pkg/kubelet/kuberuntime/kuberuntime_sandbox_windows.go", "Go", 22, 0, 0, 0, 0, 0, 8, 30
"/opt/projects/swiftkube/vendor/k8s.io/kubernetes/pkg/kubelet/kuberuntime/labels.go", "Go", 254, 0, 0, 0, 0, 0, 42, 296
"/opt/projects/swiftkube/vendor/k8s.io/kubernetes/pkg/kubelet/kuberuntime/legacy.go", "Go", 63, 0, 0, 0, 0, 0, 13, 76
"/opt/projects/swiftkube/vendor/k8s.io/kubernetes/pkg/kubelet/kuberuntime/logs/logs.go", "Go", 443, 0, 0, 0, 0, 0, 37, 480
"/opt/projects/swiftkube/vendor/k8s.io/kubernetes/pkg/kubelet/kuberuntime/security_context.go", "Go", 121, 0, 0, 0, 0, 0, 23, 144
"/opt/projects/swiftkube/vendor/k8s.io/kubernetes/pkg/kubelet/kuberuntime/security_context_others.go", "Go", 43, 0, 0, 0, 0, 0, 11, 54
"/opt/projects/swiftkube/vendor/k8s.io/kubernetes/pkg/kubelet/kuberuntime/security_context_windows.go", "Go", 65, 0, 0, 0, 0, 0, 9, 74
"/opt/projects/swiftkube/vendor/k8s.io/kubernetes/pkg/kubelet/kuberuntime/util/util.go", "Go", 98, 0, 0, 0, 0, 0, 17, 115
"/opt/projects/swiftkube/vendor/k8s.io/kubernetes/pkg/kubelet/leaky/leaky.go", "Go", 20, 0, 0, 0, 0, 0, 6, 26
"/opt/projects/swiftkube/vendor/k8s.io/kubernetes/pkg/kubelet/lifecycle/admission_failure_handler_stub.go", "Go", 28, 0, 0, 0, 0, 0, 10, 38
"/opt/projects/swiftkube/vendor/k8s.io/kubernetes/pkg/kubelet/lifecycle/doc.go", "Go", 15, 0, 0, 0, 0, 0, 5, 20
"/opt/projects/swiftkube/vendor/k8s.io/kubernetes/pkg/kubelet/lifecycle/handlers.go", "Go", 214, 0, 0, 0, 0, 0, 29, 243
"/opt/projects/swiftkube/vendor/k8s.io/kubernetes/pkg/kubelet/lifecycle/interfaces.go", "Go", 101, 0, 0, 0, 0, 0, 22, 123
"/opt/projects/swiftkube/vendor/k8s.io/kubernetes/pkg/kubelet/lifecycle/predicate.go", "Go", 276, 0, 0, 0, 0, 0, 32, 308
"/opt/projects/swiftkube/vendor/k8s.io/kubernetes/pkg/kubelet/logs/container_log_manager.go", "Go", 400, 0, 0, 0, 0, 0, 35, 435
"/opt/projects/swiftkube/vendor/k8s.io/kubernetes/pkg/kubelet/logs/container_log_manager_stub.go", "Go", 23, 0, 0, 0, 0, 0, 10, 33
"/opt/projects/swiftkube/vendor/k8s.io/kubernetes/pkg/kubelet/metrics/collectors/cri_metrics.go", "Go", 110, 0, 0, 0, 0, 0, 20, 130
"/opt/projects/swiftkube/vendor/k8s.io/kubernetes/pkg/kubelet/metrics/collectors/log_metrics.go", "Go", 73, 0, 0, 0, 0, 0, 15, 88
"/opt/projects/swiftkube/vendor/k8s.io/kubernetes/pkg/kubelet/metrics/collectors/resource_metrics.go", "Go", 222, 0, 0, 0, 0, 0, 46, 268
"/opt/projects/swiftkube/vendor/k8s.io/kubernetes/pkg/kubelet/metrics/collectors/volume_stats.go", "Go", 130, 0, 0, 0, 0, 0, 17, 147
"/opt/projects/swiftkube/vendor/k8s.io/kubernetes/pkg/kubelet/metrics/metrics.go", "Go", 784, 0, 0, 0, 0, 0, 50, 834
"/opt/projects/swiftkube/vendor/k8s.io/kubernetes/pkg/kubelet/network/dns/dns.go", "Go", 425, 0, 0, 0, 0, 0, 54, 479
"/opt/projects/swiftkube/vendor/k8s.io/kubernetes/pkg/kubelet/network/dns/dns_other.go", "Go", 17, 0, 0, 0, 0, 0, 7, 24
"/opt/projects/swiftkube/vendor/k8s.io/kubernetes/pkg/kubelet/network/dns/dns_windows.go", "Go", 195, 0, 0, 0, 0, 0, 30, 225
"/opt/projects/swiftkube/vendor/k8s.io/kubernetes/pkg/kubelet/nodeshutdown/nodeshutdown_manager.go", "Go", 59, 0, 0, 0, 0, 0, 13, 72
"/opt/projects/swiftkube/vendor/k8s.io/kubernetes/pkg/kubelet/nodeshutdown/nodeshutdown_manager_linux.go", "Go", 428, 0, 0, 0, 0, 0, 66, 494
"/opt/projects/swiftkube/vendor/k8s.io/kubernetes/pkg/kubelet/nodeshutdown/nodeshutdown_manager_others.go", "Go", 23, 0, 0, 0, 0, 0, 8, 31
"/opt/projects/swiftkube/vendor/k8s.io/kubernetes/pkg/kubelet/nodeshutdown/storage.go", "Go", 83, 0, 0, 0, 0, 0, 13, 96
"/opt/projects/swiftkube/vendor/k8s.io/kubernetes/pkg/kubelet/nodeshutdown/systemd/doc.go", "Go", 14, 0, 0, 0, 0, 0, 5, 19
"/opt/projects/swiftkube/vendor/k8s.io/kubernetes/pkg/kubelet/nodeshutdown/systemd/inhibit_linux.go", "Go", 161, 0, 0, 0, 0, 0, 40, 201
"/opt/projects/swiftkube/vendor/k8s.io/kubernetes/pkg/kubelet/nodeshutdown/systemd/inhibit_others.go", "Go", 15, 0, 0, 0, 0, 0, 6, 21
"/opt/projects/swiftkube/vendor/k8s.io/kubernetes/pkg/kubelet/nodestatus/setters.go", "Go", 712, 0, 0, 0, 0, 0, 69, 781
"/opt/projects/swiftkube/vendor/k8s.io/kubernetes/pkg/kubelet/oom/oom_watcher_linux.go", "Go", 74, 0, 0, 0, 0, 0, 21, 95
"/opt/projects/swiftkube/vendor/k8s.io/kubernetes/pkg/kubelet/oom/oom_watcher_unsupported.go", "Go", 28, 0, 0, 0, 0, 0, 11, 39
"/opt/projects/swiftkube/vendor/k8s.io/kubernetes/pkg/kubelet/oom/types.go", "Go", 18, 0, 0, 0, 0, 0, 7, 25
"/opt/projects/swiftkube/vendor/k8s.io/kubernetes/pkg/kubelet/pleg/doc.go", "Go", 15, 0, 0, 0, 0, 0, 5, 20
"/opt/projects/swiftkube/vendor/k8s.io/kubernetes/pkg/kubelet/pleg/evented.go", "Go", 374, 0, 0, 0, 0, 0, 49, 423
"/opt/projects/swiftkube/vendor/k8s.io/kubernetes/pkg/kubelet/pleg/generic.go", "Go", 531, 0, 0, 0, 0, 0, 67, 598
"/opt/projects/swiftkube/vendor/k8s.io/kubernetes/pkg/kubelet/pleg/pleg.go", "Go", 62, 0, 0, 0, 0, 0, 12, 74
"/opt/projects/swiftkube/vendor/k8s.io/kubernetes/pkg/kubelet/pluginmanager/cache/actual_state_of_world.go", "Go", 102, 0, 0, 0, 0, 0, 25, 127
"/opt/projects/swiftkube/vendor/k8s.io/kubernetes/pkg/kubelet/pluginmanager/cache/desired_state_of_world.go", "Go", 139, 0, 0, 0, 0, 0, 31, 170
"/opt/projects/swiftkube/vendor/k8s.io/kubernetes/pkg/kubelet/pluginmanager/cache/types.go", "Go", 53, 0, 0, 0, 0, 0, 6, 59
"/opt/projects/swiftkube/vendor/k8s.io/kubernetes/pkg/kubelet/pluginmanager/metrics/metrics.go", "Go", 84, 0, 0, 0, 0, 0, 20, 104
"/opt/projects/swiftkube/vendor/k8s.io/kubernetes/pkg/kubelet/pluginmanager/operationexecutor/operation_executor.go", "Go", 95, 0, 0, 0, 0, 0, 21, 116
"/opt/projects/swiftkube/vendor/k8s.io/kubernetes/pkg/kubelet/pluginmanager/operationexecutor/operation_generator.go", "Go", 160, 0, 0, 0, 0, 0, 36, 196
"/opt/projects/swiftkube/vendor/k8s.io/kubernetes/pkg/kubelet/pluginmanager/plugin_manager.go", "Go", 106, 0, 0, 0, 0, 0, 23, 129
"/opt/projects/swiftkube/vendor/k8s.io/kubernetes/pkg/kubelet/pluginmanager/pluginwatcher/example_handler.go", "Go", 120, 0, 0, 0, 0, 0, 36, 156
"/opt/projects/swiftkube/vendor/k8s.io/kubernetes/pkg/kubelet/pluginmanager/pluginwatcher/example_plugin.go", "Go", 147, 0, 0, 0, 0, 0, 33, 180
"/opt/projects/swiftkube/vendor/k8s.io/kubernetes/pkg/kubelet/pluginmanager/pluginwatcher/example_plugin_apis/v1beta1/api.pb.go", "Go", 633, 0, 0, 0, 0, 0, 45, 678
"/opt/projects/swiftkube/vendor/k8s.io/kubernetes/pkg/kubelet/pluginmanager/pluginwatcher/example_plugin_apis/v1beta1/api.proto", "Protocol Buffers", 0, 0, 33, 0, 0, 2, 11, 46
"/opt/projects/swiftkube/vendor/k8s.io/kubernetes/pkg/kubelet/pluginmanager/pluginwatcher/example_plugin_apis/v1beta2/api.pb.go", "Go", 634, 0, 0, 0, 0, 0, 45, 679
"/opt/projects/swiftkube/vendor/k8s.io/kubernetes/pkg/kubelet/pluginmanager/pluginwatcher/example_plugin_apis/v1beta2/api.proto", "Protocol Buffers", 0, 0, 33, 0, 0, 3, 11, 47
"/opt/projects/swiftkube/vendor/k8s.io/kubernetes/pkg/kubelet/pluginmanager/pluginwatcher/plugin_watcher.go", "Go", 176, 0, 0, 0, 0, 0, 33, 209
"/opt/projects/swiftkube/vendor/k8s.io/kubernetes/pkg/kubelet/pluginmanager/pluginwatcher/plugin_watcher_others.go", "Go", 25, 0, 0, 0, 0, 0, 10, 35
"/opt/projects/swiftkube/vendor/k8s.io/kubernetes/pkg/kubelet/pluginmanager/pluginwatcher/plugin_watcher_windows.go", "Go", 31, 0, 0, 0, 0, 0, 10, 41
"/opt/projects/swiftkube/vendor/k8s.io/kubernetes/pkg/kubelet/pluginmanager/reconciler/reconciler.go", "Go", 145, 0, 0, 0, 0, 0, 21, 166
"/opt/projects/swiftkube/vendor/k8s.io/kubernetes/pkg/kubelet/pod/mirror_client.go", "Go", 144, 0, 0, 0, 0, 0, 21, 165
"/opt/projects/swiftkube/vendor/k8s.io/kubernetes/pkg/kubelet/pod/pod_manager.go", "Go", 298, 0, 0, 0, 0, 0, 43, 341
"/opt/projects/swiftkube/vendor/k8s.io/kubernetes/pkg/kubelet/pod_container_deletor.go", "Go", 99, 0, 0, 0, 0, 0, 19, 118
"/opt/projects/swiftkube/vendor/k8s.io/kubernetes/pkg/kubelet/pod_workers.go", "Go", 1564, 0, 0, 0, 0, 0, 159, 1723
"/opt/projects/swiftkube/vendor/k8s.io/kubernetes/pkg/kubelet/preemption/preemption.go", "Go", 258, 0, 0, 0, 0, 0, 24, 282
"/opt/projects/swiftkube/vendor/k8s.io/kubernetes/pkg/kubelet/prober/prober.go", "Go", 220, 0, 0, 0, 0, 0, 36, 256
"/opt/projects/swiftkube/vendor/k8s.io/kubernetes/pkg/kubelet/prober/prober_manager.go", "Go", 327, 0, 0, 0, 0, 0, 54, 381
"/opt/projects/swiftkube/vendor/k8s.io/kubernetes/pkg/kubelet/prober/results/results_manager.go", "Go", 117, 0, 0, 0, 0, 0, 23, 140
"/opt/projects/swiftkube/vendor/k8s.io/kubernetes/pkg/kubelet/prober/worker.go", "Go", 285, 0, 0, 0, 0, 0, 53, 338
"/opt/projects/swiftkube/vendor/k8s.io/kubernetes/pkg/kubelet/qos/doc.go", "Go", 21, 0, 0, 0, 0, 0, 5, 26
"/opt/projects/swiftkube/vendor/k8s.io/kubernetes/pkg/kubelet/qos/policy.go", "Go", 73, 0, 0, 0, 0, 0, 10, 83
"/opt/projects/swiftkube/vendor/k8s.io/kubernetes/pkg/kubelet/reason_cache.go", "Go", 91, 0, 0, 0, 0, 0, 16, 107
"/opt/projects/swiftkube/vendor/k8s.io/kubernetes/pkg/kubelet/runonce.go", "Go", 157, 0, 0, 0, 0, 0, 20, 177
"/opt/projects/swiftkube/vendor/k8s.io/kubernetes/pkg/kubelet/runtime.go", "Go", 116, 0, 0, 0, 0, 0, 22, 138
"/opt/projects/swiftkube/vendor/k8s.io/kubernetes/pkg/kubelet/runtimeclass/runtimeclass_manager.go", "Go", 62, 0, 0, 0, 0, 0, 17, 79
"/opt/projects/swiftkube/vendor/k8s.io/kubernetes/pkg/kubelet/secret/fake_manager.go", "Go", 51, 0, 0, 0, 0, 0, 15, 66
"/opt/projects/swiftkube/vendor/k8s.io/kubernetes/pkg/kubelet/secret/secret_manager.go", "Go", 135, 0, 0, 0, 0, 0, 25, 160
"/opt/projects/swiftkube/vendor/k8s.io/kubernetes/pkg/kubelet/server/auth.go", "Go", 95, 0, 0, 0, 0, 0, 19, 114
"/opt/projects/swiftkube/vendor/k8s.io/kubernetes/pkg/kubelet/server/doc.go", "Go", 14, 0, 0, 0, 0, 0, 5, 19
"/opt/projects/swiftkube/vendor/k8s.io/kubernetes/pkg/kubelet/server/metrics/metrics.go", "Go", 89, 0, 0, 0, 0, 0, 13, 102
"/opt/projects/swiftkube/vendor/k8s.io/kubernetes/pkg/kubelet/server/server.go", "Go", 1031, 0, 0, 0, 0, 0, 116, 1147
"/opt/projects/swiftkube/vendor/k8s.io/kubernetes/pkg/kubelet/server/stats/doc.go", "Go", 16, 0, 0, 0, 0, 0, 5, 21
"/opt/projects/swiftkube/vendor/k8s.io/kubernetes/pkg/kubelet/server/stats/fs_resource_analyzer.go", "Go", 90, 0, 0, 0, 0, 0, 19, 109
"/opt/projects/swiftkube/vendor/k8s.io/kubernetes/pkg/kubelet/server/stats/handler.go", "Go", 163, 0, 0, 0, 0, 0, 25, 188
"/opt/projects/swiftkube/vendor/k8s.io/kubernetes/pkg/kubelet/server/stats/resource_analyzer.go", "Go", 39, 0, 0, 0, 0, 0, 12, 51
"/opt/projects/swiftkube/vendor/k8s.io/kubernetes/pkg/kubelet/server/stats/summary.go", "Go", 135, 0, 0, 0, 0, 0, 20, 155
"/opt/projects/swiftkube/vendor/k8s.io/kubernetes/pkg/kubelet/server/stats/summary_sys_containers.go", "Go", 83, 0, 0, 0, 0, 0, 14, 97
"/opt/projects/swiftkube/vendor/k8s.io/kubernetes/pkg/kubelet/server/stats/summary_sys_containers_windows.go", "Go", 84, 0, 0, 0, 0, 0, 15, 99
"/opt/projects/swiftkube/vendor/k8s.io/kubernetes/pkg/kubelet/server/stats/volume_stat_calculator.go", "Go", 197, 0, 0, 0, 0, 0, 26, 223
"/opt/projects/swiftkube/vendor/k8s.io/kubernetes/pkg/kubelet/stats/cadvisor_stats_provider.go", "Go", 412, 0, 0, 0, 0, 0, 39, 451
"/opt/projects/swiftkube/vendor/k8s.io/kubernetes/pkg/kubelet/stats/cri_stats_provider.go", "Go", 877, 0, 0, 0, 0, 0, 88, 965
"/opt/projects/swiftkube/vendor/k8s.io/kubernetes/pkg/kubelet/stats/cri_stats_provider_linux.go", "Go", 92, 0, 0, 0, 0, 0, 14, 106
"/opt/projects/swiftkube/vendor/k8s.io/kubernetes/pkg/kubelet/stats/cri_stats_provider_others.go", "Go", 39, 0, 0, 0, 0, 0, 13, 52
"/opt/projects/swiftkube/vendor/k8s.io/kubernetes/pkg/kubelet/stats/cri_stats_provider_windows.go", "Go", 243, 0, 0, 0, 0, 0, 30, 273
"/opt/projects/swiftkube/vendor/k8s.io/kubernetes/pkg/kubelet/stats/helper.go", "Go", 419, 0, 0, 0, 0, 0, 51, 470
"/opt/projects/swiftkube/vendor/k8s.io/kubernetes/pkg/kubelet/stats/host_stats_provider.go", "Go", 138, 0, 0, 0, 0, 0, 21, 159
"/opt/projects/swiftkube/vendor/k8s.io/kubernetes/pkg/kubelet/stats/host_stats_provider_fake.go", "Go", 94, 0, 0, 0, 0, 0, 17, 111
"/opt/projects/swiftkube/vendor/k8s.io/kubernetes/pkg/kubelet/stats/pidlimit/pidlimit.go", "Go", 20, 0, 0, 0, 0, 0, 7, 27
"/opt/projects/swiftkube/vendor/k8s.io/kubernetes/pkg/kubelet/stats/pidlimit/pidlimit_linux.go", "Go", 74, 0, 0, 0, 0, 0, 14, 88
"/opt/projects/swiftkube/vendor/k8s.io/kubernetes/pkg/kubelet/stats/pidlimit/pidlimit_unsupported.go", "Go", 22, 0, 0, 0, 0, 0, 8, 30
"/opt/projects/swiftkube/vendor/k8s.io/kubernetes/pkg/kubelet/stats/provider.go", "Go", 192, 0, 0, 0, 0, 0, 25, 217
"/opt/projects/swiftkube/vendor/k8s.io/kubernetes/pkg/kubelet/status/fake_status_manager.go", "Go", 80, 0, 0, 0, 0, 0, 19, 99
"/opt/projects/swiftkube/vendor/k8s.io/kubernetes/pkg/kubelet/status/generate.go", "Go", 255, 0, 0, 0, 0, 0, 34, 289
"/opt/projects/swiftkube/vendor/k8s.io/kubernetes/pkg/kubelet/status/state/checkpoint.go", "Go", 53, 0, 0, 0, 0, 0, 13, 66
"/opt/projects/swiftkube/vendor/k8s.io/kubernetes/pkg/kubelet/status/state/state.go", "Go", 51, 0, 0, 0, 0, 0, 12, 63
"/opt/projects/swiftkube/vendor/k8s.io/kubernetes/pkg/kubelet/status/state/state_checkpoint.go", "Go", 186, 0, 0, 0, 0, 0, 41, 227
"/opt/projects/swiftkube/vendor/k8s.io/kubernetes/pkg/kubelet/status/state/state_mem.go", "Go", 125, 0, 0, 0, 0, 0, 28, 153
"/opt/projects/swiftkube/vendor/k8s.io/kubernetes/pkg/kubelet/status/status_manager.go", "Go", 1005, 0, 0, 0, 0, 0, 130, 1135
"/opt/projects/swiftkube/vendor/k8s.io/kubernetes/pkg/kubelet/sysctl/allowlist.go", "Go", 117, 0, 0, 0, 0, 0, 16, 133
"/opt/projects/swiftkube/vendor/k8s.io/kubernetes/pkg/kubelet/sysctl/namespace.go", "Go", 48, 0, 0, 0, 0, 0, 13, 61
"/opt/projects/swiftkube/vendor/k8s.io/kubernetes/pkg/kubelet/sysctl/safe_sysctls.go", "Go", 68, 0, 0, 0, 0, 0, 12, 80
"/opt/projects/swiftkube/vendor/k8s.io/kubernetes/pkg/kubelet/sysctl/util.go", "Go", 55, 0, 0, 0, 0, 0, 10, 65
"/opt/projects/swiftkube/vendor/k8s.io/kubernetes/pkg/kubelet/token/token_manager.go", "Go", 179, 0, 0, 0, 0, 0, 28, 207
"/opt/projects/swiftkube/vendor/k8s.io/kubernetes/pkg/kubelet/types/constants.go", "Go", 41, 0, 0, 0, 0, 0, 9, 50
"/opt/projects/swiftkube/vendor/k8s.io/kubernetes/pkg/kubelet/types/doc.go", "Go", 14, 0, 0, 0, 0, 0, 5, 19
"/opt/projects/swiftkube/vendor/k8s.io/kubernetes/pkg/kubelet/types/labels.go", "Go", 36, 0, 0, 0, 0, 0, 10, 46
"/opt/projects/swiftkube/vendor/k8s.io/kubernetes/pkg/kubelet/types/pod_status.go", "Go", 48, 0, 0, 0, 0, 0, 9, 57
"/opt/projects/swiftkube/vendor/k8s.io/kubernetes/pkg/kubelet/types/pod_update.go", "Go", 178, 0, 0, 0, 0, 0, 27, 205
"/opt/projects/swiftkube/vendor/k8s.io/kubernetes/pkg/kubelet/types/types.go", "Go", 93, 0, 0, 0, 0, 0, 22, 115
"/opt/projects/swiftkube/vendor/k8s.io/kubernetes/pkg/kubelet/userns/userns_manager.go", "Go", 402, 0, 0, 0, 0, 0, 75, 477
"/opt/projects/swiftkube/vendor/k8s.io/kubernetes/pkg/kubelet/util/boottime_util_darwin.go", "Go", 37, 0, 0, 0, 0, 0, 9, 46
"/opt/projects/swiftkube/vendor/k8s.io/kubernetes/pkg/kubelet/util/boottime_util_freebsd.go", "Go", 31, 0, 0, 0, 0, 0, 10, 41
"/opt/projects/swiftkube/vendor/k8s.io/kubernetes/pkg/kubelet/util/boottime_util_linux.go", "Go", 29, 0, 0, 0, 0, 0, 9, 38
"/opt/projects/swiftkube/vendor/k8s.io/kubernetes/pkg/kubelet/util/cache/object_cache.go", "Go", 69, 0, 0, 0, 0, 0, 13, 82
"/opt/projects/swiftkube/vendor/k8s.io/kubernetes/pkg/kubelet/util/doc.go", "Go", 14, 0, 0, 0, 0, 0, 5, 19
"/opt/projects/swiftkube/vendor/k8s.io/kubernetes/pkg/kubelet/util/format/pod.go", "Go", 33, 0, 0, 0, 0, 0, 9, 42
"/opt/projects/swiftkube/vendor/k8s.io/kubernetes/pkg/kubelet/util/ioutils/ioutils.go", "Go", 44, 0, 0, 0, 0, 0, 9, 53
"/opt/projects/swiftkube/vendor/k8s.io/kubernetes/pkg/kubelet/util/manager/cache_based_manager.go", "Go", 239, 0, 0, 0, 0, 0, 36, 275
"/opt/projects/swiftkube/vendor/k8s.io/kubernetes/pkg/kubelet/util/manager/manager.go", "Go", 51, 0, 0, 0, 0, 0, 11, 62
"/opt/projects/swiftkube/vendor/k8s.io/kubernetes/pkg/kubelet/util/manager/watch_based_manager.go", "Go", 345, 0, 0, 0, 0, 0, 53, 398
"/opt/projects/swiftkube/vendor/k8s.io/kubernetes/pkg/kubelet/util/nodelease.go", "Go", 47, 0, 0, 0, 0, 0, 9, 56
"/opt/projects/swiftkube/vendor/k8s.io/kubernetes/pkg/kubelet/util/pod_startup_latency_tracker.go", "Go", 152, 0, 0, 0, 0, 0, 35, 187
"/opt/projects/swiftkube/vendor/k8s.io/kubernetes/pkg/kubelet/util/queue/work_queue.go", "Go", 56, 0, 0, 0, 0, 0, 13, 69
"/opt/projects/swiftkube/vendor/k8s.io/kubernetes/pkg/kubelet/util/sliceutils/sliceutils.go", "Go", 40, 0, 0, 0, 0, 0, 12, 52
"/opt/projects/swiftkube/vendor/k8s.io/kubernetes/pkg/kubelet/util/store/doc.go", "Go", 14, 0, 0, 0, 0, 0, 5, 19
"/opt/projects/swiftkube/vendor/k8s.io/kubernetes/pkg/kubelet/util/store/filestore.go", "Go", 133, 0, 0, 0, 0, 0, 26, 159
"/opt/projects/swiftkube/vendor/k8s.io/kubernetes/pkg/kubelet/util/store/store.go", "Go", 53, 0, 0, 0, 0, 0, 12, 65
"/opt/projects/swiftkube/vendor/k8s.io/kubernetes/pkg/kubelet/util/util.go", "Go", 50, 0, 0, 0, 0, 0, 10, 60
"/opt/projects/swiftkube/vendor/k8s.io/kubernetes/pkg/kubelet/util/util_unix.go", "Go", 126, 0, 0, 0, 0, 0, 29, 155
"/opt/projects/swiftkube/vendor/k8s.io/kubernetes/pkg/kubelet/util/util_unsupported.go", "Go", 44, 0, 0, 0, 0, 0, 13, 57
"/opt/projects/swiftkube/vendor/k8s.io/kubernetes/pkg/kubelet/util/util_windows.go", "Go", 183, 0, 0, 0, 0, 0, 31, 214
"/opt/projects/swiftkube/vendor/k8s.io/kubernetes/pkg/kubelet/volume_host.go", "Go", 251, 0, 0, 0, 0, 0, 51, 302
"/opt/projects/swiftkube/vendor/k8s.io/kubernetes/pkg/kubelet/volumemanager/cache/actual_state_of_world.go", "Go", 1089, 0, 0, 0, 0, 0, 188, 1277
"/opt/projects/swiftkube/vendor/k8s.io/kubernetes/pkg/kubelet/volumemanager/cache/desired_state_of_wold_selinux_metrics.go", "Go", 75, 0, 0, 0, 0, 0, 10, 85
"/opt/projects/swiftkube/vendor/k8s.io/kubernetes/pkg/kubelet/volumemanager/cache/desired_state_of_world.go", "Go", 575, 0, 0, 0, 0, 0, 85, 660
"/opt/projects/swiftkube/vendor/k8s.io/kubernetes/pkg/kubelet/volumemanager/metrics/metrics.go", "Go", 129, 0, 0, 0, 0, 0, 23, 152
"/opt/projects/swiftkube/vendor/k8s.io/kubernetes/pkg/kubelet/volumemanager/populator/desired_state_of_world_populator.go", "Go", 574, 0, 0, 0, 0, 0, 67, 641
"/opt/projects/swiftkube/vendor/k8s.io/kubernetes/pkg/kubelet/volumemanager/reconciler/reconciler.go", "Go", 115, 0, 0, 0, 0, 0, 18, 133
"/opt/projects/swiftkube/vendor/k8s.io/kubernetes/pkg/kubelet/volumemanager/reconciler/reconciler_common.go", "Go", 300, 0, 0, 0, 0, 0, 22, 322
"/opt/projects/swiftkube/vendor/k8s.io/kubernetes/pkg/kubelet/volumemanager/reconciler/reconciler_new.go", "Go", 62, 0, 0, 0, 0, 0, 14, 76
"/opt/projects/swiftkube/vendor/k8s.io/kubernetes/pkg/kubelet/volumemanager/reconciler/reconstruct.go", "Go", 174, 0, 0, 0, 0, 0, 15, 189
"/opt/projects/swiftkube/vendor/k8s.io/kubernetes/pkg/kubelet/volumemanager/reconciler/reconstruct_common.go", "Go", 309, 0, 0, 0, 0, 0, 28, 337
"/opt/projects/swiftkube/vendor/k8s.io/kubernetes/pkg/kubelet/volumemanager/reconciler/reconstruct_new.go", "Go", 189, 0, 0, 0, 0, 0, 24, 213
"/opt/projects/swiftkube/vendor/k8s.io/kubernetes/pkg/kubelet/volumemanager/volume_manager.go", "Go", 499, 0, 0, 0, 0, 0, 91, 590
"/opt/projects/swiftkube/vendor/k8s.io/kubernetes/pkg/kubelet/volumemanager/volume_manager_fake.go", "Go", 92, 0, 0, 0, 0, 0, 20, 112
"/opt/projects/swiftkube/vendor/k8s.io/kubernetes/pkg/kubelet/winstats/doc.go", "Go", 14, 0, 0, 0, 0, 0, 5, 19
"/opt/projects/swiftkube/vendor/k8s.io/kubernetes/pkg/kubelet/winstats/network_stats.go", "Go", 265, 0, 0, 0, 0, 0, 49, 314
"/opt/projects/swiftkube/vendor/k8s.io/kubernetes/pkg/kubelet/winstats/perfcounter_nodestats.go", "Go", 259, 0, 0, 0, 0, 0, 45, 304
"/opt/projects/swiftkube/vendor/k8s.io/kubernetes/pkg/kubelet/winstats/perfcounters.go", "Go", 110, 0, 0, 0, 0, 0, 27, 137
"/opt/projects/swiftkube/vendor/k8s.io/kubernetes/pkg/kubelet/winstats/version.go", "Go", 69, 0, 0, 0, 0, 0, 18, 87
"/opt/projects/swiftkube/vendor/k8s.io/kubernetes/pkg/kubelet/winstats/winstats.go", "Go", 159, 0, 0, 0, 0, 0, 30, 189
"/opt/projects/swiftkube/vendor/k8s.io/kubernetes/pkg/probe/dialer_others.go", "Go", 35, 0, 0, 0, 0, 0, 8, 43
"/opt/projects/swiftkube/vendor/k8s.io/kubernetes/pkg/probe/dialer_windows.go", "Go", 35, 0, 0, 0, 0, 0, 8, 43
"/opt/projects/swiftkube/vendor/k8s.io/kubernetes/pkg/probe/doc.go", "Go", 14, 0, 0, 0, 0, 0, 5, 19
"/opt/projects/swiftkube/vendor/k8s.io/kubernetes/pkg/probe/exec/errors.go", "Go", 38, 0, 0, 0, 0, 0, 10, 48
"/opt/projects/swiftkube/vendor/k8s.io/kubernetes/pkg/probe/exec/exec.go", "Go", 68, 0, 0, 0, 0, 0, 18, 86
"/opt/projects/swiftkube/vendor/k8s.io/kubernetes/pkg/probe/grpc/grpc.go", "Go", 95, 0, 0, 0, 0, 0, 23, 118
"/opt/projects/swiftkube/vendor/k8s.io/kubernetes/pkg/probe/http/http.go", "Go", 123, 0, 0, 0, 0, 0, 19, 142
"/opt/projects/swiftkube/vendor/k8s.io/kubernetes/pkg/probe/http/request.go", "Go", 101, 0, 0, 0, 0, 0, 19, 120
"/opt/projects/swiftkube/vendor/k8s.io/kubernetes/pkg/probe/probe.go", "Go", 25, 0, 0, 0, 0, 0, 7, 32
"/opt/projects/swiftkube/vendor/k8s.io/kubernetes/pkg/probe/tcp/tcp.go", "Go", 51, 0, 0, 0, 0, 0, 13, 64
"/opt/projects/swiftkube/vendor/k8s.io/kubernetes/pkg/probe/util.go", "Go", 49, 0, 0, 0, 0, 0, 9, 58
"/opt/projects/swiftkube/vendor/k8s.io/kubernetes/pkg/proxy/config/config.go", "Go", 325, 0, 0, 0, 0, 0, 49, 374
"/opt/projects/swiftkube/vendor/k8s.io/kubernetes/pkg/proxy/config/doc.go", "Go", 21, 0, 0, 0, 0, 0, 5, 26
"/opt/projects/swiftkube/vendor/k8s.io/kubernetes/pkg/proxy/conntrack/cleanup.go", "Go", 100, 0, 0, 0, 0, 0, 12, 112
"/opt/projects/swiftkube/vendor/k8s.io/kubernetes/pkg/proxy/conntrack/conntrack.go", "Go", 107, 0, 0, 0, 0, 0, 16, 123
"/opt/projects/swiftkube/vendor/k8s.io/kubernetes/pkg/proxy/doc.go", "Go", 14, 0, 0, 0, 0, 0, 5, 19
"/opt/projects/swiftkube/vendor/k8s.io/kubernetes/pkg/proxy/endpoints.go", "Go", 400, 0, 0, 0, 0, 0, 68, 468
"/opt/projects/swiftkube/vendor/k8s.io/kubernetes/pkg/proxy/endpointslicecache.go", "Go", 361, 0, 0, 0, 0, 0, 78, 439
"/opt/projects/swiftkube/vendor/k8s.io/kubernetes/pkg/proxy/healthcheck/common.go", "Go", 50, 0, 0, 0, 0, 0, 15, 65
"/opt/projects/swiftkube/vendor/k8s.io/kubernetes/pkg/proxy/healthcheck/doc.go", "Go", 14, 0, 0, 0, 0, 0, 5, 19
"/opt/projects/swiftkube/vendor/k8s.io/kubernetes/pkg/proxy/healthcheck/proxier_health.go", "Go", 201, 0, 0, 0, 0, 0, 33, 234
"/opt/projects/swiftkube/vendor/k8s.io/kubernetes/pkg/proxy/healthcheck/service_health.go", "Go", 242, 0, 0, 0, 0, 0, 50, 292
"/opt/projects/swiftkube/vendor/k8s.io/kubernetes/pkg/proxy/ipvs/graceful_termination.go", "Go", 188, 0, 0, 0, 0, 0, 30, 218
"/opt/projects/swiftkube/vendor/k8s.io/kubernetes/pkg/proxy/ipvs/ipset.go", "Go", 169, 0, 0, 0, 0, 0, 39, 208
"/opt/projects/swiftkube/vendor/k8s.io/kubernetes/pkg/proxy/ipvs/ipset/ipset.go", "Go", 487, 0, 0, 0, 0, 0, 48, 535
"/opt/projects/swiftkube/vendor/k8s.io/kubernetes/pkg/proxy/ipvs/ipset/types.go", "Go", 56, 0, 0, 0, 0, 0, 10, 66
"/opt/projects/swiftkube/vendor/k8s.io/kubernetes/pkg/proxy/ipvs/netlink.go", "Go", 42, 0, 0, 0, 0, 0, 7, 49
"/opt/projects/swiftkube/vendor/k8s.io/kubernetes/pkg/proxy/ipvs/netlink_linux.go", "Go", 175, 0, 0, 0, 0, 0, 20, 195
"/opt/projects/swiftkube/vendor/k8s.io/kubernetes/pkg/proxy/ipvs/netlink_unsupported.go", "Go", 64, 0, 0, 0, 0, 0, 19, 83
"/opt/projects/swiftkube/vendor/k8s.io/kubernetes/pkg/proxy/ipvs/proxier.go", "Go", 1815, 0, 0, 0, 0, 0, 196, 2011
"/opt/projects/swiftkube/vendor/k8s.io/kubernetes/pkg/proxy/ipvs/safe_ipset.go", "Go", 86, 0, 0, 0, 0, 0, 19, 105
"/opt/projects/swiftkube/vendor/k8s.io/kubernetes/pkg/proxy/ipvs/util/ipvs.go", "Go", 97, 0, 0, 0, 0, 0, 16, 113
"/opt/projects/swiftkube/vendor/k8s.io/kubernetes/pkg/proxy/ipvs/util/ipvs_linux.go", "Go", 287, 0, 0, 0, 0, 0, 34, 321
"/opt/projects/swiftkube/vendor/k8s.io/kubernetes/pkg/proxy/ipvs/util/ipvs_unsupported.go", "Go", 59, 0, 0, 0, 0, 0, 21, 80
"/opt/projects/swiftkube/vendor/k8s.io/kubernetes/pkg/proxy/metaproxier/meta_proxier.go", "Go", 137, 0, 0, 0, 0, 0, 24, 161
"/opt/projects/swiftkube/vendor/k8s.io/kubernetes/pkg/proxy/metrics/metrics.go", "Go", 238, 0, 0, 0, 0, 0, 29, 267
"/opt/projects/swiftkube/vendor/k8s.io/kubernetes/pkg/proxy/node.go", "Go", 88, 0, 0, 0, 0, 0, 21, 109
"/opt/projects/swiftkube/vendor/k8s.io/kubernetes/pkg/proxy/service.go", "Go", 427, 0, 0, 0, 0, 0, 65, 492
"/opt/projects/swiftkube/vendor/k8s.io/kubernetes/pkg/proxy/topology.go", "Go", 177, 0, 0, 0, 0, 0, 28, 205
"/opt/projects/swiftkube/vendor/k8s.io/kubernetes/pkg/proxy/types.go", "Go", 132, 0, 0, 0, 0, 0, 15, 147
"/opt/projects/swiftkube/vendor/k8s.io/kubernetes/pkg/proxy/util/endpoints.go", "Go", 56, 0, 0, 0, 0, 0, 9, 65
"/opt/projects/swiftkube/vendor/k8s.io/kubernetes/pkg/proxy/util/iptables/traffic.go", "Go", 115, 0, 0, 0, 0, 0, 30, 145
"/opt/projects/swiftkube/vendor/k8s.io/kubernetes/pkg/proxy/util/linebuffer.go", "Go", 123, 0, 0, 0, 0, 0, 28, 151
"/opt/projects/swiftkube/vendor/k8s.io/kubernetes/pkg/proxy/util/network.go", "Go", 30, 0, 0, 0, 0, 0, 10, 40
"/opt/projects/swiftkube/vendor/k8s.io/kubernetes/pkg/proxy/util/nodeport_addresses.go", "Go", 110, 0, 0, 0, 0, 0, 25, 135
"/opt/projects/swiftkube/vendor/k8s.io/kubernetes/pkg/proxy/util/utils.go", "Go", 290, 0, 0, 0, 0, 0, 44, 334
"/opt/projects/swiftkube/vendor/k8s.io/kubernetes/pkg/registry/core/service/allocator/bitmap.go", "Go", 225, 0, 0, 0, 0, 0, 40, 265
"/opt/projects/swiftkube/vendor/k8s.io/kubernetes/pkg/registry/core/service/allocator/interfaces.go", "Go", 36, 0, 0, 0, 0, 0, 10, 46
"/opt/projects/swiftkube/vendor/k8s.io/kubernetes/pkg/registry/core/service/allocator/utils.go", "Go", 25, 0, 0, 0, 0, 0, 7, 32
"/opt/projects/swiftkube/vendor/k8s.io/kubernetes/pkg/scheduler/apis/config/doc.go", "Go", 15, 0, 0, 0, 0, 0, 6, 21
"/opt/projects/swiftkube/vendor/k8s.io/kubernetes/pkg/scheduler/apis/config/register.go", "Go", 41, 0, 0, 0, 0, 0, 10, 51
"/opt/projects/swiftkube/vendor/k8s.io/kubernetes/pkg/scheduler/apis/config/scheme/scheme.go", "Go", 40, 0, 0, 0, 0, 0, 10, 50
"/opt/projects/swiftkube/vendor/k8s.io/kubernetes/pkg/scheduler/apis/config/types.go", "Go", 294, 0, 0, 0, 0, 0, 51, 345
"/opt/projects/swiftkube/vendor/k8s.io/kubernetes/pkg/scheduler/apis/config/types_pluginargs.go", "Go", 178, 0, 0, 0, 0, 0, 41, 219
"/opt/projects/swiftkube/vendor/k8s.io/kubernetes/pkg/scheduler/apis/config/v1/conversion.go", "Go", 95, 0, 0, 0, 0, 0, 13, 108
"/opt/projects/swiftkube/vendor/k8s.io/kubernetes/pkg/scheduler/apis/config/v1/default_plugins.go", "Go", 147, 0, 0, 0, 0, 0, 16, 163
"/opt/projects/swiftkube/vendor/k8s.io/kubernetes/pkg/scheduler/apis/config/v1/defaults.go", "Go", 217, 0, 0, 0, 0, 0, 28, 245
"/opt/projects/swiftkube/vendor/k8s.io/kubernetes/pkg/scheduler/apis/config/v1/doc.go", "Go", 19, 0, 0, 0, 0, 0, 6, 25
"/opt/projects/swiftkube/vendor/k8s.io/kubernetes/pkg/scheduler/apis/config/v1/register.go", "Go", 33, 0, 0, 0, 0, 0, 10, 43
"/opt/projects/swiftkube/vendor/k8s.io/kubernetes/pkg/scheduler/apis/config/v1/zz_generated.conversion.go", "Go", 860, 0, 0, 0, 0, 0, 89, 949
"/opt/projects/swiftkube/vendor/k8s.io/kubernetes/pkg/scheduler/apis/config/v1/zz_generated.deepcopy.go", "Go", 16, 0, 0, 0, 0, 0, 7, 23
"/opt/projects/swiftkube/vendor/k8s.io/kubernetes/pkg/scheduler/apis/config/v1/zz_generated.defaults.go", "Go", 58, 0, 0, 0, 0, 0, 16, 74
"/opt/projects/swiftkube/vendor/k8s.io/kubernetes/pkg/scheduler/apis/config/v1beta3/conversion.go", "Go", 104, 0, 0, 0, 0, 0, 15, 119
"/opt/projects/swiftkube/vendor/k8s.io/kubernetes/pkg/scheduler/apis/config/v1beta3/default_plugins.go", "Go", 129, 0, 0, 0, 0, 0, 16, 145
"/opt/projects/swiftkube/vendor/k8s.io/kubernetes/pkg/scheduler/apis/config/v1beta3/defaults.go", "Go", 215, 0, 0, 0, 0, 0, 28, 243
"/opt/projects/swiftkube/vendor/k8s.io/kubernetes/pkg/scheduler/apis/config/v1beta3/doc.go", "Go", 19, 0, 0, 0, 0, 0, 6, 25
"/opt/projects/swiftkube/vendor/k8s.io/kubernetes/pkg/scheduler/apis/config/v1beta3/register.go", "Go", 33, 0, 0, 0, 0, 0, 10, 43
"/opt/projects/swiftkube/vendor/k8s.io/kubernetes/pkg/scheduler/apis/config/v1beta3/zz_generated.conversion.go", "Go", 850, 0, 0, 0, 0, 0, 87, 937
"/opt/projects/swiftkube/vendor/k8s.io/kubernetes/pkg/scheduler/apis/config/v1beta3/zz_generated.deepcopy.go", "Go", 16, 0, 0, 0, 0, 0, 7, 23
"/opt/projects/swiftkube/vendor/k8s.io/kubernetes/pkg/scheduler/apis/config/v1beta3/zz_generated.defaults.go", "Go", 58, 0, 0, 0, 0, 0, 16, 74
"/opt/projects/swiftkube/vendor/k8s.io/kubernetes/pkg/scheduler/apis/config/validation/validation.go", "Go", 309, 0, 0, 0, 0, 0, 29, 338
"/opt/projects/swiftkube/vendor/k8s.io/kubernetes/pkg/scheduler/apis/config/validation/validation_pluginargs.go", "Go", 290, 0, 0, 0, 0, 0, 40, 330
"/opt/projects/swiftkube/vendor/k8s.io/kubernetes/pkg/scheduler/apis/config/zz_generated.deepcopy.go", "Go", 507, 0, 0, 0, 0, 0, 56, 563
"/opt/projects/swiftkube/vendor/k8s.io/kubernetes/pkg/scheduler/eventhandlers.go", "Go", 576, 0, 0, 0, 0, 0, 47, 623
"/opt/projects/swiftkube/vendor/k8s.io/kubernetes/pkg/scheduler/extender.go", "Go", 399, 0, 0, 0, 0, 0, 46, 445
"/opt/projects/swiftkube/vendor/k8s.io/kubernetes/pkg/scheduler/framework/cycle_state.go", "Go", 105, 0, 0, 0, 0, 0, 19, 124
"/opt/projects/swiftkube/vendor/k8s.io/kubernetes/pkg/scheduler/framework/extender.go", "Go", 58, 0, 0, 0, 0, 0, 15, 73
"/opt/projects/swiftkube/vendor/k8s.io/kubernetes/pkg/scheduler/framework/interface.go", "Go", 647, 0, 0, 0, 0, 0, 104, 751
"/opt/projects/swiftkube/vendor/k8s.io/kubernetes/pkg/scheduler/framework/listers.go", "Go", 35, 0, 0, 0, 0, 0, 8, 43
"/opt/projects/swiftkube/vendor/k8s.io/kubernetes/pkg/scheduler/framework/parallelize/error_channel.go", "Go", 49, 0, 0, 0, 0, 0, 11, 60
"/opt/projects/swiftkube/vendor/k8s.io/kubernetes/pkg/scheduler/framework/parallelize/parallelism.go", "Go", 52, 0, 0, 0, 0, 0, 14, 66
"/opt/projects/swiftkube/vendor/k8s.io/kubernetes/pkg/scheduler/framework/plugins/defaultbinder/default_binder.go", "Go", 51, 0, 0, 0, 0, 0, 13, 64
"/opt/projects/swiftkube/vendor/k8s.io/kubernetes/pkg/scheduler/framework/plugins/defaultpreemption/default_preemption.go", "Go", 310, 0, 0, 0, 0, 0, 31, 341
"/opt/projects/swiftkube/vendor/k8s.io/kubernetes/pkg/scheduler/framework/plugins/dynamicresources/dynamicresources.go", "Go", 941, 0, 0, 0, 0, 0, 92, 1033
"/opt/projects/swiftkube/vendor/k8s.io/kubernetes/pkg/scheduler/framework/plugins/feature/feature.go", "Go", 28, 0, 0, 0, 0, 0, 6, 34
"/opt/projects/swiftkube/vendor/k8s.io/kubernetes/pkg/scheduler/framework/plugins/helper/normalize_score.go", "Go", 45, 0, 0, 0, 0, 0, 11, 56
"/opt/projects/swiftkube/vendor/k8s.io/kubernetes/pkg/scheduler/framework/plugins/helper/shape_score.go", "Go", 45, 0, 0, 0, 0, 0, 8, 53
"/opt/projects/swiftkube/vendor/k8s.io/kubernetes/pkg/scheduler/framework/plugins/helper/spread.go", "Go", 101, 0, 0, 0, 0, 0, 16, 117
"/opt/projects/swiftkube/vendor/k8s.io/kubernetes/pkg/scheduler/framework/plugins/helper/taint.go", "Go", 22, 0, 0, 0, 0, 0, 7, 29
"/opt/projects/swiftkube/vendor/k8s.io/kubernetes/pkg/scheduler/framework/plugins/imagelocality/image_locality.go", "Go", 104, 0, 0, 0, 0, 0, 23, 127
"/opt/projects/swiftkube/vendor/k8s.io/kubernetes/pkg/scheduler/framework/plugins/interpodaffinity/filtering.go", "Go", 334, 0, 0, 0, 0, 0, 53, 387
"/opt/projects/swiftkube/vendor/k8s.io/kubernetes/pkg/scheduler/framework/plugins/interpodaffinity/plugin.go", "Go", 117, 0, 0, 0, 0, 0, 17, 134
"/opt/projects/swiftkube/vendor/k8s.io/kubernetes/pkg/scheduler/framework/plugins/interpodaffinity/scoring.go", "Go", 258, 0, 0, 0, 0, 0, 45, 303
"/opt/projects/swiftkube/vendor/k8s.io/kubernetes/pkg/scheduler/framework/plugins/names/names.go", "Go", 39, 0, 0, 0, 0, 0, 6, 45
"/opt/projects/swiftkube/vendor/k8s.io/kubernetes/pkg/scheduler/framework/plugins/nodeaffinity/node_affinity.go", "Go", 265, 0, 0, 0, 0, 0, 48, 313
"/opt/projects/swiftkube/vendor/k8s.io/kubernetes/pkg/scheduler/framework/plugins/nodename/node_name.go", "Go", 56, 0, 0, 0, 0, 0, 17, 73
"/opt/projects/swiftkube/vendor/k8s.io/kubernetes/pkg/scheduler/framework/plugins/nodeports/node_ports.go", "Go", 128, 0, 0, 0, 0, 0, 27, 155
"/opt/projects/swiftkube/vendor/k8s.io/kubernetes/pkg/scheduler/framework/plugins/noderesources/balanced_allocation.go", "Go", 145, 0, 0, 0, 0, 0, 29, 174
"/opt/projects/swiftkube/vendor/k8s.io/kubernetes/pkg/scheduler/framework/plugins/noderesources/fit.go", "Go", 356, 0, 0, 0, 0, 0, 50, 406
"/opt/projects/swiftkube/vendor/k8s.io/kubernetes/pkg/scheduler/framework/plugins/noderesources/least_allocated.go", "Go", 53, 0, 0, 0, 0, 0, 9, 62
"/opt/projects/swiftkube/vendor/k8s.io/kubernetes/pkg/scheduler/framework/plugins/noderesources/most_allocated.go", "Go", 57, 0, 0, 0, 0, 0, 9, 66
"/opt/projects/swiftkube/vendor/k8s.io/kubernetes/pkg/scheduler/framework/plugins/noderesources/requested_to_capacity_ratio.go", "Go", 62, 0, 0, 0, 0, 0, 12, 74
"/opt/projects/swiftkube/vendor/k8s.io/kubernetes/pkg/scheduler/framework/plugins/noderesources/resource_allocation.go", "Go", 123, 0, 0, 0, 0, 0, 23, 146
"/opt/projects/swiftkube/vendor/k8s.io/kubernetes/pkg/scheduler/framework/plugins/noderesources/test_util.go", "Go", 49, 0, 0, 0, 0, 0, 8, 57
"/opt/projects/swiftkube/vendor/k8s.io/kubernetes/pkg/scheduler/framework/plugins/nodeunschedulable/node_unschedulable.go", "Go", 63, 0, 0, 0, 0, 0, 16, 79
"/opt/projects/swiftkube/vendor/k8s.io/kubernetes/pkg/scheduler/framework/plugins/nodevolumelimits/csi.go", "Go", 353, 0, 0, 0, 0, 0, 58, 411
"/opt/projects/swiftkube/vendor/k8s.io/kubernetes/pkg/scheduler/framework/plugins/nodevolumelimits/non_csi.go", "Go", 482, 0, 0, 0, 0, 0, 76, 558
"/opt/projects/swiftkube/vendor/k8s.io/kubernetes/pkg/scheduler/framework/plugins/nodevolumelimits/utils.go", "Go", 78, 0, 0, 0, 0, 0, 13, 91
"/opt/projects/swiftkube/vendor/k8s.io/kubernetes/pkg/scheduler/framework/plugins/podtopologyspread/common.go", "Go", 147, 0, 0, 0, 0, 0, 20, 167
"/opt/projects/swiftkube/vendor/k8s.io/kubernetes/pkg/scheduler/framework/plugins/podtopologyspread/filtering.go", "Go", 341, 0, 0, 0, 0, 0, 53, 394
"/opt/projects/swiftkube/vendor/k8s.io/kubernetes/pkg/scheduler/framework/plugins/podtopologyspread/plugin.go", "Go", 132, 0, 0, 0, 0, 0, 17, 149
"/opt/projects/swiftkube/vendor/k8s.io/kubernetes/pkg/scheduler/framework/plugins/podtopologyspread/scoring.go", "Go", 272, 0, 0, 0, 0, 0, 34, 306
"/opt/projects/swiftkube/vendor/k8s.io/kubernetes/pkg/scheduler/framework/plugins/queuesort/priority_sort.go", "Go", 40, 0, 0, 0, 0, 0, 12, 52
"/opt/projects/swiftkube/vendor/k8s.io/kubernetes/pkg/scheduler/framework/plugins/registry.go", "Go", 82, 0, 0, 0, 0, 0, 9, 91
"/opt/projects/swiftkube/vendor/k8s.io/kubernetes/pkg/scheduler/framework/plugins/schedulinggates/scheduling_gates.go", "Go", 54, 0, 0, 0, 0, 0, 14, 68
"/opt/projects/swiftkube/vendor/k8s.io/kubernetes/pkg/scheduler/framework/plugins/selectorspread/selector_spread.go", "Go", 203, 0, 0, 0, 0, 0, 32, 235
"/opt/projects/swiftkube/vendor/k8s.io/kubernetes/pkg/scheduler/framework/plugins/tainttoleration/taint_toleration.go", "Go", 141, 0, 0, 0, 0, 0, 29, 170
"/opt/projects/swiftkube/vendor/k8s.io/kubernetes/pkg/scheduler/framework/plugins/volumebinding/assume_cache.go", "Go", 379, 0, 0, 0, 0, 0, 78, 457
"/opt/projects/swiftkube/vendor/k8s.io/kubernetes/pkg/scheduler/framework/plugins/volumebinding/binder.go", "Go", 1004, 0, 0, 0, 0, 0, 149, 1153
"/opt/projects/swiftkube/vendor/k8s.io/kubernetes/pkg/scheduler/framework/plugins/volumebinding/fake_binder.go", "Go", 64, 0, 0, 0, 0, 0, 17, 81
"/opt/projects/swiftkube/vendor/k8s.io/kubernetes/pkg/scheduler/framework/plugins/volumebinding/metrics/metrics.go", "Go", 47, 0, 0, 0, 0, 0, 9, 56
"/opt/projects/swiftkube/vendor/k8s.io/kubernetes/pkg/scheduler/framework/plugins/volumebinding/scorer.go", "Go", 44, 0, 0, 0, 0, 0, 11, 55
"/opt/projects/swiftkube/vendor/k8s.io/kubernetes/pkg/scheduler/framework/plugins/volumebinding/test_utils.go", "Go", 178, 0, 0, 0, 0, 0, 29, 207
"/opt/projects/swiftkube/vendor/k8s.io/kubernetes/pkg/scheduler/framework/plugins/volumebinding/volume_binding.go", "Go", 368, 0, 0, 0, 0, 0, 37, 405
"/opt/projects/swiftkube/vendor/k8s.io/kubernetes/pkg/scheduler/framework/plugins/volumerestrictions/volume_restrictions.go", "Go", 318, 0, 0, 0, 0, 0, 44, 362
"/opt/projects/swiftkube/vendor/k8s.io/kubernetes/pkg/scheduler/framework/plugins/volumezone/volume_zone.go", "Go", 255, 0, 0, 0, 0, 0, 35, 290
"/opt/projects/swiftkube/vendor/k8s.io/kubernetes/pkg/scheduler/framework/preemption/preemption.go", "Go", 549, 0, 0, 0, 0, 0, 60, 609
"/opt/projects/swiftkube/vendor/k8s.io/kubernetes/pkg/scheduler/framework/runtime/framework.go", "Go", 1390, 0, 0, 0, 0, 0, 155, 1545
"/opt/projects/swiftkube/vendor/k8s.io/kubernetes/pkg/scheduler/framework/runtime/instrumented_plugins.go", "Go", 61, 0, 0, 0, 0, 0, 23, 84
"/opt/projects/swiftkube/vendor/k8s.io/kubernetes/pkg/scheduler/framework/runtime/registry.go", "Go", 85, 0, 0, 0, 0, 0, 16, 101
"/opt/projects/swiftkube/vendor/k8s.io/kubernetes/pkg/scheduler/framework/runtime/waiting_pods_map.go", "Go", 140, 0, 0, 0, 0, 0, 26, 166
"/opt/projects/swiftkube/vendor/k8s.io/kubernetes/pkg/scheduler/framework/types.go", "Go", 899, 0, 0, 0, 0, 0, 123, 1022
"/opt/projects/swiftkube/vendor/k8s.io/kubernetes/pkg/scheduler/internal/cache/cache.go", "Go", 689, 0, 0, 0, 0, 0, 87, 776
"/opt/projects/swiftkube/vendor/k8s.io/kubernetes/pkg/scheduler/internal/cache/debugger/comparer.go", "Go", 109, 0, 0, 0, 0, 0, 27, 136
"/opt/projects/swiftkube/vendor/k8s.io/kubernetes/pkg/scheduler/internal/cache/debugger/debugger.go", "Go", 66, 0, 0, 0, 0, 0, 11, 77
"/opt/projects/swiftkube/vendor/k8s.io/kubernetes/pkg/scheduler/internal/cache/debugger/dumper.go", "Go", 75, 0, 0, 0, 0, 0, 14, 89
"/opt/projects/swiftkube/vendor/k8s.io/kubernetes/pkg/scheduler/internal/cache/debugger/signal.go", "Go", 19, 0, 0, 0, 0, 0, 8, 27
"/opt/projects/swiftkube/vendor/k8s.io/kubernetes/pkg/scheduler/internal/cache/debugger/signal_windows.go", "Go", 17, 0, 0, 0, 0, 0, 7, 24
"/opt/projects/swiftkube/vendor/k8s.io/kubernetes/pkg/scheduler/internal/cache/interface.go", "Go", 102, 0, 0, 0, 0, 0, 22, 124
"/opt/projects/swiftkube/vendor/k8s.io/kubernetes/pkg/scheduler/internal/cache/node_tree.go", "Go", 130, 0, 0, 0, 0, 0, 14, 144
"/opt/projects/swiftkube/vendor/k8s.io/kubernetes/pkg/scheduler/internal/cache/snapshot.go", "Go", 170, 0, 0, 0, 0, 0, 29, 199
"/opt/projects/swiftkube/vendor/k8s.io/kubernetes/pkg/scheduler/internal/heap/heap.go", "Go", 214, 0, 0, 0, 0, 0, 33, 247
"/opt/projects/swiftkube/vendor/k8s.io/kubernetes/pkg/scheduler/internal/queue/events.go", "Go", 80, 0, 0, 0, 0, 0, 8, 88
"/opt/projects/swiftkube/vendor/k8s.io/kubernetes/pkg/scheduler/internal/queue/scheduling_queue.go", "Go", 1296, 0, 0, 0, 0, 0, 161, 1457
"/opt/projects/swiftkube/vendor/k8s.io/kubernetes/pkg/scheduler/internal/queue/testing.go", "Go", 46, 0, 0, 0, 0, 0, 10, 56
"/opt/projects/swiftkube/vendor/k8s.io/kubernetes/pkg/scheduler/metrics/metric_recorder.go", "Go", 134, 0, 0, 0, 0, 0, 24, 158
"/opt/projects/swiftkube/vendor/k8s.io/kubernetes/pkg/scheduler/metrics/metrics.go", "Go", 242, 0, 0, 0, 0, 0, 31, 273
"/opt/projects/swiftkube/vendor/k8s.io/kubernetes/pkg/scheduler/metrics/profile_metrics.go", "Go", 38, 0, 0, 0, 0, 0, 11, 49
"/opt/projects/swiftkube/vendor/k8s.io/kubernetes/pkg/scheduler/profile/profile.go", "Go", 101, 0, 0, 0, 0, 0, 17, 118
"/opt/projects/swiftkube/vendor/k8s.io/kubernetes/pkg/scheduler/schedule_one.go", "Go", 943, 0, 0, 0, 0, 0, 124, 1067
"/opt/projects/swiftkube/vendor/k8s.io/kubernetes/pkg/scheduler/scheduler.go", "Go", 428, 0, 0, 0, 0, 0, 75, 503
"/opt/projects/swiftkube/vendor/k8s.io/kubernetes/pkg/scheduler/util/pod_resources.go", "Go", 72, 0, 0, 0, 0, 0, 10, 82
"/opt/projects/swiftkube/vendor/k8s.io/kubernetes/pkg/scheduler/util/utils.go", "Go", 166, 0, 0, 0, 0, 0, 26, 192
"/opt/projects/swiftkube/vendor/k8s.io/kubernetes/pkg/security/apparmor/helpers.go", "Go", 35, 0, 0, 0, 0, 0, 10, 45
"/opt/projects/swiftkube/vendor/k8s.io/kubernetes/pkg/security/apparmor/validate.go", "Go", 90, 0, 0, 0, 0, 0, 20, 110
"/opt/projects/swiftkube/vendor/k8s.io/kubernetes/pkg/security/apparmor/validate_disabled.go", "Go", 19, 0, 0, 0, 0, 0, 7, 26
"/opt/projects/swiftkube/vendor/k8s.io/kubernetes/pkg/securitycontext/accessors.go", "Go", 478, 0, 0, 0, 0, 0, 36, 514
"/opt/projects/swiftkube/vendor/k8s.io/kubernetes/pkg/securitycontext/doc.go", "Go", 14, 0, 0, 0, 0, 0, 5, 19
"/opt/projects/swiftkube/vendor/k8s.io/kubernetes/pkg/securitycontext/fake.go", "Go", 39, 0, 0, 0, 0, 0, 8, 47
"/opt/projects/swiftkube/vendor/k8s.io/kubernetes/pkg/securitycontext/util.go", "Go", 199, 0, 0, 0, 0, 0, 38, 237
"/opt/projects/swiftkube/vendor/k8s.io/kubernetes/pkg/util/async/bounded_frequency_runner.go", "Go", 264, 0, 0, 0, 0, 0, 50, 314
"/opt/projects/swiftkube/vendor/k8s.io/kubernetes/pkg/util/async/runner.go", "Go", 49, 0, 0, 0, 0, 0, 10, 59
"/opt/projects/swiftkube/vendor/k8s.io/kubernetes/pkg/util/config/config.go", "Go", 117, 0, 0, 0, 0, 0, 26, 143
"/opt/projects/swiftkube/vendor/k8s.io/kubernetes/pkg/util/config/doc.go", "Go", 16, 0, 0, 0, 0, 0, 5, 21
"/opt/projects/swiftkube/vendor/k8s.io/kubernetes/pkg/util/filesystem/defaultfs.go", "Go", 119, 0, 0, 0, 0, 0, 27, 146
"/opt/projects/swiftkube/vendor/k8s.io/kubernetes/pkg/util/filesystem/filesystem.go", "Go", 44, 0, 0, 0, 0, 0, 9, 53
"/opt/projects/swiftkube/vendor/k8s.io/kubernetes/pkg/util/filesystem/watcher.go", "Go", 72, 0, 0, 0, 0, 0, 18, 90
"/opt/projects/swiftkube/vendor/k8s.io/kubernetes/pkg/util/flag/flags.go", "Go", 255, 0, 0, 0, 0, 0, 45, 300
"/opt/projects/swiftkube/vendor/k8s.io/kubernetes/pkg/util/flock/flock_other.go", "Go", 19, 0, 0, 0, 0, 0, 7, 26
"/opt/projects/swiftkube/vendor/k8s.io/kubernetes/pkg/util/flock/flock_unix.go", "Go", 27, 0, 0, 0, 0, 0, 10, 37
"/opt/projects/swiftkube/vendor/k8s.io/kubernetes/pkg/util/goroutinemap/exponentialbackoff/exponential_backoff.go", "Go", 103, 0, 0, 0, 0, 0, 19, 122
"/opt/projects/swiftkube/vendor/k8s.io/kubernetes/pkg/util/goroutinemap/goroutinemap.go", "Go", 197, 0, 0, 0, 0, 0, 34, 231
"/opt/projects/swiftkube/vendor/k8s.io/kubernetes/pkg/util/hash/hash.go", "Go", 25, 0, 0, 0, 0, 0, 8, 33
"/opt/projects/swiftkube/vendor/k8s.io/kubernetes/pkg/util/iptables/doc.go", "Go", 14, 0, 0, 0, 0, 0, 5, 19
"/opt/projects/swiftkube/vendor/k8s.io/kubernetes/pkg/util/iptables/iptables.go", "Go", 750, 0, 0, 0, 0, 0, 127, 877
"/opt/projects/swiftkube/vendor/k8s.io/kubernetes/pkg/util/iptables/iptables_linux.go", "Go", 84, 0, 0, 0, 0, 0, 18, 102
"/opt/projects/swiftkube/vendor/k8s.io/kubernetes/pkg/util/iptables/iptables_unsupported.go", "Go", 25, 0, 0, 0, 0, 0, 9, 34
"/opt/projects/swiftkube/vendor/k8s.io/kubernetes/pkg/util/iptables/save_restore.go", "Go", 44, 0, 0, 0, 0, 0, 9, 53
"/opt/projects/swiftkube/vendor/k8s.io/kubernetes/pkg/util/node/node.go", "Go", 136, 0, 0, 0, 0, 0, 19, 155
"/opt/projects/swiftkube/vendor/k8s.io/kubernetes/pkg/util/oom/doc.go", "Go", 14, 0, 0, 0, 0, 0, 5, 19
"/opt/projects/swiftkube/vendor/k8s.io/kubernetes/pkg/util/oom/oom.go", "Go", 21, 0, 0, 0, 0, 0, 6, 27
"/opt/projects/swiftkube/vendor/k8s.io/kubernetes/pkg/util/oom/oom_fake.go", "Go", 27, 0, 0, 0, 0, 0, 9, 36
"/opt/projects/swiftkube/vendor/k8s.io/kubernetes/pkg/util/oom/oom_linux.go", "Go", 115, 0, 0, 0, 0, 0, 16, 131
"/opt/projects/swiftkube/vendor/k8s.io/kubernetes/pkg/util/oom/oom_unsupported.go", "Go", 31, 0, 0, 0, 0, 0, 11, 42
"/opt/projects/swiftkube/vendor/k8s.io/kubernetes/pkg/util/parsers/parsers.go", "Go", 44, 0, 0, 0, 0, 0, 11, 55
"/opt/projects/swiftkube/vendor/k8s.io/kubernetes/pkg/util/pod/pod.go", "Go", 69, 0, 0, 0, 0, 0, 13, 82
"/opt/projects/swiftkube/vendor/k8s.io/kubernetes/pkg/util/removeall/removeall.go", "Go", 113, 0, 0, 0, 0, 0, 16, 129
"/opt/projects/swiftkube/vendor/k8s.io/kubernetes/pkg/util/rlimit/rlimit_linux.go", "Go", 22, 0, 0, 0, 0, 0, 8, 30
"/opt/projects/swiftkube/vendor/k8s.io/kubernetes/pkg/util/rlimit/rlimit_unsupported.go", "Go", 22, 0, 0, 0, 0, 0, 8, 30
"/opt/projects/swiftkube/vendor/k8s.io/kubernetes/pkg/util/tail/tail.go", "Go", 89, 0, 0, 0, 0, 0, 10, 99
"/opt/projects/swiftkube/vendor/k8s.io/kubernetes/pkg/util/taints/taints.go", "Go", 249, 0, 0, 0, 0, 0, 41, 290
"/opt/projects/swiftkube/vendor/k8s.io/kubernetes/pkg/volume/azure_file/azure_file.go", "Go", 354, 0, 0, 0, 0, 0, 61, 415
"/opt/projects/swiftkube/vendor/k8s.io/kubernetes/pkg/volume/azure_file/azure_provision.go", "Go", 247, 0, 0, 0, 0, 0, 38, 285
"/opt/projects/swiftkube/vendor/k8s.io/kubernetes/pkg/volume/azure_file/azure_util.go", "Go", 141, 0, 0, 0, 0, 0, 22, 163
"/opt/projects/swiftkube/vendor/k8s.io/kubernetes/pkg/volume/azure_file/doc.go", "Go", 15, 0, 0, 0, 0, 0, 5, 20
"/opt/projects/swiftkube/vendor/k8s.io/kubernetes/pkg/volume/cephfs/cephfs.go", "Go", 391, 0, 0, 0, 0, 0, 69, 460
"/opt/projects/swiftkube/vendor/k8s.io/kubernetes/pkg/volume/cephfs/doc.go", "Go", 15, 0, 0, 0, 0, 0, 5, 20
"/opt/projects/swiftkube/vendor/k8s.io/kubernetes/pkg/volume/configmap/configmap.go", "Go", 292, 0, 0, 0, 0, 0, 58, 350
"/opt/projects/swiftkube/vendor/k8s.io/kubernetes/pkg/volume/configmap/doc.go", "Go", 14, 0, 0, 0, 0, 0, 5, 19
"/opt/projects/swiftkube/vendor/k8s.io/kubernetes/pkg/volume/csi/csi_attacher.go", "Go", 613, 0, 0, 0, 0, 0, 109, 722
"/opt/projects/swiftkube/vendor/k8s.io/kubernetes/pkg/volume/csi/csi_block.go", "Go", 445, 0, 0, 0, 0, 0, 75, 520
"/opt/projects/swiftkube/vendor/k8s.io/kubernetes/pkg/volume/csi/csi_client.go", "Go", 643, 0, 0, 0, 0, 0, 87, 730
"/opt/projects/swiftkube/vendor/k8s.io/kubernetes/pkg/volume/csi/csi_drivers_store.go", "Go", 61, 0, 0, 0, 0, 0, 19, 80
"/opt/projects/swiftkube/vendor/k8s.io/kubernetes/pkg/volume/csi/csi_metrics.go", "Go", 115, 0, 0, 0, 0, 0, 21, 136
"/opt/projects/swiftkube/vendor/k8s.io/kubernetes/pkg/volume/csi/csi_mounter.go", "Go", 531, 0, 0, 0, 0, 0, 81, 612
"/opt/projects/swiftkube/vendor/k8s.io/kubernetes/pkg/volume/csi/csi_plugin.go", "Go", 790, 0, 0, 0, 0, 0, 133, 923
"/opt/projects/swiftkube/vendor/k8s.io/kubernetes/pkg/volume/csi/csi_util.go", "Go", 187, 0, 0, 0, 0, 0, 30, 217
"/opt/projects/swiftkube/vendor/k8s.io/kubernetes/pkg/volume/csi/expander.go", "Go", 117, 0, 0, 0, 0, 0, 22, 139
"/opt/projects/swiftkube/vendor/k8s.io/kubernetes/pkg/volume/csi/nodeinfomanager/nodeinfomanager.go", "Go", 563, 0, 0, 0, 0, 0, 105, 668
"/opt/projects/swiftkube/vendor/k8s.io/kubernetes/pkg/volume/csimigration/plugin_manager.go", "Go", 151, 0, 0, 0, 0, 0, 19, 170
"/opt/projects/swiftkube/vendor/k8s.io/kubernetes/pkg/volume/doc.go", "Go", 15, 0, 0, 0, 0, 0, 5, 20
"/opt/projects/swiftkube/vendor/k8s.io/kubernetes/pkg/volume/downwardapi/downwardapi.go", "Go", 266, 0, 0, 0, 0, 0, 49, 315
"/opt/projects/swiftkube/vendor/k8s.io/kubernetes/pkg/volume/emptydir/doc.go", "Go", 15, 0, 0, 0, 0, 0, 5, 20
"/opt/projects/swiftkube/vendor/k8s.io/kubernetes/pkg/volume/emptydir/empty_dir.go", "Go", 489, 0, 0, 0, 0, 0, 73, 562
"/opt/projects/swiftkube/vendor/k8s.io/kubernetes/pkg/volume/emptydir/empty_dir_linux.go", "Go", 101, 0, 0, 0, 0, 0, 16, 117
"/opt/projects/swiftkube/vendor/k8s.io/kubernetes/pkg/volume/emptydir/empty_dir_unsupported.go", "Go", 27, 0, 0, 0, 0, 0, 10, 37
"/opt/projects/swiftkube/vendor/k8s.io/kubernetes/pkg/volume/fc/attacher.go", "Go", 225, 0, 0, 0, 0, 0, 39, 264
"/opt/projects/swiftkube/vendor/k8s.io/kubernetes/pkg/volume/fc/disk_manager.go", "Go", 85, 0, 0, 0, 0, 0, 14, 99
"/opt/projects/swiftkube/vendor/k8s.io/kubernetes/pkg/volume/fc/doc.go", "Go", 15, 0, 0, 0, 0, 0, 5, 20
"/opt/projects/swiftkube/vendor/k8s.io/kubernetes/pkg/volume/fc/fc.go", "Go", 457, 0, 0, 0, 0, 0, 72, 529
"/opt/projects/swiftkube/vendor/k8s.io/kubernetes/pkg/volume/fc/fc_util.go", "Go", 379, 0, 0, 0, 0, 0, 41, 420
"/opt/projects/swiftkube/vendor/k8s.io/kubernetes/pkg/volume/flexvolume/attacher-defaults.go", "Go", 55, 0, 0, 0, 0, 0, 19, 74
"/opt/projects/swiftkube/vendor/k8s.io/kubernetes/pkg/volume/flexvolume/attacher.go", "Go", 101, 0, 0, 0, 0, 0, 22, 123
"/opt/projects/swiftkube/vendor/k8s.io/kubernetes/pkg/volume/flexvolume/detacher-defaults.go", "Go", 35, 0, 0, 0, 0, 0, 12, 47
"/opt/projects/swiftkube/vendor/k8s.io/kubernetes/pkg/volume/flexvolume/detacher.go", "Go", 76, 0, 0, 0, 0, 0, 20, 96
"/opt/projects/swiftkube/vendor/k8s.io/kubernetes/pkg/volume/flexvolume/driver-call.go", "Go", 225, 0, 0, 0, 0, 0, 50, 275
"/opt/projects/swiftkube/vendor/k8s.io/kubernetes/pkg/volume/flexvolume/expander-defaults.go", "Go", 48, 0, 0, 0, 0, 0, 12, 60
"/opt/projects/swiftkube/vendor/k8s.io/kubernetes/pkg/volume/flexvolume/expander.go", "Go", 58, 0, 0, 0, 0, 0, 14, 72
"/opt/projects/swiftkube/vendor/k8s.io/kubernetes/pkg/volume/flexvolume/fake_watcher.go", "Go", 41, 0, 0, 0, 0, 0, 13, 54
"/opt/projects/swiftkube/vendor/k8s.io/kubernetes/pkg/volume/flexvolume/mounter-defaults.go", "Go", 40, 0, 0, 0, 0, 0, 13, 53
"/opt/projects/swiftkube/vendor/k8s.io/kubernetes/pkg/volume/flexvolume/mounter.go", "Go", 86, 0, 0, 0, 0, 0, 24, 110
"/opt/projects/swiftkube/vendor/k8s.io/kubernetes/pkg/volume/flexvolume/plugin-defaults.go", "Go", 25, 0, 0, 0, 0, 0, 10, 35
"/opt/projects/swiftkube/vendor/k8s.io/kubernetes/pkg/volume/flexvolume/plugin.go", "Go", 271, 0, 0, 0, 0, 0, 55, 326
"/opt/projects/swiftkube/vendor/k8s.io/kubernetes/pkg/volume/flexvolume/probe.go", "Go", 248, 0, 0, 0, 0, 0, 36, 284
"/opt/projects/swiftkube/vendor/k8s.io/kubernetes/pkg/volume/flexvolume/unmounter-defaults.go", "Go", 22, 0, 0, 0, 0, 0, 8, 30
"/opt/projects/swiftkube/vendor/k8s.io/kubernetes/pkg/volume/flexvolume/unmounter.go", "Go", 61, 0, 0, 0, 0, 0, 14, 75
"/opt/projects/swiftkube/vendor/k8s.io/kubernetes/pkg/volume/flexvolume/util.go", "Go", 135, 0, 0, 0, 0, 0, 24, 159
"/opt/projects/swiftkube/vendor/k8s.io/kubernetes/pkg/volume/flexvolume/volume.go", "Go", 47, 0, 0, 0, 0, 0, 10, 57
"/opt/projects/swiftkube/vendor/k8s.io/kubernetes/pkg/volume/git_repo/doc.go", "Go", 14, 0, 0, 0, 0, 0, 5, 19
"/opt/projects/swiftkube/vendor/k8s.io/kubernetes/pkg/volume/git_repo/git_repo.go", "Go", 247, 0, 0, 0, 0, 0, 55, 302
"/opt/projects/swiftkube/vendor/k8s.io/kubernetes/pkg/volume/hostpath/doc.go", "Go", 15, 0, 0, 0, 0, 0, 5, 20
"/opt/projects/swiftkube/vendor/k8s.io/kubernetes/pkg/volume/hostpath/host_path.go", "Go", 457, 0, 0, 0, 0, 0, 74, 531
"/opt/projects/swiftkube/vendor/k8s.io/kubernetes/pkg/volume/iscsi/attacher.go", "Go", 206, 0, 0, 0, 0, 0, 36, 242
"/opt/projects/swiftkube/vendor/k8s.io/kubernetes/pkg/volume/iscsi/disk_manager.go", "Go", 91, 0, 0, 0, 0, 0, 13, 104
"/opt/projects/swiftkube/vendor/k8s.io/kubernetes/pkg/volume/iscsi/doc.go", "Go", 15, 0, 0, 0, 0, 0, 5, 20
"/opt/projects/swiftkube/vendor/k8s.io/kubernetes/pkg/volume/iscsi/iscsi.go", "Go", 629, 0, 0, 0, 0, 0, 87, 716
"/opt/projects/swiftkube/vendor/k8s.io/kubernetes/pkg/volume/iscsi/iscsi_util.go", "Go", 878, 0, 0, 0, 0, 0, 109, 987
"/opt/projects/swiftkube/vendor/k8s.io/kubernetes/pkg/volume/local/doc.go", "Go", 14, 0, 0, 0, 0, 0, 5, 19
"/opt/projects/swiftkube/vendor/k8s.io/kubernetes/pkg/volume/local/local.go", "Go", 608, 0, 0, 0, 0, 0, 98, 706
"/opt/projects/swiftkube/vendor/k8s.io/kubernetes/pkg/volume/metrics_block.go", "Go", 74, 0, 0, 0, 0, 0, 19, 93
"/opt/projects/swiftkube/vendor/k8s.io/kubernetes/pkg/volume/metrics_cached.go", "Go", 63, 0, 0, 0, 0, 0, 12, 75
"/opt/projects/swiftkube/vendor/k8s.io/kubernetes/pkg/volume/metrics_du.go", "Go", 71, 0, 0, 0, 0, 0, 15, 86
"/opt/projects/swiftkube/vendor/k8s.io/kubernetes/pkg/volume/metrics_errors.go", "Go", 79, 0, 0, 0, 0, 0, 16, 95
"/opt/projects/swiftkube/vendor/k8s.io/kubernetes/pkg/volume/metrics_nil.go", "Go", 27, 0, 0, 0, 0, 0, 9, 36
"/opt/projects/swiftkube/vendor/k8s.io/kubernetes/pkg/volume/metrics_statfs.go", "Go", 61, 0, 0, 0, 0, 0, 15, 76
"/opt/projects/swiftkube/vendor/k8s.io/kubernetes/pkg/volume/nfs/doc.go", "Go", 15, 0, 0, 0, 0, 0, 5, 20
"/opt/projects/swiftkube/vendor/k8s.io/kubernetes/pkg/volume/nfs/nfs.go", "Go", 271, 0, 0, 0, 0, 0, 45, 316
"/opt/projects/swiftkube/vendor/k8s.io/kubernetes/pkg/volume/noop_expandable_plugin.go", "Go", 61, 0, 0, 0, 0, 0, 21, 82
"/opt/projects/swiftkube/vendor/k8s.io/kubernetes/pkg/volume/plugins.go", "Go", 952, 0, 0, 0, 0, 0, 140, 1092
"/opt/projects/swiftkube/vendor/k8s.io/kubernetes/pkg/volume/portworx/doc.go", "Go", 15, 0, 0, 0, 0, 0, 5, 20
"/opt/projects/swiftkube/vendor/k8s.io/kubernetes/pkg/volume/portworx/portworx.go", "Go", 373, 0, 0, 0, 0, 0, 76, 449
"/opt/projects/swiftkube/vendor/k8s.io/kubernetes/pkg/volume/portworx/portworx_util.go", "Go", 328, 0, 0, 0, 0, 0, 60, 388
"/opt/projects/swiftkube/vendor/k8s.io/kubernetes/pkg/volume/projected/projected.go", "Go", 336, 0, 0, 0, 0, 0, 57, 393
"/opt/projects/swiftkube/vendor/k8s.io/kubernetes/pkg/volume/rbd/attacher.go", "Go", 237, 0, 0, 0, 0, 0, 33, 270
"/opt/projects/swiftkube/vendor/k8s.io/kubernetes/pkg/volume/rbd/disk_manager.go", "Go", 118, 0, 0, 0, 0, 0, 18, 136
"/opt/projects/swiftkube/vendor/k8s.io/kubernetes/pkg/volume/rbd/doc.go", "Go", 15, 0, 0, 0, 0, 0, 5, 20
"/opt/projects/swiftkube/vendor/k8s.io/kubernetes/pkg/volume/rbd/rbd.go", "Go", 1026, 0, 0, 0, 0, 0, 138, 1164
"/opt/projects/swiftkube/vendor/k8s.io/kubernetes/pkg/volume/rbd/rbd_util.go", "Go", 721, 0, 0, 0, 0, 0, 92, 813
"/opt/projects/swiftkube/vendor/k8s.io/kubernetes/pkg/volume/secret/doc.go", "Go", 14, 0, 0, 0, 0, 0, 5, 19
"/opt/projects/swiftkube/vendor/k8s.io/kubernetes/pkg/volume/secret/secret.go", "Go", 279, 0, 0, 0, 0, 0, 57, 336
"/opt/projects/swiftkube/vendor/k8s.io/kubernetes/pkg/volume/util/atomic_writer.go", "Go", 430, 0, 0, 0, 0, 0, 58, 488
"/opt/projects/swiftkube/vendor/k8s.io/kubernetes/pkg/volume/util/attach_limit.go", "Go", 59, 0, 0, 0, 0, 0, 12, 71
"/opt/projects/swiftkube/vendor/k8s.io/kubernetes/pkg/volume/util/device_util.go", "Go", 27, 0, 0, 0, 0, 0, 8, 35
"/opt/projects/swiftkube/vendor/k8s.io/kubernetes/pkg/volume/util/device_util_linux.go", "Go", 266, 0, 0, 0, 0, 0, 36, 302
"/opt/projects/swiftkube/vendor/k8s.io/kubernetes/pkg/volume/util/device_util_unsupported.go", "Go", 34, 0, 0, 0, 0, 0, 10, 44
"/opt/projects/swiftkube/vendor/k8s.io/kubernetes/pkg/volume/util/doc.go", "Go", 14, 0, 0, 0, 0, 0, 5, 19
"/opt/projects/swiftkube/vendor/k8s.io/kubernetes/pkg/volume/util/finalizer.go", "Go", 19, 0, 0, 0, 0, 0, 7, 26
"/opt/projects/swiftkube/vendor/k8s.io/kubernetes/pkg/volume/util/fs/fs.go", "Go", 117, 0, 0, 0, 0, 0, 32, 149
"/opt/projects/swiftkube/vendor/k8s.io/kubernetes/pkg/volume/util/fs/fs_unsupported.go", "Go", 31, 0, 0, 0, 0, 0, 10, 41
"/opt/projects/swiftkube/vendor/k8s.io/kubernetes/pkg/volume/util/fs/fs_windows.go", "Go", 96, 0, 0, 0, 0, 0, 22, 118
"/opt/projects/swiftkube/vendor/k8s.io/kubernetes/pkg/volume/util/fsquota/common/quota_common.go", "Go", 22, 0, 0, 0, 0, 0, 7, 29
"/opt/projects/swiftkube/vendor/k8s.io/kubernetes/pkg/volume/util/fsquota/common/quota_common_linux.go", "Go", 73, 0, 0, 0, 0, 0, 18, 91
"/opt/projects/swiftkube/vendor/k8s.io/kubernetes/pkg/volume/util/fsquota/common/quota_common_linux_impl.go", "Go", 254, 0, 0, 0, 0, 0, 33, 287
"/opt/projects/swiftkube/vendor/k8s.io/kubernetes/pkg/volume/util/fsquota/project.go", "Go", 332, 0, 0, 0, 0, 0, 30, 362
"/opt/projects/swiftkube/vendor/k8s.io/kubernetes/pkg/volume/util/fsquota/quota.go", "Go", 43, 0, 0, 0, 0, 0, 13, 56
"/opt/projects/swiftkube/vendor/k8s.io/kubernetes/pkg/volume/util/fsquota/quota_linux.go", "Go", 426, 0, 0, 0, 0, 0, 45, 471
"/opt/projects/swiftkube/vendor/k8s.io/kubernetes/pkg/volume/util/fsquota/quota_unsupported.go", "Go", 48, 0, 0, 0, 0, 0, 17, 65
"/opt/projects/swiftkube/vendor/k8s.io/kubernetes/pkg/volume/util/hostutil/fake_hostutil.go", "Go", 103, 0, 0, 0, 0, 0, 23, 126
"/opt/projects/swiftkube/vendor/k8s.io/kubernetes/pkg/volume/util/hostutil/hostutil.go", "Go", 98, 0, 0, 0, 0, 0, 15, 113
"/opt/projects/swiftkube/vendor/k8s.io/kubernetes/pkg/volume/util/hostutil/hostutil_linux.go", "Go", 290, 0, 0, 0, 0, 0, 44, 334
"/opt/projects/swiftkube/vendor/k8s.io/kubernetes/pkg/volume/util/hostutil/hostutil_unsupported.go", "Go", 85, 0, 0, 0, 0, 0, 25, 110
"/opt/projects/swiftkube/vendor/k8s.io/kubernetes/pkg/volume/util/hostutil/hostutil_windows.go", "Go", 109, 0, 0, 0, 0, 0, 23, 132
"/opt/projects/swiftkube/vendor/k8s.io/kubernetes/pkg/volume/util/io_util.go", "Go", 42, 0, 0, 0, 0, 0, 10, 52
"/opt/projects/swiftkube/vendor/k8s.io/kubernetes/pkg/volume/util/metrics.go", "Go", 140, 0, 0, 0, 0, 0, 22, 162
"/opt/projects/swiftkube/vendor/k8s.io/kubernetes/pkg/volume/util/nested_volumes.go", "Go", 103, 0, 0, 0, 0, 0, 12, 115
"/opt/projects/swiftkube/vendor/k8s.io/kubernetes/pkg/volume/util/nestedpendingoperations/nestedpendingoperations.go", "Go", 335, 0, 0, 0, 0, 0, 63, 398
"/opt/projects/swiftkube/vendor/k8s.io/kubernetes/pkg/volume/util/operationexecutor/fakegenerator.go", "Go", 100, 0, 0, 0, 0, 0, 27, 127
"/opt/projects/swiftkube/vendor/k8s.io/kubernetes/pkg/volume/util/operationexecutor/node_expander.go", "Go", 134, 0, 0, 0, 0, 0, 26, 160
"/opt/projects/swiftkube/vendor/k8s.io/kubernetes/pkg/volume/util/operationexecutor/operation_executor.go", "Go", 930, 0, 0, 0, 0, 0, 161, 1091
"/opt/projects/swiftkube/vendor/k8s.io/kubernetes/pkg/volume/util/operationexecutor/operation_generator.go", "Go", 2018, 0, 0, 0, 0, 0, 303, 2321
"/opt/projects/swiftkube/vendor/k8s.io/kubernetes/pkg/volume/util/recyclerclient/recycler_client.go", "Go", 230, 0, 0, 0, 0, 0, 37, 267
"/opt/projects/swiftkube/vendor/k8s.io/kubernetes/pkg/volume/util/resize_util.go", "Go", 351, 0, 0, 0, 0, 0, 52, 403
"/opt/projects/swiftkube/vendor/k8s.io/kubernetes/pkg/volume/util/selinux.go", "Go", 168, 0, 0, 0, 0, 0, 31, 199
"/opt/projects/swiftkube/vendor/k8s.io/kubernetes/pkg/volume/util/storageclass.go", "Go", 70, 0, 0, 0, 0, 0, 16, 86
"/opt/projects/swiftkube/vendor/k8s.io/kubernetes/pkg/volume/util/subpath/subpath.go", "Go", 73, 0, 0, 0, 0, 0, 20, 93
"/opt/projects/swiftkube/vendor/k8s.io/kubernetes/pkg/volume/util/subpath/subpath_linux.go", "Go", 532, 0, 0, 0, 0, 0, 78, 610
"/opt/projects/swiftkube/vendor/k8s.io/kubernetes/pkg/volume/util/subpath/subpath_unsupported.go", "Go", 41, 0, 0, 0, 0, 0, 15, 56
"/opt/projects/swiftkube/vendor/k8s.io/kubernetes/pkg/volume/util/subpath/subpath_windows.go", "Go", 334, 0, 0, 0, 0, 0, 50, 384
"/opt/projects/swiftkube/vendor/k8s.io/kubernetes/pkg/volume/util/types/types.go", "Go", 140, 0, 0, 0, 0, 0, 29, 169
"/opt/projects/swiftkube/vendor/k8s.io/kubernetes/pkg/volume/util/util.go", "Go", 731, 0, 0, 0, 0, 0, 86, 817
"/opt/projects/swiftkube/vendor/k8s.io/kubernetes/pkg/volume/util/volumepathhandler/volume_path_handler.go", "Go", 261, 0, 0, 0, 0, 0, 35, 296
"/opt/projects/swiftkube/vendor/k8s.io/kubernetes/pkg/volume/util/volumepathhandler/volume_path_handler_linux.go", "Go", 203, 0, 0, 0, 0, 0, 34, 237
"/opt/projects/swiftkube/vendor/k8s.io/kubernetes/pkg/volume/util/volumepathhandler/volume_path_handler_unsupported.go", "Go", 38, 0, 0, 0, 0, 0, 12, 50
"/opt/projects/swiftkube/vendor/k8s.io/kubernetes/pkg/volume/validation/pv_validation.go", "Go", 61, 0, 0, 0, 0, 0, 11, 72
"/opt/projects/swiftkube/vendor/k8s.io/kubernetes/pkg/volume/volume.go", "Go", 264, 0, 0, 0, 0, 0, 47, 311
"/opt/projects/swiftkube/vendor/k8s.io/kubernetes/pkg/volume/volume_linux.go", "Go", 182, 0, 0, 0, 0, 0, 29, 211
"/opt/projects/swiftkube/vendor/k8s.io/kubernetes/pkg/volume/volume_unsupported.go", "Go", 22, 0, 0, 0, 0, 0, 8, 30
"/opt/projects/swiftkube/vendor/k8s.io/kubernetes/pkg/volume/vsphere_volume/attacher.go", "Go", 275, 0, 0, 0, 0, 0, 53, 328
"/opt/projects/swiftkube/vendor/k8s.io/kubernetes/pkg/volume/vsphere_volume/doc.go", "Go", 13, 0, 0, 0, 0, 0, 5, 18
"/opt/projects/swiftkube/vendor/k8s.io/kubernetes/pkg/volume/vsphere_volume/vsphere_volume.go", "Go", 404, 0, 0, 0, 0, 0, 71, 475
"/opt/projects/swiftkube/vendor/k8s.io/kubernetes/pkg/volume/vsphere_volume/vsphere_volume_block.go", "Go", 144, 0, 0, 0, 0, 0, 26, 170
"/opt/projects/swiftkube/vendor/k8s.io/kubernetes/pkg/volume/vsphere_volume/vsphere_volume_util.go", "Go", 257, 0, 0, 0, 0, 0, 25, 282
"/opt/projects/swiftkube/vendor/k8s.io/kubernetes/pkg/volume/vsphere_volume/vsphere_volume_util_linux.go", "Go", 27, 0, 0, 0, 0, 0, 10, 37
"/opt/projects/swiftkube/vendor/k8s.io/kubernetes/pkg/volume/vsphere_volume/vsphere_volume_util_unsupported.go", "Go", 19, 0, 0, 0, 0, 0, 8, 27
"/opt/projects/swiftkube/vendor/k8s.io/kubernetes/pkg/volume/vsphere_volume/vsphere_volume_util_windows.go", "Go", 57, 0, 0, 0, 0, 0, 12, 69
"/opt/projects/swiftkube/vendor/k8s.io/kubernetes/pkg/windows/service/service.go", "Go", 94, 0, 0, 0, 0, 0, 18, 112
"/opt/projects/swiftkube/vendor/k8s.io/kubernetes/third_party/forked/golang/expansion/expand.go", "Go", 89, 0, 0, 0, 0, 0, 14, 103
"/opt/projects/swiftkube/vendor/k8s.io/legacy-cloud-providers/azure/auth/azure_auth.go", "Go", 255, 0, 0, 0, 0, 0, 36, 291
"/opt/projects/swiftkube/vendor/k8s.io/legacy-cloud-providers/azure/auth/doc.go", "Go", 14, 0, 0, 0, 0, 0, 5, 19
"/opt/projects/swiftkube/vendor/k8s.io/legacy-cloud-providers/azure/azure.go", "Go", 851, 0, 0, 0, 0, 0, 138, 989
"/opt/projects/swiftkube/vendor/k8s.io/legacy-cloud-providers/azure/azure_backoff.go", "Go", 402, 0, 0, 0, 0, 0, 69, 471
"/opt/projects/swiftkube/vendor/k8s.io/legacy-cloud-providers/azure/azure_blobDiskController.go", "Go", 549, 0, 0, 0, 0, 0, 100, 649
"/opt/projects/swiftkube/vendor/k8s.io/legacy-cloud-providers/azure/azure_config.go", "Go", 76, 0, 0, 0, 0, 0, 20, 96
"/opt/projects/swiftkube/vendor/k8s.io/legacy-cloud-providers/azure/azure_controller_common.go", "Go", 398, 0, 0, 0, 0, 0, 63, 461
"/opt/projects/swiftkube/vendor/k8s.io/legacy-cloud-providers/azure/azure_controller_standard.go", "Go", 176, 0, 0, 0, 0, 0, 29, 205
"/opt/projects/swiftkube/vendor/k8s.io/legacy-cloud-providers/azure/azure_controller_vmss.go", "Go", 180, 0, 0, 0, 0, 0, 28, 208
"/opt/projects/swiftkube/vendor/k8s.io/legacy-cloud-providers/azure/azure_fakes.go", "Go", 87, 0, 0, 0, 0, 0, 13, 100
"/opt/projects/swiftkube/vendor/k8s.io/legacy-cloud-providers/azure/azure_file.go", "Go", 32, 0, 0, 0, 0, 0, 11, 43
"/opt/projects/swiftkube/vendor/k8s.io/legacy-cloud-providers/azure/azure_instance_metadata.go", "Go", 225, 0, 0, 0, 0, 0, 46, 271
"/opt/projects/swiftkube/vendor/k8s.io/legacy-cloud-providers/azure/azure_instances.go", "Go", 363, 0, 0, 0, 0, 0, 70, 433
"/opt/projects/swiftkube/vendor/k8s.io/legacy-cloud-providers/azure/azure_loadbalancer.go", "Go", 2443, 0, 0, 0, 0, 0, 327, 2770
"/opt/projects/swiftkube/vendor/k8s.io/legacy-cloud-providers/azure/azure_managedDiskController.go", "Go", 337, 0, 0, 0, 0, 0, 63, 400
"/opt/projects/swiftkube/vendor/k8s.io/legacy-cloud-providers/azure/azure_ratelimit.go", "Go", 95, 0, 0, 0, 0, 0, 16, 111
"/opt/projects/swiftkube/vendor/k8s.io/legacy-cloud-providers/azure/azure_routes.go", "Go", 504, 0, 0, 0, 0, 0, 76, 580
"/opt/projects/swiftkube/vendor/k8s.io/legacy-cloud-providers/azure/azure_standard.go", "Go", 993, 0, 0, 0, 0, 0, 140, 1133
"/opt/projects/swiftkube/vendor/k8s.io/legacy-cloud-providers/azure/azure_storage.go", "Go", 70, 0, 0, 0, 0, 0, 17, 87
"/opt/projects/swiftkube/vendor/k8s.io/legacy-cloud-providers/azure/azure_storageaccount.go", "Go", 182, 0, 0, 0, 0, 0, 33, 215
"/opt/projects/swiftkube/vendor/k8s.io/legacy-cloud-providers/azure/azure_utils.go", "Go", 139, 0, 0, 0, 0, 0, 27, 166
"/opt/projects/swiftkube/vendor/k8s.io/legacy-cloud-providers/azure/azure_vmsets.go", "Go", 72, 0, 0, 0, 0, 0, 17, 89
"/opt/projects/swiftkube/vendor/k8s.io/legacy-cloud-providers/azure/azure_vmss.go", "Go", 1475, 0, 0, 0, 0, 0, 234, 1709
"/opt/projects/swiftkube/vendor/k8s.io/legacy-cloud-providers/azure/azure_vmss_cache.go", "Go", 293, 0, 0, 0, 0, 0, 58, 351
"/opt/projects/swiftkube/vendor/k8s.io/legacy-cloud-providers/azure/azure_wrap.go", "Go", 289, 0, 0, 0, 0, 0, 68, 357
"/opt/projects/swiftkube/vendor/k8s.io/legacy-cloud-providers/azure/azure_zones.go", "Go", 110, 0, 0, 0, 0, 0, 22, 132
"/opt/projects/swiftkube/vendor/k8s.io/legacy-cloud-providers/azure/cache/azure_cache.go", "Go", 151, 0, 0, 0, 0, 0, 28, 179
"/opt/projects/swiftkube/vendor/k8s.io/legacy-cloud-providers/azure/cache/doc.go", "Go", 16, 0, 0, 0, 0, 0, 6, 22
"/opt/projects/swiftkube/vendor/k8s.io/legacy-cloud-providers/azure/clients/armclient/azure_armclient.go", "Go", 600, 0, 0, 0, 0, 0, 102, 702
"/opt/projects/swiftkube/vendor/k8s.io/legacy-cloud-providers/azure/clients/armclient/doc.go", "Go", 16, 0, 0, 0, 0, 0, 6, 22
"/opt/projects/swiftkube/vendor/k8s.io/legacy-cloud-providers/azure/clients/armclient/interface.go", "Go", 75, 0, 0, 0, 0, 0, 30, 105
"/opt/projects/swiftkube/vendor/k8s.io/legacy-cloud-providers/azure/clients/azure_client_config.go", "Go", 68, 0, 0, 0, 0, 0, 15, 83
"/opt/projects/swiftkube/vendor/k8s.io/legacy-cloud-providers/azure/clients/containerserviceclient/azure_containerserviceclient.go", "Go", 348, 0, 0, 0, 0, 0, 72, 420
"/opt/projects/swiftkube/vendor/k8s.io/legacy-cloud-providers/azure/clients/containerserviceclient/doc.go", "Go", 16, 0, 0, 0, 0, 0, 6, 22
"/opt/projects/swiftkube/vendor/k8s.io/legacy-cloud-providers/azure/clients/containerserviceclient/interface.go", "Go", 32, 0, 0, 0, 0, 0, 11, 43
"/opt/projects/swiftkube/vendor/k8s.io/legacy-cloud-providers/azure/clients/deploymentclient/azure_deploymentclient.go", "Go", 382, 0, 0, 0, 0, 0, 78, 460
"/opt/projects/swiftkube/vendor/k8s.io/legacy-cloud-providers/azure/clients/deploymentclient/doc.go", "Go", 16, 0, 0, 0, 0, 0, 6, 22
"/opt/projects/swiftkube/vendor/k8s.io/legacy-cloud-providers/azure/clients/deploymentclient/interface.go", "Go", 33, 0, 0, 0, 0, 0, 10, 43
"/opt/projects/swiftkube/vendor/k8s.io/legacy-cloud-providers/azure/clients/diskclient/azure_diskclient.go", "Go", 378, 0, 0, 0, 0, 0, 76, 454
"/opt/projects/swiftkube/vendor/k8s.io/legacy-cloud-providers/azure/clients/diskclient/doc.go", "Go", 16, 0, 0, 0, 0, 0, 6, 22
"/opt/projects/swiftkube/vendor/k8s.io/legacy-cloud-providers/azure/clients/diskclient/interface.go", "Go", 42, 0, 0, 0, 0, 0, 14, 56
"/opt/projects/swiftkube/vendor/k8s.io/legacy-cloud-providers/azure/clients/diskclient/mockdiskclient/doc.go", "Go", 16, 0, 0, 0, 0, 0, 6, 22
"/opt/projects/swiftkube/vendor/k8s.io/legacy-cloud-providers/azure/clients/diskclient/mockdiskclient/interface.go", "Go", 106, 0, 0, 0, 0, 0, 23, 129
"/opt/projects/swiftkube/vendor/k8s.io/legacy-cloud-providers/azure/clients/doc.go", "Go", 16, 0, 0, 0, 0, 0, 6, 22
"/opt/projects/swiftkube/vendor/k8s.io/legacy-cloud-providers/azure/clients/fileclient/azure_fileclient.go", "Go", 97, 0, 0, 0, 0, 0, 25, 122
"/opt/projects/swiftkube/vendor/k8s.io/legacy-cloud-providers/azure/clients/fileclient/doc.go", "Go", 16, 0, 0, 0, 0, 0, 6, 22
"/opt/projects/swiftkube/vendor/k8s.io/legacy-cloud-providers/azure/clients/fileclient/interface.go", "Go", 26, 0, 0, 0, 0, 0, 8, 34
"/opt/projects/swiftkube/vendor/k8s.io/legacy-cloud-providers/azure/clients/interfaceclient/azure_interfaceclient.go", "Go", 266, 0, 0, 0, 0, 0, 55, 321
"/opt/projects/swiftkube/vendor/k8s.io/legacy-cloud-providers/azure/clients/interfaceclient/doc.go", "Go", 16, 0, 0, 0, 0, 0, 6, 22
"/opt/projects/swiftkube/vendor/k8s.io/legacy-cloud-providers/azure/clients/interfaceclient/interface.go", "Go", 38, 0, 0, 0, 0, 0, 14, 52
"/opt/projects/swiftkube/vendor/k8s.io/legacy-cloud-providers/azure/clients/interfaceclient/mockinterfaceclient/doc.go", "Go", 16, 0, 0, 0, 0, 0, 6, 22
"/opt/projects/swiftkube/vendor/k8s.io/legacy-cloud-providers/azure/clients/interfaceclient/mockinterfaceclient/interface.go", "Go", 94, 0, 0, 0, 0, 0, 21, 115
"/opt/projects/swiftkube/vendor/k8s.io/legacy-cloud-providers/azure/clients/loadbalancerclient/azure_loadbalancerclient.go", "Go", 348, 0, 0, 0, 0, 0, 72, 420
"/opt/projects/swiftkube/vendor/k8s.io/legacy-cloud-providers/azure/clients/loadbalancerclient/doc.go", "Go", 16, 0, 0, 0, 0, 0, 6, 22
"/opt/projects/swiftkube/vendor/k8s.io/legacy-cloud-providers/azure/clients/loadbalancerclient/interface.go", "Go", 36, 0, 0, 0, 0, 0, 13, 49
"/opt/projects/swiftkube/vendor/k8s.io/legacy-cloud-providers/azure/clients/loadbalancerclient/mockloadbalancerclient/doc.go", "Go", 16, 0, 0, 0, 0, 0, 6, 22
"/opt/projects/swiftkube/vendor/k8s.io/legacy-cloud-providers/azure/clients/loadbalancerclient/mockloadbalancerclient/interface.go", "Go", 94, 0, 0, 0, 0, 0, 21, 115
"/opt/projects/swiftkube/vendor/k8s.io/legacy-cloud-providers/azure/clients/publicipclient/azure_publicipclient.go", "Go", 404, 0, 0, 0, 0, 0, 82, 486
"/opt/projects/swiftkube/vendor/k8s.io/legacy-cloud-providers/azure/clients/publicipclient/doc.go", "Go", 16, 0, 0, 0, 0, 0, 6, 22
"/opt/projects/swiftkube/vendor/k8s.io/legacy-cloud-providers/azure/clients/publicipclient/interface.go", "Go", 40, 0, 0, 0, 0, 0, 15, 55
"/opt/projects/swiftkube/vendor/k8s.io/legacy-cloud-providers/azure/clients/publicipclient/mockpublicipclient/doc.go", "Go", 16, 0, 0, 0, 0, 0, 6, 22
"/opt/projects/swiftkube/vendor/k8s.io/legacy-cloud-providers/azure/clients/publicipclient/mockpublicipclient/interface.go", "Go", 107, 0, 0, 0, 0, 0, 23, 130
"/opt/projects/swiftkube/vendor/k8s.io/legacy-cloud-providers/azure/clients/routeclient/azure_routeclient.go", "Go", 164, 0, 0, 0, 0, 0, 36, 200
"/opt/projects/swiftkube/vendor/k8s.io/legacy-cloud-providers/azure/clients/routeclient/doc.go", "Go", 16, 0, 0, 0, 0, 0, 6, 22
"/opt/projects/swiftkube/vendor/k8s.io/legacy-cloud-providers/azure/clients/routeclient/interface.go", "Go", 32, 0, 0, 0, 0, 0, 11, 43
"/opt/projects/swiftkube/vendor/k8s.io/legacy-cloud-providers/azure/clients/routeclient/mockrouteclient/doc.go", "Go", 16, 0, 0, 0, 0, 0, 6, 22
"/opt/projects/swiftkube/vendor/k8s.io/legacy-cloud-providers/azure/clients/routeclient/mockrouteclient/interface.go", "Go", 68, 0, 0, 0, 0, 0, 17, 85
"/opt/projects/swiftkube/vendor/k8s.io/legacy-cloud-providers/azure/clients/routetableclient/azure_routetableclient.go", "Go", 176, 0, 0, 0, 0, 0, 38, 214
"/opt/projects/swiftkube/vendor/k8s.io/legacy-cloud-providers/azure/clients/routetableclient/doc.go", "Go", 16, 0, 0, 0, 0, 0, 6, 22
"/opt/projects/swiftkube/vendor/k8s.io/legacy-cloud-providers/azure/clients/routetableclient/interface.go", "Go", 32, 0, 0, 0, 0, 0, 11, 43
"/opt/projects/swiftkube/vendor/k8s.io/legacy-cloud-providers/azure/clients/routetableclient/mockroutetableclient/doc.go", "Go", 16, 0, 0, 0, 0, 0, 6, 22
"/opt/projects/swiftkube/vendor/k8s.io/legacy-cloud-providers/azure/clients/routetableclient/mockroutetableclient/interface.go", "Go", 69, 0, 0, 0, 0, 0, 17, 86
"/opt/projects/swiftkube/vendor/k8s.io/legacy-cloud-providers/azure/clients/securitygroupclient/azure_securitygroupclient.go", "Go", 348, 0, 0, 0, 0, 0, 72, 420
"/opt/projects/swiftkube/vendor/k8s.io/legacy-cloud-providers/azure/clients/securitygroupclient/doc.go", "Go", 16, 0, 0, 0, 0, 0, 6, 22
"/opt/projects/swiftkube/vendor/k8s.io/legacy-cloud-providers/azure/clients/securitygroupclient/interface.go", "Go", 36, 0, 0, 0, 0, 0, 13, 49
"/opt/projects/swiftkube/vendor/k8s.io/legacy-cloud-providers/azure/clients/securitygroupclient/mocksecuritygroupclient/doc.go", "Go", 16, 0, 0, 0, 0, 0, 6, 22
"/opt/projects/swiftkube/vendor/k8s.io/legacy-cloud-providers/azure/clients/securitygroupclient/mocksecuritygroupclient/interface.go", "Go", 94, 0, 0, 0, 0, 0, 21, 115
"/opt/projects/swiftkube/vendor/k8s.io/legacy-cloud-providers/azure/clients/snapshotclient/azure_snapshotclient.go", "Go", 341, 0, 0, 0, 0, 0, 72, 413
"/opt/projects/swiftkube/vendor/k8s.io/legacy-cloud-providers/azure/clients/snapshotclient/doc.go", "Go", 16, 0, 0, 0, 0, 0, 6, 22
"/opt/projects/swiftkube/vendor/k8s.io/legacy-cloud-providers/azure/clients/snapshotclient/interface.go", "Go", 36, 0, 0, 0, 0, 0, 13, 49
"/opt/projects/swiftkube/vendor/k8s.io/legacy-cloud-providers/azure/clients/storageaccountclient/azure_storageaccountclient.go", "Go", 397, 0, 0, 0, 0, 0, 82, 479
"/opt/projects/swiftkube/vendor/k8s.io/legacy-cloud-providers/azure/clients/storageaccountclient/doc.go", "Go", 16, 0, 0, 0, 0, 0, 6, 22
"/opt/projects/swiftkube/vendor/k8s.io/legacy-cloud-providers/azure/clients/storageaccountclient/interface.go", "Go", 42, 0, 0, 0, 0, 0, 14, 56
"/opt/projects/swiftkube/vendor/k8s.io/legacy-cloud-providers/azure/clients/subnetclient/azure_subnetclient.go", "Go", 347, 0, 0, 0, 0, 0, 73, 420
"/opt/projects/swiftkube/vendor/k8s.io/legacy-cloud-providers/azure/clients/subnetclient/doc.go", "Go", 16, 0, 0, 0, 0, 0, 6, 22
"/opt/projects/swiftkube/vendor/k8s.io/legacy-cloud-providers/azure/clients/subnetclient/interface.go", "Go", 36, 0, 0, 0, 0, 0, 13, 49
"/opt/projects/swiftkube/vendor/k8s.io/legacy-cloud-providers/azure/clients/subnetclient/mocksubnetclient/doc.go", "Go", 16, 0, 0, 0, 0, 0, 6, 22
"/opt/projects/swiftkube/vendor/k8s.io/legacy-cloud-providers/azure/clients/subnetclient/mocksubnetclient/interface.go", "Go", 94, 0, 0, 0, 0, 0, 21, 115
"/opt/projects/swiftkube/vendor/k8s.io/legacy-cloud-providers/azure/clients/vmclient/azure_vmclient.go", "Go", 403, 0, 0, 0, 0, 0, 84, 487
"/opt/projects/swiftkube/vendor/k8s.io/legacy-cloud-providers/azure/clients/vmclient/doc.go", "Go", 16, 0, 0, 0, 0, 0, 6, 22
"/opt/projects/swiftkube/vendor/k8s.io/legacy-cloud-providers/azure/clients/vmclient/interface.go", "Go", 38, 0, 0, 0, 0, 0, 14, 52
"/opt/projects/swiftkube/vendor/k8s.io/legacy-cloud-providers/azure/clients/vmclient/mockvmclient/doc.go", "Go", 16, 0, 0, 0, 0, 0, 6, 22
"/opt/projects/swiftkube/vendor/k8s.io/legacy-cloud-providers/azure/clients/vmclient/mockvmclient/interface.go", "Go", 106, 0, 0, 0, 0, 0, 23, 129
"/opt/projects/swiftkube/vendor/k8s.io/legacy-cloud-providers/azure/clients/vmsizeclient/azure_vmsizeclient.go", "Go", 111, 0, 0, 0, 0, 0, 27, 138
"/opt/projects/swiftkube/vendor/k8s.io/legacy-cloud-providers/azure/clients/vmsizeclient/doc.go", "Go", 16, 0, 0, 0, 0, 0, 6, 22
"/opt/projects/swiftkube/vendor/k8s.io/legacy-cloud-providers/azure/clients/vmsizeclient/interface.go", "Go", 30, 0, 0, 0, 0, 0, 10, 40
"/opt/projects/swiftkube/vendor/k8s.io/legacy-cloud-providers/azure/clients/vmssclient/azure_vmssclient.go", "Go", 541, 0, 0, 0, 0, 0, 113, 654
"/opt/projects/swiftkube/vendor/k8s.io/legacy-cloud-providers/azure/clients/vmssclient/doc.go", "Go", 16, 0, 0, 0, 0, 0, 6, 22
"/opt/projects/swiftkube/vendor/k8s.io/legacy-cloud-providers/azure/clients/vmssclient/interface.go", "Go", 56, 0, 0, 0, 0, 0, 23, 79
"/opt/projects/swiftkube/vendor/k8s.io/legacy-cloud-providers/azure/clients/vmssclient/mockvmssclient/doc.go", "Go", 16, 0, 0, 0, 0, 0, 6, 22
"/opt/projects/swiftkube/vendor/k8s.io/legacy-cloud-providers/azure/clients/vmssclient/mockvmssclient/interface.go", "Go", 213, 0, 0, 0, 0, 0, 39, 252
"/opt/projects/swiftkube/vendor/k8s.io/legacy-cloud-providers/azure/clients/vmssvmclient/azure_vmssvmclient.go", "Go", 387, 0, 0, 0, 0, 0, 77, 464
"/opt/projects/swiftkube/vendor/k8s.io/legacy-cloud-providers/azure/clients/vmssvmclient/doc.go", "Go", 16, 0, 0, 0, 0, 0, 6, 22
"/opt/projects/swiftkube/vendor/k8s.io/legacy-cloud-providers/azure/clients/vmssvmclient/interface.go", "Go", 36, 0, 0, 0, 0, 0, 13, 49
"/opt/projects/swiftkube/vendor/k8s.io/legacy-cloud-providers/azure/clients/vmssvmclient/mockvmssvmclient/doc.go", "Go", 16, 0, 0, 0, 0, 0, 6, 22
"/opt/projects/swiftkube/vendor/k8s.io/legacy-cloud-providers/azure/clients/vmssvmclient/mockvmssvmclient/interface.go", "Go", 94, 0, 0, 0, 0, 0, 21, 115
"/opt/projects/swiftkube/vendor/k8s.io/legacy-cloud-providers/azure/doc.go", "Go", 17, 0, 0, 0, 0, 0, 6, 23
"/opt/projects/swiftkube/vendor/k8s.io/legacy-cloud-providers/azure/metrics/azure_metrics.go", "Go", 163, 0, 0, 0, 0, 0, 27, 190
"/opt/projects/swiftkube/vendor/k8s.io/legacy-cloud-providers/azure/metrics/doc.go", "Go", 16, 0, 0, 0, 0, 0, 6, 22
"/opt/projects/swiftkube/vendor/k8s.io/legacy-cloud-providers/azure/retry/azure_error.go", "Go", 261, 0, 0, 0, 0, 0, 55, 316
"/opt/projects/swiftkube/vendor/k8s.io/legacy-cloud-providers/azure/retry/azure_retry.go", "Go", 175, 0, 0, 0, 0, 0, 27, 202
"/opt/projects/swiftkube/vendor/k8s.io/legacy-cloud-providers/azure/retry/doc.go", "Go", 17, 0, 0, 0, 0, 0, 6, 23
"/opt/projects/swiftkube/vendor/k8s.io/legacy-cloud-providers/gce/doc.go", "Go", 15, 0, 0, 0, 0, 0, 5, 20
"/opt/projects/swiftkube/vendor/k8s.io/legacy-cloud-providers/gce/gce.go", "Go", 843, 0, 0, 0, 0, 0, 120, 963
"/opt/projects/swiftkube/vendor/k8s.io/legacy-cloud-providers/gce/gce_address_manager.go", "Go", 171, 0, 0, 0, 0, 0, 32, 203
"/opt/projects/swiftkube/vendor/k8s.io/legacy-cloud-providers/gce/gce_addresses.go", "Go", 154, 0, 0, 0, 0, 0, 39, 193
"/opt/projects/swiftkube/vendor/k8s.io/legacy-cloud-providers/gce/gce_alpha.go", "Go", 42, 0, 0, 0, 0, 0, 11, 53
"/opt/projects/swiftkube/vendor/k8s.io/legacy-cloud-providers/gce/gce_annotations.go", "Go", 132, 0, 0, 0, 0, 0, 33, 165
"/opt/projects/swiftkube/vendor/k8s.io/legacy-cloud-providers/gce/gce_backendservice.go", "Go", 189, 0, 0, 0, 0, 0, 50, 239
"/opt/projects/swiftkube/vendor/k8s.io/legacy-cloud-providers/gce/gce_cert.go", "Go", 58, 0, 0, 0, 0, 0, 17, 75
"/opt/projects/swiftkube/vendor/k8s.io/legacy-cloud-providers/gce/gce_clusterid.go", "Go", 225, 0, 0, 0, 0, 0, 46, 271
"/opt/projects/swiftkube/vendor/k8s.io/legacy-cloud-providers/gce/gce_clusters.go", "Go", 88, 0, 0, 0, 0, 0, 20, 108
"/opt/projects/swiftkube/vendor/k8s.io/legacy-cloud-providers/gce/gce_disks.go", "Go", 898, 0, 0, 0, 0, 0, 157, 1055
"/opt/projects/swiftkube/vendor/k8s.io/legacy-cloud-providers/gce/gce_fake.go", "Go", 79, 0, 0, 0, 0, 0, 13, 92
"/opt/projects/swiftkube/vendor/k8s.io/legacy-cloud-providers/gce/gce_firewall.go", "Go", 59, 0, 0, 0, 0, 0, 19, 78
"/opt/projects/swiftkube/vendor/k8s.io/legacy-cloud-providers/gce/gce_forwardingrule.go", "Go", 155, 0, 0, 0, 0, 0, 39, 194
"/opt/projects/swiftkube/vendor/k8s.io/legacy-cloud-providers/gce/gce_healthchecks.go", "Go", 204, 0, 0, 0, 0, 0, 57, 261
"/opt/projects/swiftkube/vendor/k8s.io/legacy-cloud-providers/gce/gce_instancegroup.go", "Go", 113, 0, 0, 0, 0, 0, 26, 139
"/opt/projects/swiftkube/vendor/k8s.io/legacy-cloud-providers/gce/gce_instances.go", "Go", 701, 0, 0, 0, 0, 0, 110, 811
"/opt/projects/swiftkube/vendor/k8s.io/legacy-cloud-providers/gce/gce_interfaces.go", "Go", 42, 0, 0, 0, 0, 0, 13, 55
"/opt/projects/swiftkube/vendor/k8s.io/legacy-cloud-providers/gce/gce_loadbalancer.go", "Go", 261, 0, 0, 0, 0, 0, 42, 303
"/opt/projects/swiftkube/vendor/k8s.io/legacy-cloud-providers/gce/gce_loadbalancer_external.go", "Go", 1070, 0, 0, 0, 0, 0, 98, 1168
"/opt/projects/swiftkube/vendor/k8s.io/legacy-cloud-providers/gce/gce_loadbalancer_internal.go", "Go", 907, 0, 0, 0, 0, 0, 112, 1019
"/opt/projects/swiftkube/vendor/k8s.io/legacy-cloud-providers/gce/gce_loadbalancer_metrics.go", "Go", 156, 0, 0, 0, 0, 0, 27, 183
"/opt/projects/swiftkube/vendor/k8s.io/legacy-cloud-providers/gce/gce_loadbalancer_naming.go", "Go", 104, 0, 0, 0, 0, 0, 26, 130
"/opt/projects/swiftkube/vendor/k8s.io/legacy-cloud-providers/gce/gce_networkendpointgroup.go", "Go", 113, 0, 0, 0, 0, 0, 26, 139
"/opt/projects/swiftkube/vendor/k8s.io/legacy-cloud-providers/gce/gce_routes.go", "Go", 93, 0, 0, 0, 0, 0, 18, 111
"/opt/projects/swiftkube/vendor/k8s.io/legacy-cloud-providers/gce/gce_securitypolicy.go", "Go", 93, 0, 0, 0, 0, 0, 27, 120
"/opt/projects/swiftkube/vendor/k8s.io/legacy-cloud-providers/gce/gce_targetpool.go", "Go", 65, 0, 0, 0, 0, 0, 19, 84
"/opt/projects/swiftkube/vendor/k8s.io/legacy-cloud-providers/gce/gce_targetproxy.go", "Go", 111, 0, 0, 0, 0, 0, 32, 143
"/opt/projects/swiftkube/vendor/k8s.io/legacy-cloud-providers/gce/gce_tpu.go", "Go", 189, 0, 0, 0, 0, 0, 32, 221
"/opt/projects/swiftkube/vendor/k8s.io/legacy-cloud-providers/gce/gce_urlmap.go", "Go", 61, 0, 0, 0, 0, 0, 19, 80
"/opt/projects/swiftkube/vendor/k8s.io/legacy-cloud-providers/gce/gce_util.go", "Go", 357, 0, 0, 0, 0, 0, 62, 419
"/opt/projects/swiftkube/vendor/k8s.io/legacy-cloud-providers/gce/gce_zones.go", "Go", 80, 0, 0, 0, 0, 0, 16, 96
"/opt/projects/swiftkube/vendor/k8s.io/legacy-cloud-providers/gce/gcpcredential/credentialutil.go", "Go", 94, 0, 0, 0, 0, 0, 20, 114
"/opt/projects/swiftkube/vendor/k8s.io/legacy-cloud-providers/gce/gcpcredential/gcpcredential.go", "Go", 109, 0, 0, 0, 0, 0, 22, 131
"/opt/projects/swiftkube/vendor/k8s.io/legacy-cloud-providers/gce/gcpcredential/registry_marshal.go", "Go", 87, 0, 0, 0, 0, 0, 24, 111
"/opt/projects/swiftkube/vendor/k8s.io/legacy-cloud-providers/gce/metrics.go", "Go", 92, 0, 0, 0, 0, 0, 20, 112
"/opt/projects/swiftkube/vendor/k8s.io/legacy-cloud-providers/gce/support.go", "Go", 66, 0, 0, 0, 0, 0, 13, 79
"/opt/projects/swiftkube/vendor/k8s.io/legacy-cloud-providers/gce/token_source.go", "Go", 115, 0, 0, 0, 0, 0, 16, 131
"/opt/projects/swiftkube/vendor/k8s.io/legacy-cloud-providers/vsphere/credentialmanager.go", "Go", 150, 0, 0, 0, 0, 0, 21, 171
"/opt/projects/swiftkube/vendor/k8s.io/legacy-cloud-providers/vsphere/doc.go", "Go", 13, 0, 0, 0, 0, 0, 5, 18
"/opt/projects/swiftkube/vendor/k8s.io/legacy-cloud-providers/vsphere/nodemanager.go", "Go", 499, 0, 0, 0, 0, 0, 66, 565
"/opt/projects/swiftkube/vendor/k8s.io/legacy-cloud-providers/vsphere/shared_datastore.go", "Go", 186, 0, 0, 0, 0, 0, 25, 211
"/opt/projects/swiftkube/vendor/k8s.io/legacy-cloud-providers/vsphere/vclib/connection.go", "Go", 202, 0, 0, 0, 0, 0, 36, 238
"/opt/projects/swiftkube/vendor/k8s.io/legacy-cloud-providers/vsphere/vclib/constants.go", "Go", 56, 0, 0, 0, 0, 0, 10, 66
"/opt/projects/swiftkube/vendor/k8s.io/legacy-cloud-providers/vsphere/vclib/custom_errors.go", "Go", 30, 0, 0, 0, 0, 0, 8, 38
"/opt/projects/swiftkube/vendor/k8s.io/legacy-cloud-providers/vsphere/vclib/datacenter.go", "Go", 337, 0, 0, 0, 0, 0, 34, 371
"/opt/projects/swiftkube/vendor/k8s.io/legacy-cloud-providers/vsphere/vclib/datastore.go", "Go", 95, 0, 0, 0, 0, 0, 15, 110
"/opt/projects/swiftkube/vendor/k8s.io/legacy-cloud-providers/vsphere/vclib/diskmanagers/vdm.go", "Go", 92, 0, 0, 0, 0, 0, 14, 106
"/opt/projects/swiftkube/vendor/k8s.io/legacy-cloud-providers/vsphere/vclib/diskmanagers/virtualdisk.go", "Go", 68, 0, 0, 0, 0, 0, 13, 81
"/opt/projects/swiftkube/vendor/k8s.io/legacy-cloud-providers/vsphere/vclib/diskmanagers/vmdm.go", "Go", 233, 0, 0, 0, 0, 0, 22, 255
"/opt/projects/swiftkube/vendor/k8s.io/legacy-cloud-providers/vsphere/vclib/folder.go", "Go", 39, 0, 0, 0, 0, 0, 9, 48
"/opt/projects/swiftkube/vendor/k8s.io/legacy-cloud-providers/vsphere/vclib/pbm.go", "Go", 155, 0, 0, 0, 0, 0, 15, 170
"/opt/projects/swiftkube/vendor/k8s.io/legacy-cloud-providers/vsphere/vclib/utils.go", "Go", 256, 0, 0, 0, 0, 0, 29, 285
"/opt/projects/swiftkube/vendor/k8s.io/legacy-cloud-providers/vsphere/vclib/virtualmachine.go", "Go", 439, 0, 0, 0, 0, 0, 34, 473
"/opt/projects/swiftkube/vendor/k8s.io/legacy-cloud-providers/vsphere/vclib/vmoptions.go", "Go", 21, 0, 0, 0, 0, 0, 7, 28
"/opt/projects/swiftkube/vendor/k8s.io/legacy-cloud-providers/vsphere/vclib/volumeoptions.go", "Go", 98, 0, 0, 0, 0, 0, 14, 112
"/opt/projects/swiftkube/vendor/k8s.io/legacy-cloud-providers/vsphere/vclib/vsphere_metrics.go", "Go", 164, 0, 0, 0, 0, 0, 29, 193
"/opt/projects/swiftkube/vendor/k8s.io/legacy-cloud-providers/vsphere/vsphere.go", "Go", 1918, 0, 0, 0, 0, 0, 188, 2106
"/opt/projects/swiftkube/vendor/k8s.io/legacy-cloud-providers/vsphere/vsphere_util.go", "Go", 814, 0, 0, 0, 0, 0, 67, 881
"/opt/projects/swiftkube/vendor/k8s.io/legacy-cloud-providers/vsphere/vsphere_util_linux.go", "Go", 26, 0, 0, 0, 0, 0, 9, 35
"/opt/projects/swiftkube/vendor/k8s.io/legacy-cloud-providers/vsphere/vsphere_util_unsupported.go", "Go", 19, 0, 0, 0, 0, 0, 8, 27
"/opt/projects/swiftkube/vendor/k8s.io/legacy-cloud-providers/vsphere/vsphere_util_windows.go", "Go", 38, 0, 0, 0, 0, 0, 8, 46
"/opt/projects/swiftkube/vendor/k8s.io/legacy-cloud-providers/vsphere/vsphere_volume_map.go", "Go", 98, 0, 0, 0, 0, 0, 17, 115
"/opt/projects/swiftkube/vendor/k8s.io/metrics/pkg/apis/metrics/doc.go", "Go", 16, 0, 0, 0, 0, 0, 6, 22
"/opt/projects/swiftkube/vendor/k8s.io/metrics/pkg/apis/metrics/register.go", "Go", 44, 0, 0, 0, 0, 0, 12, 56
"/opt/projects/swiftkube/vendor/k8s.io/metrics/pkg/apis/metrics/types.go", "Go", 81, 0, 0, 0, 0, 0, 21, 102
"/opt/projects/swiftkube/vendor/k8s.io/metrics/pkg/apis/metrics/v1alpha1/doc.go", "Go", 19, 0, 0, 0, 0, 0, 6, 25
"/opt/projects/swiftkube/vendor/k8s.io/metrics/pkg/apis/metrics/v1alpha1/generated.pb.go", "Go", 1706, 0, 0, 0, 0, 0, 53, 1759
"/opt/projects/swiftkube/vendor/k8s.io/metrics/pkg/apis/metrics/v1alpha1/generated.proto", "Protocol Buffers", 0, 0, 44, 0, 0, 27, 25, 96
"/opt/projects/swiftkube/vendor/k8s.io/metrics/pkg/apis/metrics/v1alpha1/register.go", "Go", 43, 0, 0, 0, 0, 0, 11, 54
"/opt/projects/swiftkube/vendor/k8s.io/metrics/pkg/apis/metrics/v1alpha1/types.go", "Go", 81, 0, 0, 0, 0, 0, 21, 102
"/opt/projects/swiftkube/vendor/k8s.io/metrics/pkg/apis/metrics/v1alpha1/zz_generated.conversion.go", "Go", 179, 0, 0, 0, 0, 0, 31, 210
"/opt/projects/swiftkube/vendor/k8s.io/metrics/pkg/apis/metrics/v1alpha1/zz_generated.deepcopy.go", "Go", 165, 0, 0, 0, 0, 0, 22, 187
"/opt/projects/swiftkube/vendor/k8s.io/metrics/pkg/apis/metrics/v1beta1/doc.go", "Go", 19, 0, 0, 0, 0, 0, 6, 25
"/opt/projects/swiftkube/vendor/k8s.io/metrics/pkg/apis/metrics/v1beta1/generated.pb.go", "Go", 1706, 0, 0, 0, 0, 0, 53, 1759
"/opt/projects/swiftkube/vendor/k8s.io/metrics/pkg/apis/metrics/v1beta1/generated.proto", "Protocol Buffers", 0, 0, 44, 0, 0, 27, 25, 96
"/opt/projects/swiftkube/vendor/k8s.io/metrics/pkg/apis/metrics/v1beta1/register.go", "Go", 43, 0, 0, 0, 0, 0, 11, 54
"/opt/projects/swiftkube/vendor/k8s.io/metrics/pkg/apis/metrics/v1beta1/types.go", "Go", 81, 0, 0, 0, 0, 0, 21, 102
"/opt/projects/swiftkube/vendor/k8s.io/metrics/pkg/apis/metrics/v1beta1/zz_generated.conversion.go", "Go", 179, 0, 0, 0, 0, 0, 31, 210
"/opt/projects/swiftkube/vendor/k8s.io/metrics/pkg/apis/metrics/v1beta1/zz_generated.deepcopy.go", "Go", 165, 0, 0, 0, 0, 0, 22, 187
"/opt/projects/swiftkube/vendor/k8s.io/metrics/pkg/apis/metrics/zz_generated.deepcopy.go", "Go", 165, 0, 0, 0, 0, 0, 22, 187
"/opt/projects/swiftkube/vendor/k8s.io/metrics/pkg/client/clientset/versioned/clientset.go", "Go", 111, 0, 0, 0, 0, 0, 23, 134
"/opt/projects/swiftkube/vendor/k8s.io/metrics/pkg/client/clientset/versioned/scheme/doc.go", "Go", 15, 0, 0, 0, 0, 0, 6, 21
"/opt/projects/swiftkube/vendor/k8s.io/metrics/pkg/client/clientset/versioned/scheme/register.go", "Go", 49, 0, 0, 0, 0, 0, 10, 59
"/opt/projects/swiftkube/vendor/k8s.io/metrics/pkg/client/clientset/versioned/typed/metrics/v1alpha1/doc.go", "Go", 15, 0, 0, 0, 0, 0, 6, 21
"/opt/projects/swiftkube/vendor/k8s.io/metrics/pkg/client/clientset/versioned/typed/metrics/v1alpha1/generated_expansion.go", "Go", 16, 0, 0, 0, 0, 0, 8, 24
"/opt/projects/swiftkube/vendor/k8s.io/metrics/pkg/client/clientset/versioned/typed/metrics/v1alpha1/metrics_client.go", "Go", 93, 0, 0, 0, 0, 0, 20, 113
"/opt/projects/swiftkube/vendor/k8s.io/metrics/pkg/client/clientset/versioned/typed/metrics/v1alpha1/nodemetrics.go", "Go", 84, 0, 0, 0, 0, 0, 15, 99
"/opt/projects/swiftkube/vendor/k8s.io/metrics/pkg/client/clientset/versioned/typed/metrics/v1alpha1/podmetrics.go", "Go", 89, 0, 0, 0, 0, 0, 15, 104
"/opt/projects/swiftkube/vendor/k8s.io/metrics/pkg/client/clientset/versioned/typed/metrics/v1beta1/doc.go", "Go", 15, 0, 0, 0, 0, 0, 6, 21
"/opt/projects/swiftkube/vendor/k8s.io/metrics/pkg/client/clientset/versioned/typed/metrics/v1beta1/generated_expansion.go", "Go", 16, 0, 0, 0, 0, 0, 8, 24
"/opt/projects/swiftkube/vendor/k8s.io/metrics/pkg/client/clientset/versioned/typed/metrics/v1beta1/metrics_client.go", "Go", 93, 0, 0, 0, 0, 0, 20, 113
"/opt/projects/swiftkube/vendor/k8s.io/metrics/pkg/client/clientset/versioned/typed/metrics/v1beta1/nodemetrics.go", "Go", 84, 0, 0, 0, 0, 0, 15, 99
"/opt/projects/swiftkube/vendor/k8s.io/metrics/pkg/client/clientset/versioned/typed/metrics/v1beta1/podmetrics.go", "Go", 89, 0, 0, 0, 0, 0, 15, 104
"/opt/projects/swiftkube/vendor/k8s.io/mount-utils/doc.go", "Go", 14, 0, 0, 0, 0, 0, 5, 19
"/opt/projects/swiftkube/vendor/k8s.io/mount-utils/fake_mounter.go", "Go", 205, 0, 0, 0, 0, 0, 38, 243
"/opt/projects/swiftkube/vendor/k8s.io/mount-utils/mount.go", "Go", 356, 0, 0, 0, 0, 0, 46, 402
"/opt/projects/swiftkube/vendor/k8s.io/mount-utils/mount_helper_common.go", "Go", 136, 0, 0, 0, 0, 0, 22, 158
"/opt/projects/swiftkube/vendor/k8s.io/mount-utils/mount_helper_unix.go", "Go", 225, 0, 0, 0, 0, 0, 26, 251
"/opt/projects/swiftkube/vendor/k8s.io/mount-utils/mount_helper_windows.go", "Go", 95, 0, 0, 0, 0, 0, 17, 112
"/opt/projects/swiftkube/vendor/k8s.io/mount-utils/mount_linux.go", "Go", 745, 0, 0, 0, 0, 0, 88, 833
"/opt/projects/swiftkube/vendor/k8s.io/mount-utils/mount_unsupported.go", "Go", 83, 0, 0, 0, 0, 0, 23, 106
"/opt/projects/swiftkube/vendor/k8s.io/mount-utils/mount_windows.go", "Go", 305, 0, 0, 0, 0, 0, 53, 358
"/opt/projects/swiftkube/vendor/k8s.io/mount-utils/resizefs_linux.go", "Go", 254, 0, 0, 0, 0, 0, 43, 297
"/opt/projects/swiftkube/vendor/k8s.io/mount-utils/resizefs_unsupported.go", "Go", 35, 0, 0, 0, 0, 0, 12, 47
"/opt/projects/swiftkube/vendor/k8s.io/utils/buffer/ring_growing.go", "Go", 64, 0, 0, 0, 0, 0, 9, 73
"/opt/projects/swiftkube/vendor/k8s.io/utils/clock/clock.go", "Go", 148, 0, 0, 0, 0, 0, 31, 179
"/opt/projects/swiftkube/vendor/k8s.io/utils/clock/testing/fake_clock.go", "Go", 305, 0, 0, 0, 0, 0, 57, 362
"/opt/projects/swiftkube/vendor/k8s.io/utils/clock/testing/simple_interval_clock.go", "Go", 34, 0, 0, 0, 0, 0, 11, 45
"/opt/projects/swiftkube/vendor/k8s.io/utils/cpuset/cpuset.go", "Go", 225, 0, 0, 0, 0, 0, 32, 257
"/opt/projects/swiftkube/vendor/k8s.io/utils/exec/doc.go", "Go", 14, 0, 0, 0, 0, 0, 5, 19
"/opt/projects/swiftkube/vendor/k8s.io/utils/exec/exec.go", "Go", 207, 0, 0, 0, 0, 0, 50, 257
"/opt/projects/swiftkube/vendor/k8s.io/utils/exec/fixup_go118.go", "Go", 24, 0, 0, 0, 0, 0, 9, 33
"/opt/projects/swiftkube/vendor/k8s.io/utils/exec/fixup_go119.go", "Go", 32, 0, 0, 0, 0, 0, 9, 41
"/opt/projects/swiftkube/vendor/k8s.io/utils/inotify/inotify.go", "Go", 37, 0, 0, 0, 0, 0, 9, 46
"/opt/projects/swiftkube/vendor/k8s.io/utils/inotify/inotify_linux.go", "Go", 281, 0, 0, 0, 0, 0, 35, 316
"/opt/projects/swiftkube/vendor/k8s.io/utils/inotify/inotify_others.go", "Go", 42, 0, 0, 0, 0, 0, 13, 55
"/opt/projects/swiftkube/vendor/k8s.io/utils/integer/integer.go", "Go", 62, 0, 0, 0, 0, 0, 12, 74
"/opt/projects/swiftkube/vendor/k8s.io/utils/internal/third_party/forked/golang/golang-lru/lru.go", "Go", 115, 0, 0, 0, 0, 0, 19, 134
"/opt/projects/swiftkube/vendor/k8s.io/utils/internal/third_party/forked/golang/net/ip.go", "Go", 214, 0, 0, 0, 0, 0, 23, 237
"/opt/projects/swiftkube/vendor/k8s.io/utils/internal/third_party/forked/golang/net/parse.go", "Go", 53, 0, 0, 0, 0, 0, 7, 60
"/opt/projects/swiftkube/vendor/k8s.io/utils/io/read.go", "Go", 85, 0, 0, 0, 0, 0, 14, 99
"/opt/projects/swiftkube/vendor/k8s.io/utils/keymutex/hashed.go", "Go", 48, 0, 0, 0, 0, 0, 11, 59
"/opt/projects/swiftkube/vendor/k8s.io/utils/keymutex/keymutex.go", "Go", 21, 0, 0, 0, 0, 0, 7, 28
"/opt/projects/swiftkube/vendor/k8s.io/utils/lru/lru.go", "Go", 72, 0, 0, 0, 0, 0, 16, 88
"/opt/projects/swiftkube/vendor/k8s.io/utils/net/ipfamily.go", "Go", 155, 0, 0, 0, 0, 0, 27, 182
"/opt/projects/swiftkube/vendor/k8s.io/utils/net/ipnet.go", "Go", 192, 0, 0, 0, 0, 0, 30, 222
"/opt/projects/swiftkube/vendor/k8s.io/utils/net/net.go", "Go", 80, 0, 0, 0, 0, 0, 12, 92
"/opt/projects/swiftkube/vendor/k8s.io/utils/net/parse.go", "Go", 26, 0, 0, 0, 0, 0, 8, 34
"/opt/projects/swiftkube/vendor/k8s.io/utils/net/port.go", "Go", 113, 0, 0, 0, 0, 0, 17, 130
"/opt/projects/swiftkube/vendor/k8s.io/utils/nsenter/nsenter.go", "Go", 234, 0, 0, 0, 0, 0, 31, 265
"/opt/projects/swiftkube/vendor/k8s.io/utils/nsenter/nsenter_unsupported.go", "Go", 62, 0, 0, 0, 0, 0, 19, 81
"/opt/projects/swiftkube/vendor/k8s.io/utils/path/file.go", "Go", 63, 0, 0, 0, 0, 0, 16, 79
"/opt/projects/swiftkube/vendor/k8s.io/utils/pointer/pointer.go", "Go", 353, 0, 0, 0, 0, 0, 58, 411
"/opt/projects/swiftkube/vendor/k8s.io/utils/strings/escape.go", "Go", 29, 0, 0, 0, 0, 0, 8, 37
"/opt/projects/swiftkube/vendor/k8s.io/utils/strings/line_delimiter.go", "Go", 55, 0, 0, 0, 0, 0, 10, 65
"/opt/projects/swiftkube/vendor/k8s.io/utils/strings/slices/slices.go", "Go", 72, 0, 0, 0, 0, 0, 11, 83
"/opt/projects/swiftkube/vendor/k8s.io/utils/strings/strings.go", "Go", 38, 0, 0, 0, 0, 0, 9, 47
"/opt/projects/swiftkube/vendor/k8s.io/utils/trace/trace.go", "Go", 276, 0, 0, 0, 0, 0, 44, 320
"/opt/projects/swiftkube/vendor/sigs.k8s.io/apiserver-network-proxy/konnectivity-client/pkg/client/client.go", "Go", 472, 0, 0, 0, 0, 0, 83, 555
"/opt/projects/swiftkube/vendor/sigs.k8s.io/apiserver-network-proxy/konnectivity-client/pkg/client/conn.go", "Go", 133, 0, 0, 0, 0, 0, 33, 166
"/opt/projects/swiftkube/vendor/sigs.k8s.io/apiserver-network-proxy/konnectivity-client/pkg/client/metrics/metrics.go", "Go", 141, 0, 0, 0, 0, 0, 24, 165
"/opt/projects/swiftkube/vendor/sigs.k8s.io/apiserver-network-proxy/konnectivity-client/pkg/common/metrics/metrics.go", "Go", 65, 0, 0, 0, 0, 0, 14, 79
"/opt/projects/swiftkube/vendor/sigs.k8s.io/apiserver-network-proxy/konnectivity-client/proto/client/client.pb.go", "Go", 718, 0, 0, 0, 0, 0, 103, 821
"/opt/projects/swiftkube/vendor/sigs.k8s.io/apiserver-network-proxy/konnectivity-client/proto/client/client.proto", "Protocol Buffers", 0, 0, 49, 0, 0, 28, 21, 98
"/opt/projects/swiftkube/vendor/sigs.k8s.io/apiserver-network-proxy/konnectivity-client/proto/client/client_grpc.pb.go", "Go", 125, 0, 0, 0, 0, 0, 26, 151
"/opt/projects/swiftkube/vendor/sigs.k8s.io/json/doc.go", "Go", 13, 0, 0, 0, 0, 0, 5, 18
"/opt/projects/swiftkube/vendor/sigs.k8s.io/json/internal/golang/encoding/json/decode.go", "Go", 1321, 0, 0, 0, 0, 0, 118, 1439
"/opt/projects/swiftkube/vendor/sigs.k8s.io/json/internal/golang/encoding/json/encode.go", "Go", 1294, 0, 0, 0, 0, 0, 125, 1419
"/opt/projects/swiftkube/vendor/sigs.k8s.io/json/internal/golang/encoding/json/fold.go", "Go", 136, 0, 0, 0, 0, 0, 9, 145
"/opt/projects/swiftkube/vendor/sigs.k8s.io/json/internal/golang/encoding/json/fuzz.go", "Go", 35, 0, 0, 0, 0, 0, 8, 43
"/opt/projects/swiftkube/vendor/sigs.k8s.io/json/internal/golang/encoding/json/indent.go", "Go", 131, 0, 0, 0, 0, 0, 13, 144
"/opt/projects/swiftkube/vendor/sigs.k8s.io/json/internal/golang/encoding/json/kubernetes_patch.go", "Go", 143, 0, 0, 0, 0, 0, 26, 169
"/opt/projects/swiftkube/vendor/sigs.k8s.io/json/internal/golang/encoding/json/scanner.go", "Go", 552, 0, 0, 0, 0, 0, 59, 611
"/opt/projects/swiftkube/vendor/sigs.k8s.io/json/internal/golang/encoding/json/stream.go", "Go", 462, 0, 0, 0, 0, 0, 57, 519
"/opt/projects/swiftkube/vendor/sigs.k8s.io/json/internal/golang/encoding/json/tables.go", "Go", 214, 0, 0, 0, 0, 0, 5, 219
"/opt/projects/swiftkube/vendor/sigs.k8s.io/json/internal/golang/encoding/json/tags.go", "Go", 33, 0, 0, 0, 0, 0, 6, 39
"/opt/projects/swiftkube/vendor/sigs.k8s.io/json/json.go", "Go", 134, 0, 0, 0, 0, 0, 17, 151
"/opt/projects/swiftkube/vendor/sigs.k8s.io/kustomize/api/filters/annotations/annotations.go", "Go", 43, 0, 0, 0, 0, 0, 10, 53
"/opt/projects/swiftkube/vendor/sigs.k8s.io/kustomize/api/filters/annotations/doc.go", "Go", 5, 0, 0, 0, 0, 0, 2, 7
"/opt/projects/swiftkube/vendor/sigs.k8s.io/kustomize/api/filters/fieldspec/doc.go", "Go", 5, 0, 0, 0, 0, 0, 2, 7
"/opt/projects/swiftkube/vendor/sigs.k8s.io/kustomize/api/filters/fieldspec/fieldspec.go", "Go", 160, 0, 0, 0, 0, 0, 23, 183
"/opt/projects/swiftkube/vendor/sigs.k8s.io/kustomize/api/filters/filtersutil/setters.go", "Go", 93, 0, 0, 0, 0, 0, 13, 106
"/opt/projects/swiftkube/vendor/sigs.k8s.io/kustomize/api/filters/fsslice/doc.go", "Go", 5, 0, 0, 0, 0, 0, 2, 7
"/opt/projects/swiftkube/vendor/sigs.k8s.io/kustomize/api/filters/fsslice/fsslice.go", "Go", 39, 0, 0, 0, 0, 0, 9, 48
"/opt/projects/swiftkube/vendor/sigs.k8s.io/kustomize/api/filters/iampolicygenerator/doc.go", "Go", 5, 0, 0, 0, 0, 0, 2, 7
"/opt/projects/swiftkube/vendor/sigs.k8s.io/kustomize/api/filters/iampolicygenerator/iampolicygenerator.go", "Go", 46, 0, 0, 0, 0, 0, 10, 56
"/opt/projects/swiftkube/vendor/sigs.k8s.io/kustomize/api/filters/imagetag/doc.go", "Go", 11, 0, 0, 0, 0, 0, 2, 13
"/opt/projects/swiftkube/vendor/sigs.k8s.io/kustomize/api/filters/imagetag/imagetag.go", "Go", 62, 0, 0, 0, 0, 0, 11, 73
"/opt/projects/swiftkube/vendor/sigs.k8s.io/kustomize/api/filters/imagetag/legacy.go", "Go", 89, 0, 0, 0, 0, 0, 16, 105
"/opt/projects/swiftkube/vendor/sigs.k8s.io/kustomize/api/filters/imagetag/updater.go", "Go", 59, 0, 0, 0, 0, 0, 13, 72
"/opt/projects/swiftkube/vendor/sigs.k8s.io/kustomize/api/filters/labels/doc.go", "Go", 5, 0, 0, 0, 0, 0, 2, 7
"/opt/projects/swiftkube/vendor/sigs.k8s.io/kustomize/api/filters/labels/labels.go", "Go", 44, 0, 0, 0, 0, 0, 10, 54
"/opt/projects/swiftkube/vendor/sigs.k8s.io/kustomize/api/filters/nameref/doc.go", "Go", 5, 0, 0, 0, 0, 0, 2, 7
"/opt/projects/swiftkube/vendor/sigs.k8s.io/kustomize/api/filters/nameref/nameref.go", "Go", 383, 0, 0, 0, 0, 0, 31, 414
"/opt/projects/swiftkube/vendor/sigs.k8s.io/kustomize/api/filters/nameref/seqfilter.go", "Go", 51, 0, 0, 0, 0, 0, 10, 61
"/opt/projects/swiftkube/vendor/sigs.k8s.io/kustomize/api/filters/namespace/doc.go", "Go", 8, 0, 0, 0, 0, 0, 2, 10
"/opt/projects/swiftkube/vendor/sigs.k8s.io/kustomize/api/filters/namespace/namespace.go", "Go", 191, 0, 0, 0, 0, 0, 27, 218
"/opt/projects/swiftkube/vendor/sigs.k8s.io/kustomize/api/filters/patchjson6902/doc.go", "Go", 5, 0, 0, 0, 0, 0, 2, 7
"/opt/projects/swiftkube/vendor/sigs.k8s.io/kustomize/api/filters/patchjson6902/patchjson6902.go", "Go", 56, 0, 0, 0, 0, 0, 10, 66
"/opt/projects/swiftkube/vendor/sigs.k8s.io/kustomize/api/filters/patchstrategicmerge/doc.go", "Go", 5, 0, 0, 0, 0, 0, 2, 7
"/opt/projects/swiftkube/vendor/sigs.k8s.io/kustomize/api/filters/patchstrategicmerge/patchstrategicmerge.go", "Go", 31, 0, 0, 0, 0, 0, 6, 37
"/opt/projects/swiftkube/vendor/sigs.k8s.io/kustomize/api/filters/prefix/doc.go", "Go", 5, 0, 0, 0, 0, 0, 2, 7
"/opt/projects/swiftkube/vendor/sigs.k8s.io/kustomize/api/filters/prefix/prefix.go", "Go", 39, 0, 0, 0, 0, 0, 12, 51
"/opt/projects/swiftkube/vendor/sigs.k8s.io/kustomize/api/filters/refvar/doc.go", "Go", 5, 0, 0, 0, 0, 0, 2, 7
"/opt/projects/swiftkube/vendor/sigs.k8s.io/kustomize/api/filters/refvar/expand.go", "Go", 132, 0, 0, 0, 0, 0, 16, 148
"/opt/projects/swiftkube/vendor/sigs.k8s.io/kustomize/api/filters/refvar/refvar.go", "Go", 102, 0, 0, 0, 0, 0, 12, 114
"/opt/projects/swiftkube/vendor/sigs.k8s.io/kustomize/api/filters/replacement/doc.go", "Go", 6, 0, 0, 0, 0, 0, 2, 8
"/opt/projects/swiftkube/vendor/sigs.k8s.io/kustomize/api/filters/replacement/replacement.go", "Go", 221, 0, 0, 0, 0, 0, 24, 245
"/opt/projects/swiftkube/vendor/sigs.k8s.io/kustomize/api/filters/replicacount/doc.go", "Go", 5, 0, 0, 0, 0, 0, 2, 7
"/opt/projects/swiftkube/vendor/sigs.k8s.io/kustomize/api/filters/replicacount/replicacount.go", "Go", 38, 0, 0, 0, 0, 0, 11, 49
"/opt/projects/swiftkube/vendor/sigs.k8s.io/kustomize/api/filters/suffix/doc.go", "Go", 5, 0, 0, 0, 0, 0, 2, 7
"/opt/projects/swiftkube/vendor/sigs.k8s.io/kustomize/api/filters/suffix/suffix.go", "Go", 39, 0, 0, 0, 0, 0, 12, 51
"/opt/projects/swiftkube/vendor/sigs.k8s.io/kustomize/api/filters/valueadd/valueadd.go", "Go", 126, 0, 0, 0, 0, 0, 9, 135
"/opt/projects/swiftkube/vendor/sigs.k8s.io/kustomize/api/hasher/hasher.go", "Go", 142, 0, 0, 0, 0, 0, 14, 156
"/opt/projects/swiftkube/vendor/sigs.k8s.io/kustomize/api/ifc/ifc.go", "Go", 44, 0, 0, 0, 0, 0, 13, 57
"/opt/projects/swiftkube/vendor/sigs.k8s.io/kustomize/api/image/image.go", "Go", 57, 0, 0, 0, 0, 0, 10, 67
"/opt/projects/swiftkube/vendor/sigs.k8s.io/kustomize/api/internal/accumulator/loadconfigfromcrds.go", "Go", 180, 0, 0, 0, 0, 0, 19, 199
"/opt/projects/swiftkube/vendor/sigs.k8s.io/kustomize/api/internal/accumulator/namereferencetransformer.go", "Go", 151, 0, 0, 0, 0, 0, 14, 165
"/opt/projects/swiftkube/vendor/sigs.k8s.io/kustomize/api/internal/accumulator/refvartransformer.go", "Go", 51, 0, 0, 0, 0, 0, 7, 58
"/opt/projects/swiftkube/vendor/sigs.k8s.io/kustomize/api/internal/accumulator/resaccumulator.go", "Go", 171, 0, 0, 0, 0, 0, 20, 191
"/opt/projects/swiftkube/vendor/sigs.k8s.io/kustomize/api/internal/builtins/AnnotationsTransformer.go", "Go", 32, 0, 0, 0, 0, 0, 7, 39
"/opt/projects/swiftkube/vendor/sigs.k8s.io/kustomize/api/internal/builtins/ConfigMapGenerator.go", "Go", 33, 0, 0, 0, 0, 0, 7, 40
"/opt/projects/swiftkube/vendor/sigs.k8s.io/kustomize/api/internal/builtins/HashTransformer.go", "Go", 33, 0, 0, 0, 0, 0, 8, 41
"/opt/projects/swiftkube/vendor/sigs.k8s.io/kustomize/api/internal/builtins/HelmChartInflationGenerator.go", "Go", 301, 0, 0, 0, 0, 0, 29, 330
"/opt/projects/swiftkube/vendor/sigs.k8s.io/kustomize/api/internal/builtins/IAMPolicyGenerator.go", "Go", 27, 0, 0, 0, 0, 0, 7, 34
"/opt/projects/swiftkube/vendor/sigs.k8s.io/kustomize/api/internal/builtins/ImageTagTransformer.go", "Go", 35, 0, 0, 0, 0, 0, 7, 42
"/opt/projects/swiftkube/vendor/sigs.k8s.io/kustomize/api/internal/builtins/LabelTransformer.go", "Go", 32, 0, 0, 0, 0, 0, 7, 39
"/opt/projects/swiftkube/vendor/sigs.k8s.io/kustomize/api/internal/builtins/NamespaceTransformer.go", "Go", 66, 0, 0, 0, 0, 0, 9, 75
"/opt/projects/swiftkube/vendor/sigs.k8s.io/kustomize/api/internal/builtins/PatchJson6902Transformer.go", "Go", 96, 0, 0, 0, 0, 0, 10, 106
"/opt/projects/swiftkube/vendor/sigs.k8s.io/kustomize/api/internal/builtins/PatchStrategicMergeTransformer.go", "Go", 81, 0, 0, 0, 0, 0, 9, 90
"/opt/projects/swiftkube/vendor/sigs.k8s.io/kustomize/api/internal/builtins/PatchTransformer.go", "Go", 140, 0, 0, 0, 0, 0, 14, 154
"/opt/projects/swiftkube/vendor/sigs.k8s.io/kustomize/api/internal/builtins/PrefixTransformer.go", "Go", 86, 0, 0, 0, 0, 0, 11, 97
"/opt/projects/swiftkube/vendor/sigs.k8s.io/kustomize/api/internal/builtins/ReplacementTransformer.go", "Go", 70, 0, 0, 0, 0, 0, 9, 79
"/opt/projects/swiftkube/vendor/sigs.k8s.io/kustomize/api/internal/builtins/ReplicaCountTransformer.go", "Go", 63, 0, 0, 0, 0, 0, 11, 74
"/opt/projects/swiftkube/vendor/sigs.k8s.io/kustomize/api/internal/builtins/SecretGenerator.go", "Go", 33, 0, 0, 0, 0, 0, 7, 40
"/opt/projects/swiftkube/vendor/sigs.k8s.io/kustomize/api/internal/builtins/SortOrderTransformer.go", "Go", 220, 0, 0, 0, 0, 0, 25, 245
"/opt/projects/swiftkube/vendor/sigs.k8s.io/kustomize/api/internal/builtins/SuffixTransformer.go", "Go", 86, 0, 0, 0, 0, 0, 11, 97
"/opt/projects/swiftkube/vendor/sigs.k8s.io/kustomize/api/internal/builtins/ValueAddTransformer.go", "Go", 126, 0, 0, 0, 0, 0, 16, 142
"/opt/projects/swiftkube/vendor/sigs.k8s.io/kustomize/api/internal/builtins/doc.go", "Go", 7, 0, 0, 0, 0, 0, 2, 9
"/opt/projects/swiftkube/vendor/sigs.k8s.io/kustomize/api/internal/generators/configmap.go", "Go", 49, 0, 0, 0, 0, 0, 4, 53
"/opt/projects/swiftkube/vendor/sigs.k8s.io/kustomize/api/internal/generators/secret.go", "Go", 56, 0, 0, 0, 0, 0, 4, 60
"/opt/projects/swiftkube/vendor/sigs.k8s.io/kustomize/api/internal/generators/utils.go", "Go", 115, 0, 0, 0, 0, 0, 10, 125
"/opt/projects/swiftkube/vendor/sigs.k8s.io/kustomize/api/internal/git/cloner.go", "Go", 45, 0, 0, 0, 0, 0, 6, 51
"/opt/projects/swiftkube/vendor/sigs.k8s.io/kustomize/api/internal/git/gitrunner.go", "Go", 49, 0, 0, 0, 0, 0, 7, 56
"/opt/projects/swiftkube/vendor/sigs.k8s.io/kustomize/api/internal/git/repospec.go", "Go", 329, 0, 0, 0, 0, 0, 59, 388
"/opt/projects/swiftkube/vendor/sigs.k8s.io/kustomize/api/internal/kusterr/yamlformaterror.go", "Go", 46, 0, 0, 0, 0, 0, 10, 56
"/opt/projects/swiftkube/vendor/sigs.k8s.io/kustomize/api/internal/plugins/builtinconfig/doc.go", "Go", 9, 0, 0, 0, 0, 0, 2, 11
"/opt/projects/swiftkube/vendor/sigs.k8s.io/kustomize/api/internal/plugins/builtinconfig/loaddefaultconfig.go", "Go", 38, 0, 0, 0, 0, 0, 5, 43
"/opt/projects/swiftkube/vendor/sigs.k8s.io/kustomize/api/internal/plugins/builtinconfig/namebackreferences.go", "Go", 89, 0, 0, 0, 0, 0, 11, 100
"/opt/projects/swiftkube/vendor/sigs.k8s.io/kustomize/api/internal/plugins/builtinconfig/transformerconfig.go", "Go", 142, 0, 0, 0, 0, 0, 15, 157
"/opt/projects/swiftkube/vendor/sigs.k8s.io/kustomize/api/internal/plugins/builtinhelpers/builtinplugintype_string.go", "Go", 35, 0, 0, 0, 0, 0, 7, 42
"/opt/projects/swiftkube/vendor/sigs.k8s.io/kustomize/api/internal/plugins/builtinhelpers/builtins.go", "Go", 101, 0, 0, 0, 0, 0, 15, 116
"/opt/projects/swiftkube/vendor/sigs.k8s.io/kustomize/api/internal/plugins/execplugin/execplugin.go", "Go", 167, 0, 0, 0, 0, 0, 25, 192
"/opt/projects/swiftkube/vendor/sigs.k8s.io/kustomize/api/internal/plugins/fnplugin/fnplugin.go", "Go", 171, 0, 0, 0, 0, 0, 32, 203
"/opt/projects/swiftkube/vendor/sigs.k8s.io/kustomize/api/internal/plugins/loader/loader.go", "Go", 308, 0, 0, 0, 0, 0, 25, 333
"/opt/projects/swiftkube/vendor/sigs.k8s.io/kustomize/api/internal/plugins/utils/utils.go", "Go", 222, 0, 0, 0, 0, 0, 19, 241
"/opt/projects/swiftkube/vendor/sigs.k8s.io/kustomize/api/internal/target/errmissingkustomization.go", "Go", 35, 0, 0, 0, 0, 0, 10, 45
"/opt/projects/swiftkube/vendor/sigs.k8s.io/kustomize/api/internal/target/kusttarget.go", "Go", 535, 0, 0, 0, 0, 0, 40, 575
"/opt/projects/swiftkube/vendor/sigs.k8s.io/kustomize/api/internal/target/kusttarget_configplugin.go", "Go", 431, 0, 0, 0, 0, 0, 16, 447
"/opt/projects/swiftkube/vendor/sigs.k8s.io/kustomize/api/internal/target/multitransformer.go", "Go", 35, 0, 0, 0, 0, 0, 7, 42
"/opt/projects/swiftkube/vendor/sigs.k8s.io/kustomize/api/internal/utils/annotations.go", "Go", 23, 0, 0, 0, 0, 0, 7, 30
"/opt/projects/swiftkube/vendor/sigs.k8s.io/kustomize/api/internal/utils/errtimeout.go", "Go", 22, 0, 0, 0, 0, 0, 8, 30
"/opt/projects/swiftkube/vendor/sigs.k8s.io/kustomize/api/internal/utils/makeResIds.go", "Go", 63, 0, 0, 0, 0, 0, 6, 69
"/opt/projects/swiftkube/vendor/sigs.k8s.io/kustomize/api/internal/utils/stringslice.go", "Go", 40, 0, 0, 0, 0, 0, 5, 45
"/opt/projects/swiftkube/vendor/sigs.k8s.io/kustomize/api/internal/utils/timedcall.go", "Go", 20, 0, 0, 0, 0, 0, 4, 24
"/opt/projects/swiftkube/vendor/sigs.k8s.io/kustomize/api/internal/validate/fieldvalidator.go", "Go", 56, 0, 0, 0, 0, 0, 13, 69
"/opt/projects/swiftkube/vendor/sigs.k8s.io/kustomize/api/konfig/builtinpluginconsts/commonannotations.go", "Go", 36, 0, 0, 0, 0, 0, 12, 48
"/opt/projects/swiftkube/vendor/sigs.k8s.io/kustomize/api/konfig/builtinpluginconsts/commonlabels.go", "Go", 91, 0, 0, 0, 0, 0, 23, 114
"/opt/projects/swiftkube/vendor/sigs.k8s.io/kustomize/api/konfig/builtinpluginconsts/defaultconfig.go", "Go", 38, 0, 0, 0, 0, 0, 5, 43
"/opt/projects/swiftkube/vendor/sigs.k8s.io/kustomize/api/konfig/builtinpluginconsts/doc.go", "Go", 7, 0, 0, 0, 0, 0, 2, 9
"/opt/projects/swiftkube/vendor/sigs.k8s.io/kustomize/api/konfig/builtinpluginconsts/images.go", "Go", 16, 0, 0, 0, 0, 0, 3, 19
"/opt/projects/swiftkube/vendor/sigs.k8s.io/kustomize/api/konfig/builtinpluginconsts/metadatalabels.go", "Go", 40, 0, 0, 0, 0, 0, 12, 52
"/opt/projects/swiftkube/vendor/sigs.k8s.io/kustomize/api/konfig/builtinpluginconsts/nameprefix.go", "Go", 9, 0, 0, 0, 0, 0, 3, 12
"/opt/projects/swiftkube/vendor/sigs.k8s.io/kustomize/api/konfig/builtinpluginconsts/namereference.go", "Go", 410, 0, 0, 0, 0, 0, 18, 428
"/opt/projects/swiftkube/vendor/sigs.k8s.io/kustomize/api/konfig/builtinpluginconsts/namespace.go", "Go", 18, 0, 0, 0, 0, 0, 3, 21
"/opt/projects/swiftkube/vendor/sigs.k8s.io/kustomize/api/konfig/builtinpluginconsts/namesuffix.go", "Go", 9, 0, 0, 0, 0, 0, 3, 12
"/opt/projects/swiftkube/vendor/sigs.k8s.io/kustomize/api/konfig/builtinpluginconsts/replicas.go", "Go", 18, 0, 0, 0, 0, 0, 6, 24
"/opt/projects/swiftkube/vendor/sigs.k8s.io/kustomize/api/konfig/builtinpluginconsts/templatelabels.go", "Go", 6, 0, 0, 0, 0, 0, 3, 9
"/opt/projects/swiftkube/vendor/sigs.k8s.io/kustomize/api/konfig/builtinpluginconsts/varreference.go", "Go", 150, 0, 0, 0, 0, 0, 74, 224
"/opt/projects/swiftkube/vendor/sigs.k8s.io/kustomize/api/konfig/doc.go", "Go", 6, 0, 0, 0, 0, 0, 2, 8
"/opt/projects/swiftkube/vendor/sigs.k8s.io/kustomize/api/konfig/general.go", "Go", 38, 0, 0, 0, 0, 0, 12, 50
"/opt/projects/swiftkube/vendor/sigs.k8s.io/kustomize/api/konfig/plugins.go", "Go", 121, 0, 0, 0, 0, 0, 18, 139
"/opt/projects/swiftkube/vendor/sigs.k8s.io/kustomize/api/krusty/doc.go", "Go", 10, 0, 0, 0, 0, 0, 2, 12
"/opt/projects/swiftkube/vendor/sigs.k8s.io/kustomize/api/krusty/kustomizer.go", "Go", 155, 0, 0, 0, 0, 0, 9, 164
"/opt/projects/swiftkube/vendor/sigs.k8s.io/kustomize/api/krusty/options.go", "Go", 59, 0, 0, 0, 0, 0, 12, 71
"/opt/projects/swiftkube/vendor/sigs.k8s.io/kustomize/api/kv/kv.go", "Go", 170, 0, 0, 0, 0, 0, 28, 198
"/opt/projects/swiftkube/vendor/sigs.k8s.io/kustomize/api/loader/errors.go", "Go", 8, 0, 0, 0, 0, 0, 4, 12
"/opt/projects/swiftkube/vendor/sigs.k8s.io/kustomize/api/loader/fileloader.go", "Go", 320, 0, 0, 0, 0, 0, 30, 350
"/opt/projects/swiftkube/vendor/sigs.k8s.io/kustomize/api/loader/loader.go", "Go", 32, 0, 0, 0, 0, 0, 4, 36
"/opt/projects/swiftkube/vendor/sigs.k8s.io/kustomize/api/loader/loadrestrictions.go", "Go", 29, 0, 0, 0, 0, 0, 7, 36
"/opt/projects/swiftkube/vendor/sigs.k8s.io/kustomize/api/provenance/provenance.go", "Go", 75, 0, 0, 0, 0, 0, 10, 85
"/opt/projects/swiftkube/vendor/sigs.k8s.io/kustomize/api/provider/depprovider.go", "Go", 35, 0, 0, 0, 0, 0, 8, 43
"/opt/projects/swiftkube/vendor/sigs.k8s.io/kustomize/api/resmap/factory.go", "Go", 129, 0, 0, 0, 0, 0, 17, 146
"/opt/projects/swiftkube/vendor/sigs.k8s.io/kustomize/api/resmap/resmap.go", "Go", 281, 0, 0, 0, 0, 0, 53, 334
"/opt/projects/swiftkube/vendor/sigs.k8s.io/kustomize/api/resmap/reswrangler.go", "Go", 701, 0, 0, 0, 0, 0, 64, 765
"/opt/projects/swiftkube/vendor/sigs.k8s.io/kustomize/api/resource/doc.go", "Go", 4, 0, 0, 0, 0, 0, 2, 6
"/opt/projects/swiftkube/vendor/sigs.k8s.io/kustomize/api/resource/factory.go", "Go", 266, 0, 0, 0, 0, 0, 28, 294
"/opt/projects/swiftkube/vendor/sigs.k8s.io/kustomize/api/resource/idset.go", "Go", 24, 0, 0, 0, 0, 0, 7, 31
"/opt/projects/swiftkube/vendor/sigs.k8s.io/kustomize/api/resource/origin.go", "Go", 91, 0, 0, 0, 0, 0, 16, 107
"/opt/projects/swiftkube/vendor/sigs.k8s.io/kustomize/api/resource/resource.go", "Go", 472, 0, 0, 0, 0, 0, 63, 535
"/opt/projects/swiftkube/vendor/sigs.k8s.io/kustomize/api/types/builtinpluginloadingoptions_string.go", "Go", 19, 0, 0, 0, 0, 0, 7, 26
"/opt/projects/swiftkube/vendor/sigs.k8s.io/kustomize/api/types/configmapargs.go", "Go", 8, 0, 0, 0, 0, 0, 3, 11
"/opt/projects/swiftkube/vendor/sigs.k8s.io/kustomize/api/types/doc.go", "Go", 8, 0, 0, 0, 0, 0, 2, 10
"/opt/projects/swiftkube/vendor/sigs.k8s.io/kustomize/api/types/erronlybuiltinpluginsallowed.go", "Go", 22, 0, 0, 0, 0, 0, 8, 30
"/opt/projects/swiftkube/vendor/sigs.k8s.io/kustomize/api/types/errunabletofind.go", "Go", 29, 0, 0, 0, 0, 0, 8, 37
"/opt/projects/swiftkube/vendor/sigs.k8s.io/kustomize/api/types/fieldspec.go", "Go", 80, 0, 0, 0, 0, 0, 12, 92
"/opt/projects/swiftkube/vendor/sigs.k8s.io/kustomize/api/types/generationbehavior.go", "Go", 41, 0, 0, 0, 0, 0, 6, 47
"/opt/projects/swiftkube/vendor/sigs.k8s.io/kustomize/api/types/generatorargs.go", "Go", 21, 0, 0, 0, 0, 0, 7, 28
"/opt/projects/swiftkube/vendor/sigs.k8s.io/kustomize/api/types/generatoroptions.go", "Go", 68, 0, 0, 0, 0, 0, 9, 77
"/opt/projects/swiftkube/vendor/sigs.k8s.io/kustomize/api/types/helmchartargs.go", "Go", 160, 0, 0, 0, 0, 0, 26, 186
"/opt/projects/swiftkube/vendor/sigs.k8s.io/kustomize/api/types/iampolicygenerator.go", "Go", 26, 0, 0, 0, 0, 0, 11, 37
"/opt/projects/swiftkube/vendor/sigs.k8s.io/kustomize/api/types/image.go", "Go", 19, 0, 0, 0, 0, 0, 7, 26
"/opt/projects/swiftkube/vendor/sigs.k8s.io/kustomize/api/types/kustomization.go", "Go", 293, 0, 0, 0, 0, 0, 59, 352
"/opt/projects/swiftkube/vendor/sigs.k8s.io/kustomize/api/types/kvpairsources.go", "Go", 31, 0, 0, 0, 0, 0, 6, 37
"/opt/projects/swiftkube/vendor/sigs.k8s.io/kustomize/api/types/labels.go", "Go", 27, 0, 0, 0, 0, 0, 4, 31
"/opt/projects/swiftkube/vendor/sigs.k8s.io/kustomize/api/types/loadrestrictions.go", "Go", 19, 0, 0, 0, 0, 0, 6, 25
"/opt/projects/swiftkube/vendor/sigs.k8s.io/kustomize/api/types/loadrestrictions_string.go", "Go", 19, 0, 0, 0, 0, 0, 7, 26
"/opt/projects/swiftkube/vendor/sigs.k8s.io/kustomize/api/types/objectmeta.go", "Go", 11, 0, 0, 0, 0, 0, 3, 14
"/opt/projects/swiftkube/vendor/sigs.k8s.io/kustomize/api/types/pair.go", "Go", 8, 0, 0, 0, 0, 0, 3, 11
"/opt/projects/swiftkube/vendor/sigs.k8s.io/kustomize/api/types/patch.go", "Go", 27, 0, 0, 0, 0, 0, 8, 35
"/opt/projects/swiftkube/vendor/sigs.k8s.io/kustomize/api/types/patchstrategicmerge.go", "Go", 7, 0, 0, 0, 0, 0, 3, 10
"/opt/projects/swiftkube/vendor/sigs.k8s.io/kustomize/api/types/pluginconfig.go", "Go", 38, 0, 0, 0, 0, 0, 10, 48
"/opt/projects/swiftkube/vendor/sigs.k8s.io/kustomize/api/types/pluginrestrictions.go", "Go", 52, 0, 0, 0, 0, 0, 11, 63
"/opt/projects/swiftkube/vendor/sigs.k8s.io/kustomize/api/types/pluginrestrictions_string.go", "Go", 19, 0, 0, 0, 0, 0, 7, 26
"/opt/projects/swiftkube/vendor/sigs.k8s.io/kustomize/api/types/replacement.go", "Go", 68, 0, 0, 0, 0, 0, 20, 88
"/opt/projects/swiftkube/vendor/sigs.k8s.io/kustomize/api/types/replacementfield.go", "Go", 7, 0, 0, 0, 0, 0, 3, 10
"/opt/projects/swiftkube/vendor/sigs.k8s.io/kustomize/api/types/replica.go", "Go", 13, 0, 0, 0, 0, 0, 4, 17
"/opt/projects/swiftkube/vendor/sigs.k8s.io/kustomize/api/types/secretargs.go", "Go", 16, 0, 0, 0, 0, 0, 4, 20
"/opt/projects/swiftkube/vendor/sigs.k8s.io/kustomize/api/types/selector.go", "Go", 110, 0, 0, 0, 0, 0, 15, 125
"/opt/projects/swiftkube/vendor/sigs.k8s.io/kustomize/api/types/sortoptions.go", "Go", 23, 0, 0, 0, 0, 0, 6, 29
"/opt/projects/swiftkube/vendor/sigs.k8s.io/kustomize/api/types/typemeta.go", "Go", 9, 0, 0, 0, 0, 0, 3, 12
"/opt/projects/swiftkube/vendor/sigs.k8s.io/kustomize/api/types/var.go", "Go", 185, 0, 0, 0, 0, 0, 27, 212
"/opt/projects/swiftkube/vendor/sigs.k8s.io/kustomize/kustomize/v5/commands/build/build.go", "Go", 145, 0, 0, 0, 0, 0, 14, 159
"/opt/projects/swiftkube/vendor/sigs.k8s.io/kustomize/kustomize/v5/commands/build/flagaddmanagedby.go", "Go", 23, 0, 0, 0, 0, 0, 7, 30
"/opt/projects/swiftkube/vendor/sigs.k8s.io/kustomize/kustomize/v5/commands/build/flagenablehelm.go", "Go", 21, 0, 0, 0, 0, 0, 4, 25
"/opt/projects/swiftkube/vendor/sigs.k8s.io/kustomize/kustomize/v5/commands/build/flagenableplugins.go", "Go", 13, 0, 0, 0, 0, 0, 4, 17
"/opt/projects/swiftkube/vendor/sigs.k8s.io/kustomize/kustomize/v5/commands/build/flagloadrestrictor.go", "Go", 40, 0, 0, 0, 0, 0, 8, 48
"/opt/projects/swiftkube/vendor/sigs.k8s.io/kustomize/kustomize/v5/commands/build/flagoutputpath.go", "Go", 14, 0, 0, 0, 0, 0, 4, 18
"/opt/projects/swiftkube/vendor/sigs.k8s.io/kustomize/kustomize/v5/commands/build/flagsforfunctions.go", "Go", 32, 0, 0, 0, 0, 0, 5, 37
"/opt/projects/swiftkube/vendor/sigs.k8s.io/kustomize/kustomize/v5/commands/build/reorderoutput.go", "Go", 43, 0, 0, 0, 0, 0, 8, 51
"/opt/projects/swiftkube/vendor/sigs.k8s.io/kustomize/kustomize/v5/commands/build/writer.go", "Go", 55, 0, 0, 0, 0, 0, 9, 64
"/opt/projects/swiftkube/vendor/sigs.k8s.io/kustomize/kyaml/comments/comments.go", "Go", 71, 0, 0, 0, 0, 0, 13, 84
"/opt/projects/swiftkube/vendor/sigs.k8s.io/kustomize/kyaml/errors/errors.go", "Go", 41, 0, 0, 0, 0, 0, 10, 51
"/opt/projects/swiftkube/vendor/sigs.k8s.io/kustomize/kyaml/ext/ext.go", "Go", 8, 0, 0, 0, 0, 0, 3, 11
"/opt/projects/swiftkube/vendor/sigs.k8s.io/kustomize/kyaml/fieldmeta/fieldmeta.go", "Go", 237, 0, 0, 0, 0, 0, 39, 276
"/opt/projects/swiftkube/vendor/sigs.k8s.io/kustomize/kyaml/filesys/confirmeddir.go", "Go", 71, 0, 0, 0, 0, 0, 9, 80
"/opt/projects/swiftkube/vendor/sigs.k8s.io/kustomize/kyaml/filesys/doc.go", "Go", 6, 0, 0, 0, 0, 0, 2, 8
"/opt/projects/swiftkube/vendor/sigs.k8s.io/kustomize/kyaml/filesys/file.go", "Go", 12, 0, 0, 0, 0, 0, 4, 16
"/opt/projects/swiftkube/vendor/sigs.k8s.io/kustomize/kyaml/filesys/fileinfo.go", "Go", 24, 0, 0, 0, 0, 0, 11, 35
"/opt/projects/swiftkube/vendor/sigs.k8s.io/kustomize/kyaml/filesys/fileondisk.go", "Go", 19, 0, 0, 0, 0, 0, 9, 28
"/opt/projects/swiftkube/vendor/sigs.k8s.io/kustomize/kyaml/filesys/filesystem.go", "Go", 117, 0, 0, 0, 0, 0, 37, 154
"/opt/projects/swiftkube/vendor/sigs.k8s.io/kustomize/kyaml/filesys/fsnode.go", "Go", 592, 0, 0, 0, 0, 0, 56, 648
"/opt/projects/swiftkube/vendor/sigs.k8s.io/kustomize/kyaml/filesys/fsondisk.go", "Go", 122, 0, 0, 0, 0, 0, 20, 142
"/opt/projects/swiftkube/vendor/sigs.k8s.io/kustomize/kyaml/filesys/fsondisk_unix.go", "Go", 11, 0, 0, 0, 0, 0, 5, 16
"/opt/projects/swiftkube/vendor/sigs.k8s.io/kustomize/kyaml/filesys/fsondisk_windows.go", "Go", 14, 0, 0, 0, 0, 0, 5, 19
"/opt/projects/swiftkube/vendor/sigs.k8s.io/kustomize/kyaml/filesys/util.go", "Go", 133, 0, 0, 0, 0, 0, 11, 144
"/opt/projects/swiftkube/vendor/sigs.k8s.io/kustomize/kyaml/fn/runtime/container/container.go", "Go", 191, 0, 0, 0, 0, 0, 18, 209
"/opt/projects/swiftkube/vendor/sigs.k8s.io/kustomize/kyaml/fn/runtime/exec/doc.go", "Go", 4, 0, 0, 0, 0, 0, 2, 6
"/opt/projects/swiftkube/vendor/sigs.k8s.io/kustomize/kyaml/fn/runtime/exec/exec.go", "Go", 45, 0, 0, 0, 0, 0, 10, 55
"/opt/projects/swiftkube/vendor/sigs.k8s.io/kustomize/kyaml/fn/runtime/runtimeutil/doc.go", "Go", 4, 0, 0, 0, 0, 0, 2, 6
"/opt/projects/swiftkube/vendor/sigs.k8s.io/kustomize/kyaml/fn/runtime/runtimeutil/functiontypes.go", "Go", 267, 0, 0, 0, 0, 0, 46, 313
"/opt/projects/swiftkube/vendor/sigs.k8s.io/kustomize/kyaml/fn/runtime/runtimeutil/runtimeutil.go", "Go", 241, 0, 0, 0, 0, 0, 41, 282
"/opt/projects/swiftkube/vendor/sigs.k8s.io/kustomize/kyaml/fn/runtime/runtimeutil/types.go", "Go", 6, 0, 0, 0, 0, 0, 3, 9
"/opt/projects/swiftkube/vendor/sigs.k8s.io/kustomize/kyaml/fn/runtime/starlark/context.go", "Go", 68, 0, 0, 0, 0, 0, 12, 80
"/opt/projects/swiftkube/vendor/sigs.k8s.io/kustomize/kyaml/fn/runtime/starlark/doc.go", "Go", 35, 0, 0, 0, 0, 0, 2, 37
"/opt/projects/swiftkube/vendor/sigs.k8s.io/kustomize/kyaml/fn/runtime/starlark/starlark.go", "Go", 154, 0, 0, 0, 0, 0, 27, 181
"/opt/projects/swiftkube/vendor/sigs.k8s.io/kustomize/kyaml/internal/forked/github.com/go-yaml/yaml/apic.go", "Go", 711, 0, 0, 0, 0, 0, 37, 748
"/opt/projects/swiftkube/vendor/sigs.k8s.io/kustomize/kyaml/internal/forked/github.com/go-yaml/yaml/decode.go", "Go", 933, 0, 0, 0, 0, 0, 68, 1001
"/opt/projects/swiftkube/vendor/sigs.k8s.io/kustomize/kyaml/internal/forked/github.com/go-yaml/yaml/emitterc.go", "Go", 1875, 0, 0, 0, 0, 0, 154, 2029
"/opt/projects/swiftkube/vendor/sigs.k8s.io/kustomize/kyaml/internal/forked/github.com/go-yaml/yaml/encode.go", "Go", 535, 0, 0, 0, 0, 0, 43, 578
"/opt/projects/swiftkube/vendor/sigs.k8s.io/kustomize/kyaml/internal/forked/github.com/go-yaml/yaml/parserc.go", "Go", 1149, 0, 0, 0, 0, 0, 110, 1259
"/opt/projects/swiftkube/vendor/sigs.k8s.io/kustomize/kyaml/internal/forked/github.com/go-yaml/yaml/readerc.go", "Go", 387, 0, 0, 0, 0, 0, 48, 435
"/opt/projects/swiftkube/vendor/sigs.k8s.io/kustomize/kyaml/internal/forked/github.com/go-yaml/yaml/resolve.go", "Go", 299, 0, 0, 0, 0, 0, 28, 327
"/opt/projects/swiftkube/vendor/sigs.k8s.io/kustomize/kyaml/internal/forked/github.com/go-yaml/yaml/scannerc.go", "Go", 2710, 0, 0, 0, 0, 0, 329, 3039
"/opt/projects/swiftkube/vendor/sigs.k8s.io/kustomize/kyaml/internal/forked/github.com/go-yaml/yaml/sorter.go", "Go", 128, 0, 0, 0, 0, 0, 7, 135
"/opt/projects/swiftkube/vendor/sigs.k8s.io/kustomize/kyaml/internal/forked/github.com/go-yaml/yaml/writerc.go", "Go", 43, 0, 0, 0, 0, 0, 6, 49
"/opt/projects/swiftkube/vendor/sigs.k8s.io/kustomize/kyaml/internal/forked/github.com/go-yaml/yaml/yaml.go", "Go", 638, 0, 0, 0, 0, 0, 71, 709
"/opt/projects/swiftkube/vendor/sigs.k8s.io/kustomize/kyaml/internal/forked/github.com/go-yaml/yaml/yamlh.go", "Go", 647, 0, 0, 0, 0, 0, 163, 810
"/opt/projects/swiftkube/vendor/sigs.k8s.io/kustomize/kyaml/internal/forked/github.com/go-yaml/yaml/yamlprivateh.go", "Go", 173, 0, 0, 0, 0, 0, 26, 199
"/opt/projects/swiftkube/vendor/sigs.k8s.io/kustomize/kyaml/internal/forked/github.com/qri-io/starlib/util/doc.go", "Go", 20, 0, 0, 0, 0, 0, 6, 26
"/opt/projects/swiftkube/vendor/sigs.k8s.io/kustomize/kyaml/internal/forked/github.com/qri-io/starlib/util/util.go", "Go", 250, 0, 0, 0, 0, 0, 26, 276
"/opt/projects/swiftkube/vendor/sigs.k8s.io/kustomize/kyaml/kio/byteio_reader.go", "Go", 295, 0, 0, 0, 0, 0, 55, 350
"/opt/projects/swiftkube/vendor/sigs.k8s.io/kustomize/kyaml/kio/byteio_writer.go", "Go", 173, 0, 0, 0, 0, 0, 26, 199
"/opt/projects/swiftkube/vendor/sigs.k8s.io/kustomize/kyaml/kio/doc.go", "Go", 34, 0, 0, 0, 0, 0, 2, 36
"/opt/projects/swiftkube/vendor/sigs.k8s.io/kustomize/kyaml/kio/filters/filters.go", "Go", 174, 0, 0, 0, 0, 0, 37, 211
"/opt/projects/swiftkube/vendor/sigs.k8s.io/kustomize/kyaml/kio/filters/fmtr.go", "Go", 276, 0, 0, 0, 0, 0, 39, 315
"/opt/projects/swiftkube/vendor/sigs.k8s.io/kustomize/kyaml/kio/filters/grep.go", "Go", 104, 0, 0, 0, 0, 0, 14, 118
"/opt/projects/swiftkube/vendor/sigs.k8s.io/kustomize/kyaml/kio/filters/local.go", "Go", 31, 0, 0, 0, 0, 0, 8, 39
"/opt/projects/swiftkube/vendor/sigs.k8s.io/kustomize/kyaml/kio/filters/merge.go", "Go", 78, 0, 0, 0, 0, 0, 9, 87
"/opt/projects/swiftkube/vendor/sigs.k8s.io/kustomize/kyaml/kio/filters/merge3.go", "Go", 286, 0, 0, 0, 0, 0, 32, 318
"/opt/projects/swiftkube/vendor/sigs.k8s.io/kustomize/kyaml/kio/filters/modify.go", "Go", 3, 0, 0, 0, 0, 0, 2, 5
"/opt/projects/swiftkube/vendor/sigs.k8s.io/kustomize/kyaml/kio/filters/stripcomments.go", "Go", 26, 0, 0, 0, 0, 0, 7, 33
"/opt/projects/swiftkube/vendor/sigs.k8s.io/kustomize/kyaml/kio/ignorefilesmatcher.go", "Go", 94, 0, 0, 0, 0, 0, 12, 106
"/opt/projects/swiftkube/vendor/sigs.k8s.io/kustomize/kyaml/kio/kio.go", "Go", 396, 0, 0, 0, 0, 0, 52, 448
"/opt/projects/swiftkube/vendor/sigs.k8s.io/kustomize/kyaml/kio/kioutil/kioutil.go", "Go", 371, 0, 0, 0, 0, 0, 50, 421
"/opt/projects/swiftkube/vendor/sigs.k8s.io/kustomize/kyaml/kio/pkgio_reader.go", "Go", 304, 0, 0, 0, 0, 0, 57, 361
"/opt/projects/swiftkube/vendor/sigs.k8s.io/kustomize/kyaml/kio/pkgio_writer.go", "Go", 128, 0, 0, 0, 0, 0, 23, 151
"/opt/projects/swiftkube/vendor/sigs.k8s.io/kustomize/kyaml/kio/tree.go", "Go", 446, 0, 0, 0, 0, 0, 74, 520
"/opt/projects/swiftkube/vendor/sigs.k8s.io/kustomize/kyaml/openapi/kubernetesapi/openapiinfo.go", "Go", 12, 0, 0, 0, 0, 0, 7, 19
"/opt/projects/swiftkube/vendor/sigs.k8s.io/kustomize/kyaml/openapi/kubernetesapi/v1_21_2/swagger.go", "Go", 219, 0, 0, 0, 0, 0, 31, 250
"/opt/projects/swiftkube/vendor/sigs.k8s.io/kustomize/kyaml/openapi/kustomizationapi/swagger.go", "Go", 218, 0, 0, 0, 0, 0, 31, 249
"/opt/projects/swiftkube/vendor/sigs.k8s.io/kustomize/kyaml/openapi/openapi.go", "Go", 687, 0, 0, 0, 0, 0, 90, 777
"/opt/projects/swiftkube/vendor/sigs.k8s.io/kustomize/kyaml/order/syncorder.go", "Go", 110, 0, 0, 0, 0, 0, 12, 122
"/opt/projects/swiftkube/vendor/sigs.k8s.io/kustomize/kyaml/resid/gvk.go", "Go", 234, 0, 0, 0, 0, 0, 22, 256
"/opt/projects/swiftkube/vendor/sigs.k8s.io/kustomize/kyaml/resid/resid.go", "Go", 122, 0, 0, 0, 0, 0, 24, 146
"/opt/projects/swiftkube/vendor/sigs.k8s.io/kustomize/kyaml/runfn/runfn.go", "Go", 476, 0, 0, 0, 0, 0, 74, 550
"/opt/projects/swiftkube/vendor/sigs.k8s.io/kustomize/kyaml/sets/string.go", "Go", 55, 0, 0, 0, 0, 0, 10, 65
"/opt/projects/swiftkube/vendor/sigs.k8s.io/kustomize/kyaml/sets/stringlist.go", "Go", 37, 0, 0, 0, 0, 0, 8, 45
"/opt/projects/swiftkube/vendor/sigs.k8s.io/kustomize/kyaml/sliceutil/slice.go", "Go", 22, 0, 0, 0, 0, 0, 4, 26
"/opt/projects/swiftkube/vendor/sigs.k8s.io/kustomize/kyaml/utils/pathsplitter.go", "Go", 63, 0, 0, 0, 0, 0, 9, 72
"/opt/projects/swiftkube/vendor/sigs.k8s.io/kustomize/kyaml/yaml/alias.go", "Go", 94, 0, 0, 0, 0, 0, 16, 110
"/opt/projects/swiftkube/vendor/sigs.k8s.io/kustomize/kyaml/yaml/compatibility.go", "Go", 89, 0, 0, 0, 0, 0, 12, 101
"/opt/projects/swiftkube/vendor/sigs.k8s.io/kustomize/kyaml/yaml/const.go", "Go", 27, 0, 0, 0, 0, 0, 4, 31
"/opt/projects/swiftkube/vendor/sigs.k8s.io/kustomize/kyaml/yaml/datamap.go", "Go", 112, 0, 0, 0, 0, 0, 10, 122
"/opt/projects/swiftkube/vendor/sigs.k8s.io/kustomize/kyaml/yaml/doc.go", "Go", 48, 0, 0, 0, 0, 0, 2, 50
"/opt/projects/swiftkube/vendor/sigs.k8s.io/kustomize/kyaml/yaml/filters.go", "Go", 125, 0, 0, 0, 0, 0, 22, 147
"/opt/projects/swiftkube/vendor/sigs.k8s.io/kustomize/kyaml/yaml/fns.go", "Go", 756, 0, 0, 0, 0, 0, 123, 879
"/opt/projects/swiftkube/vendor/sigs.k8s.io/kustomize/kyaml/yaml/internal/k8sgen/pkg/labels/copied.deepcopy.go", "Go", 36, 0, 0, 0, 0, 0, 9, 45
"/opt/projects/swiftkube/vendor/sigs.k8s.io/kustomize/kyaml/yaml/internal/k8sgen/pkg/labels/labels.go", "Go", 164, 0, 0, 0, 0, 0, 29, 193
"/opt/projects/swiftkube/vendor/sigs.k8s.io/kustomize/kyaml/yaml/internal/k8sgen/pkg/labels/selector.go", "Go", 841, 0, 0, 0, 0, 0, 85, 926
"/opt/projects/swiftkube/vendor/sigs.k8s.io/kustomize/kyaml/yaml/internal/k8sgen/pkg/selection/operator.go", "Go", 29, 0, 0, 0, 0, 0, 8, 37
"/opt/projects/swiftkube/vendor/sigs.k8s.io/kustomize/kyaml/yaml/internal/k8sgen/pkg/util/errors/errors.go", "Go", 227, 0, 0, 0, 0, 0, 26, 253
"/opt/projects/swiftkube/vendor/sigs.k8s.io/kustomize/kyaml/yaml/internal/k8sgen/pkg/util/sets/empty.go", "Go", 18, 0, 0, 0, 0, 0, 7, 25
"/opt/projects/swiftkube/vendor/sigs.k8s.io/kustomize/kyaml/yaml/internal/k8sgen/pkg/util/sets/string.go", "Go", 179, 0, 0, 0, 0, 0, 28, 207
"/opt/projects/swiftkube/vendor/sigs.k8s.io/kustomize/kyaml/yaml/internal/k8sgen/pkg/util/validation/field/errors.go", "Go", 247, 0, 0, 0, 0, 0, 29, 276
"/opt/projects/swiftkube/vendor/sigs.k8s.io/kustomize/kyaml/yaml/internal/k8sgen/pkg/util/validation/field/path.go", "Go", 80, 0, 0, 0, 0, 0, 15, 95
"/opt/projects/swiftkube/vendor/sigs.k8s.io/kustomize/kyaml/yaml/internal/k8sgen/pkg/util/validation/validation.go", "Go", 434, 0, 0, 0, 0, 0, 73, 507
"/opt/projects/swiftkube/vendor/sigs.k8s.io/kustomize/kyaml/yaml/kfns.go", "Go", 117, 0, 0, 0, 0, 0, 21, 138
"/opt/projects/swiftkube/vendor/sigs.k8s.io/kustomize/kyaml/yaml/mapnode.go", "Go", 34, 0, 0, 0, 0, 0, 7, 41
"/opt/projects/swiftkube/vendor/sigs.k8s.io/kustomize/kyaml/yaml/match.go", "Go", 292, 0, 0, 0, 0, 0, 42, 334
"/opt/projects/swiftkube/vendor/sigs.k8s.io/kustomize/kyaml/yaml/merge2/merge2.go", "Go", 167, 0, 0, 0, 0, 0, 22, 189
"/opt/projects/swiftkube/vendor/sigs.k8s.io/kustomize/kyaml/yaml/merge2/smpdirective.go", "Go", 90, 0, 0, 0, 0, 0, 12, 102
"/opt/projects/swiftkube/vendor/sigs.k8s.io/kustomize/kyaml/yaml/merge2/smpdirective_string.go", "Go", 20, 0, 0, 0, 0, 0, 7, 27
"/opt/projects/swiftkube/vendor/sigs.k8s.io/kustomize/kyaml/yaml/merge3/merge3.go", "Go", 39, 0, 0, 0, 0, 0, 7, 46
"/opt/projects/swiftkube/vendor/sigs.k8s.io/kustomize/kyaml/yaml/merge3/visitor.go", "Go", 148, 0, 0, 0, 0, 0, 25, 173
"/opt/projects/swiftkube/vendor/sigs.k8s.io/kustomize/kyaml/yaml/order.go", "Go", 88, 0, 0, 0, 0, 0, 20, 108
"/opt/projects/swiftkube/vendor/sigs.k8s.io/kustomize/kyaml/yaml/rnode.go", "Go", 1236, 0, 0, 0, 0, 0, 133, 1369
"/opt/projects/swiftkube/vendor/sigs.k8s.io/kustomize/kyaml/yaml/schema/schema.go", "Go", 39, 0, 0, 0, 0, 0, 6, 45
"/opt/projects/swiftkube/vendor/sigs.k8s.io/kustomize/kyaml/yaml/types.go", "Go", 260, 0, 0, 0, 0, 0, 40, 300
"/opt/projects/swiftkube/vendor/sigs.k8s.io/kustomize/kyaml/yaml/util.go", "Go", 62, 0, 0, 0, 0, 0, 9, 71
"/opt/projects/swiftkube/vendor/sigs.k8s.io/kustomize/kyaml/yaml/walk/associative_sequence.go", "Go", 357, 0, 0, 0, 0, 0, 29, 386
"/opt/projects/swiftkube/vendor/sigs.k8s.io/kustomize/kyaml/yaml/walk/map.go", "Go", 160, 0, 0, 0, 0, 0, 14, 174
"/opt/projects/swiftkube/vendor/sigs.k8s.io/kustomize/kyaml/yaml/walk/nonassociative_sequence.go", "Go", 10, 0, 0, 0, 0, 0, 4, 14
"/opt/projects/swiftkube/vendor/sigs.k8s.io/kustomize/kyaml/yaml/walk/scalar.go", "Go", 8, 0, 0, 0, 0, 0, 4, 12
"/opt/projects/swiftkube/vendor/sigs.k8s.io/kustomize/kyaml/yaml/walk/visitor.go", "Go", 20, 0, 0, 0, 0, 0, 9, 29
"/opt/projects/swiftkube/vendor/sigs.k8s.io/kustomize/kyaml/yaml/walk/walk.go", "Go", 160, 0, 0, 0, 0, 0, 27, 187
"/opt/projects/swiftkube/vendor/sigs.k8s.io/structured-merge-diff/v4/fieldpath/doc.go", "Go", 17, 0, 0, 0, 0, 0, 5, 22
"/opt/projects/swiftkube/vendor/sigs.k8s.io/structured-merge-diff/v4/fieldpath/element.go", "Go", 280, 0, 0, 0, 0, 0, 38, 318
"/opt/projects/swiftkube/vendor/sigs.k8s.io/structured-merge-diff/v4/fieldpath/fromvalue.go", "Go", 117, 0, 0, 0, 0, 0, 18, 135
"/opt/projects/swiftkube/vendor/sigs.k8s.io/structured-merge-diff/v4/fieldpath/managers.go", "Go", 124, 0, 0, 0, 0, 0, 21, 145
"/opt/projects/swiftkube/vendor/sigs.k8s.io/structured-merge-diff/v4/fieldpath/path.go", "Go", 105, 0, 0, 0, 0, 0, 14, 119
"/opt/projects/swiftkube/vendor/sigs.k8s.io/structured-merge-diff/v4/fieldpath/pathelementmap.go", "Go", 72, 0, 0, 0, 0, 0, 14, 86
"/opt/projects/swiftkube/vendor/sigs.k8s.io/structured-merge-diff/v4/fieldpath/serialize-pe.go", "Go", 149, 0, 0, 0, 0, 0, 20, 169
"/opt/projects/swiftkube/vendor/sigs.k8s.io/structured-merge-diff/v4/fieldpath/serialize.go", "Go", 211, 0, 0, 0, 0, 0, 28, 239
"/opt/projects/swiftkube/vendor/sigs.k8s.io/structured-merge-diff/v4/fieldpath/set.go", "Go", 450, 0, 0, 0, 0, 0, 56, 506
"/opt/projects/swiftkube/vendor/sigs.k8s.io/structured-merge-diff/v4/merge/conflict.go", "Go", 99, 0, 0, 0, 0, 0, 23, 122
"/opt/projects/swiftkube/vendor/sigs.k8s.io/structured-merge-diff/v4/merge/update.go", "Go", 329, 0, 0, 0, 0, 0, 28, 357
"/opt/projects/swiftkube/vendor/sigs.k8s.io/structured-merge-diff/v4/schema/doc.go", "Go", 24, 0, 0, 0, 0, 0, 5, 29
"/opt/projects/swiftkube/vendor/sigs.k8s.io/structured-merge-diff/v4/schema/elements.go", "Go", 324, 0, 0, 0, 0, 0, 51, 375
"/opt/projects/swiftkube/vendor/sigs.k8s.io/structured-merge-diff/v4/schema/equals.go", "Go", 187, 0, 0, 0, 0, 0, 16, 203
"/opt/projects/swiftkube/vendor/sigs.k8s.io/structured-merge-diff/v4/schema/schemaschema.go", "Go", 159, 0, 0, 0, 0, 0, 6, 165
"/opt/projects/swiftkube/vendor/sigs.k8s.io/structured-merge-diff/v4/typed/doc.go", "Go", 14, 0, 0, 0, 0, 0, 5, 19
"/opt/projects/swiftkube/vendor/sigs.k8s.io/structured-merge-diff/v4/typed/helpers.go", "Go", 231, 0, 0, 0, 0, 0, 30, 261
"/opt/projects/swiftkube/vendor/sigs.k8s.io/structured-merge-diff/v4/typed/merge.go", "Go", 359, 0, 0, 0, 0, 0, 54, 413
"/opt/projects/swiftkube/vendor/sigs.k8s.io/structured-merge-diff/v4/typed/parser.go", "Go", 131, 0, 0, 0, 0, 0, 21, 152
"/opt/projects/swiftkube/vendor/sigs.k8s.io/structured-merge-diff/v4/typed/reconcile_schema.go", "Go", 256, 0, 0, 0, 0, 0, 35, 291
"/opt/projects/swiftkube/vendor/sigs.k8s.io/structured-merge-diff/v4/typed/remove.go", "Go", 152, 0, 0, 0, 0, 0, 14, 166
"/opt/projects/swiftkube/vendor/sigs.k8s.io/structured-merge-diff/v4/typed/tofieldset.go", "Go", 139, 0, 0, 0, 0, 0, 30, 169
"/opt/projects/swiftkube/vendor/sigs.k8s.io/structured-merge-diff/v4/typed/typed.go", "Go", 289, 0, 0, 0, 0, 0, 34, 323
"/opt/projects/swiftkube/vendor/sigs.k8s.io/structured-merge-diff/v4/typed/union.go", "Go", 238, 0, 0, 0, 0, 0, 39, 277
"/opt/projects/swiftkube/vendor/sigs.k8s.io/structured-merge-diff/v4/typed/validate.go", "Go", 171, 0, 0, 0, 0, 0, 25, 196
"/opt/projects/swiftkube/vendor/sigs.k8s.io/structured-merge-diff/v4/value/allocator.go", "Go", 173, 0, 0, 0, 0, 0, 31, 204
"/opt/projects/swiftkube/vendor/sigs.k8s.io/structured-merge-diff/v4/value/doc.go", "Go", 17, 0, 0, 0, 0, 0, 5, 22
"/opt/projects/swiftkube/vendor/sigs.k8s.io/structured-merge-diff/v4/value/fields.go", "Go", 86, 0, 0, 0, 0, 0, 12, 98
"/opt/projects/swiftkube/vendor/sigs.k8s.io/structured-merge-diff/v4/value/jsontagutil.go", "Go", 80, 0, 0, 0, 0, 0, 12, 92
"/opt/projects/swiftkube/vendor/sigs.k8s.io/structured-merge-diff/v4/value/list.go", "Go", 121, 0, 0, 0, 0, 0, 19, 140
"/opt/projects/swiftkube/vendor/sigs.k8s.io/structured-merge-diff/v4/value/listreflect.go", "Go", 82, 0, 0, 0, 0, 0, 17, 99
"/opt/projects/swiftkube/vendor/sigs.k8s.io/structured-merge-diff/v4/value/listunstructured.go", "Go", 59, 0, 0, 0, 0, 0, 16, 75
"/opt/projects/swiftkube/vendor/sigs.k8s.io/structured-merge-diff/v4/value/map.go", "Go", 250, 0, 0, 0, 0, 0, 21, 271
"/opt/projects/swiftkube/vendor/sigs.k8s.io/structured-merge-diff/v4/value/mapreflect.go", "Go", 179, 0, 0, 0, 0, 0, 31, 210
"/opt/projects/swiftkube/vendor/sigs.k8s.io/structured-merge-diff/v4/value/mapunstructured.go", "Go", 159, 0, 0, 0, 0, 0, 32, 191
"/opt/projects/swiftkube/vendor/sigs.k8s.io/structured-merge-diff/v4/value/reflectcache.go", "Go", 410, 0, 0, 0, 0, 0, 58, 468
"/opt/projects/swiftkube/vendor/sigs.k8s.io/structured-merge-diff/v4/value/scalar.go", "Go", 43, 0, 0, 0, 0, 0, 8, 51
"/opt/projects/swiftkube/vendor/sigs.k8s.io/structured-merge-diff/v4/value/structreflect.go", "Go", 180, 0, 0, 0, 0, 0, 29, 209
"/opt/projects/swiftkube/vendor/sigs.k8s.io/structured-merge-diff/v4/value/value.go", "Go", 320, 0, 0, 0, 0, 0, 28, 348
"/opt/projects/swiftkube/vendor/sigs.k8s.io/structured-merge-diff/v4/value/valuereflect.go", "Go", 260, 0, 0, 0, 0, 0, 35, 295
"/opt/projects/swiftkube/vendor/sigs.k8s.io/structured-merge-diff/v4/value/valueunstructured.go", "Go", 154, 0, 0, 0, 0, 0, 25, 179
"/opt/projects/swiftkube/vendor/sigs.k8s.io/yaml/fields.go", "Go", 456, 0, 0, 0, 0, 0, 47, 503
"/opt/projects/swiftkube/vendor/sigs.k8s.io/yaml/yaml.go", "Go", 353, 0, 0, 0, 0, 0, 28, 381
"/opt/projects/swiftkube/vendor/sigs.k8s.io/yaml/yaml_go110.go", "Go", 10, 0, 0, 0, 0, 0, 5, 15
"Total", "-", 2939693, 1279, 11648, 335, 211, 17663, 334877, 3305706